,year,unitid,institution_name,city_txt,state_cd,zip_text,classification_code,classification_name,ef_male_count,ef_female_count,ef_total_count,sector_cd,sector_name,sportscode,sum_partic_men,sum_partic_women,rev_men,rev_women,total_rev_menwomen,exp_men,exp_women,total_exp_menwomen,sports
14626,2015,222178,Abilene Christian University,Abilene,TX,79699,2,NCAA Division I-FCS,1447,2120,3567,2,"Private nonprofit, 4-year or above",2,15,11,1109152,831785,1940937,1109152,831785,1940937,Basketball
32095,2016,222178,Abilene Christian University,Abilene,TX,79699,2,NCAA Division I-FCS,1465,2085,3550,2,"Private nonprofit, 4-year or above",2,16,12,1143099,1048516,2191615,1143099,1048516,2191615,Basketball
49614,2017,222178,Abilene Christian University,Abilene,TX,79699,2,NCAA Division I-FCS,1455,2053,3508,2,"Private nonprofit, 4-year or above",2,15,13,1363430,1229969,2593399,1363430,1229969,2593399,Basketball
67384,2018,222178,Abilene Christian University,Abilene,TX,79699,2,NCAA Division I-FCS,1351,2046,3397,2,"Private nonprofit, 4-year or above",2,15,16,1178426,1247975,2426401,1178426,1247975,2426401,Basketball
121230,2019,222178,Abilene Christian University,Abilene,TX,79699,2,NCAA Division I-FCS,1321,2023,3344,2,"Private nonprofit, 4-year or above",2,14,12,1604471,1472260,3076731,1709614,1466828,3176442,Basketball
631,2015,108232,Academy of Art University,San Francisco,CA,94105,5,NCAA Division II without football,2341,2978,5319,3,"Private for-profit, 4-year or above",2,11,14,600487,673446,1273933,600487,673446,1273933,Basketball
17979,2016,108232,Academy of Art University,San Francisco,CA,94105,5,NCAA Division II without football,2144,2669,4813,3,"Private for-profit, 4-year or above",2,16,14,631203,765206,1396409,631203,765206,1396409,Basketball
35411,2017,108232,Academy of Art University,San Francisco,CA,94105,5,NCAA Division II without football,2016,2391,4407,3,"Private for-profit, 4-year or above",2,17,16,785214,864537,1649751,785214,864537,1649751,Basketball
53034,2018,108232,Academy of Art University,San Francisco,CA,94105,5,NCAA Division II without football,1889,2181,4070,3,"Private for-profit, 4-year or above",2,16,12,839238,888949,1728187,839238,888949,1728187,Basketball
73030,2019,108232,Academy of Art University,San Francisco,CA,94105,5,NCAA Division II without football,1757,1991,3748,3,"Private for-profit, 4-year or above",2,22,19,846941,735798,1582739,846941,735798,1582739,Basketball
2148,2015,126182,Adams State University,Alamosa,CO,81101,4,NCAA Division II with football,916,828,1744,1,"Public, 4-year or above",2,30,30,378080,498239,876319,378080,498239,876319,Basketball
19516,2016,126182,Adams State University,Alamosa,CO,81101,4,NCAA Division II with football,830,793,1623,1,"Public, 4-year or above",2,25,38,401891,438709,840600,401891,438709,840600,Basketball
36954,2017,126182,Adams State University,Alamosa,CO,81101,4,NCAA Division II with football,766,739,1505,1,"Public, 4-year or above",2,36,24,440996,436914,877910,440996,436914,877910,Basketball
54591,2018,126182,Adams State University,Alamosa,CO,81101,4,NCAA Division II with football,786,686,1472,1,"Public, 4-year or above",2,36,24,434534,478583,913117,434534,478583,913117,Basketball
78082,2019,126182,Adams State University,Alamosa,CO,81101,4,NCAA Division II with football,699,653,1352,1,"Public, 4-year or above",2,34,20,393980,427297,821277,393980,427297,821277,Basketball
9365,2015,188429,Adelphi University,Garden City,NY,115300701,5,NCAA Division II without football,1403,2997,4400,2,"Private nonprofit, 4-year or above",2,14,15,690712,602935,1293647,690712,602935,1293647,Basketball
26787,2016,188429,Adelphi University,Garden City,NY,115300701,5,NCAA Division II without football,1489,3248,4737,2,"Private nonprofit, 4-year or above",2,18,13,733322,468054,1201376,733322,468054,1201376,Basketball
44280,2017,188429,Adelphi University,Garden City,NY,11530,5,NCAA Division II without football,1522,3336,4858,2,"Private nonprofit, 4-year or above",2,14,15,624651,615738,1240389,624651,615738,1240389,Basketball
62001,2018,188429,Adelphi University,Garden City,NY,11530,5,NCAA Division II without football,1571,3472,5043,2,"Private nonprofit, 4-year or above",2,15,15,707147,657449,1364596,707147,657449,1364596,Basketball
103267,2019,188429,Adelphi University,Garden City,NY,11530,5,NCAA Division II without football,1543,3507,5050,2,"Private nonprofit, 4-year or above",2,16,12,677511,578115,1255626,677511,578115,1255626,Basketball
6993,2015,168528,Adrian College,Adrian,MI,492212575,6,NCAA Division III with football,865,743,1608,2,"Private nonprofit, 4-year or above",2,26,21,152516,127517,280033,152516,127517,280033,Basketball
24385,2016,168528,Adrian College,Adrian,MI,49221,6,NCAA Division III with football,833,771,1604,2,"Private nonprofit, 4-year or above",2,25,20,105385,116305,221690,105385,116305,221690,Basketball
41883,2017,168528,Adrian College,Adrian,MI,49221,6,NCAA Division III with football,819,787,1606,2,"Private nonprofit, 4-year or above",2,24,15,111787,105929,217716,111787,105929,217716,Basketball
59576,2018,168528,Adrian College,Adrian,MI,49221,6,NCAA Division III with football,924,826,1750,2,"Private nonprofit, 4-year or above",2,25,18,113776,124863,238639,113776,124863,238639,Basketball
94587,2019,168528,Adrian College,Adrian,MI,49221,6,NCAA Division III with football,869,854,1723,2,"Private nonprofit, 4-year or above",2,24,19,122984,132345,255329,122984,132345,255329,Basketball
2,2015,100654,Alabama A & M University,Normal,AL,35762,2,NCAA Division I-FCS,1923,2300,4223,1,"Public, 4-year or above",2,19,16,1211095,748833,1959928,817868,742460,1560328,Basketball
17347,2016,100654,Alabama A & M University,Normal,AL,35762,2,NCAA Division I-FCS,1801,2410,4211,1,"Public, 4-year or above",2,15,15,824939,869729,1694668,824939,869729,1694668,Basketball
34761,2017,100654,Alabama A & M University,Normal,AL,35762,2,NCAA Division I-FCS,1900,2608,4508,1,"Public, 4-year or above",2,16,16,706508,819659,1526167,706508,819659,1526167,Basketball
52389,2018,100654,Alabama A & M University,Normal,AL,35762,2,NCAA Division I-FCS,1899,2798,4697,1,"Public, 4-year or above",2,15,12,1591652,1426155,3017807,1667122,1308585,2975707,Basketball
70161,2019,100654,Alabama A & M University,Normal,AL,35762,2,NCAA Division I-FCS,1951,3024,4975,1,"Public, 4-year or above",2,15,13,1382143,1289349,2671492,1567122,1387755,2954877,Basketball
31,2015,100724,Alabama State University,Montgomery,AL,361040271,2,NCAA Division I-FCS,1679,2698,4377,1,"Public, 4-year or above",2,17,20,977453,782842,1760295,859867,695056,1554923,Basketball
17377,2016,100724,Alabama State University,Montgomery,AL,36104,2,NCAA Division I-FCS,1646,2716,4362,1,"Public, 4-year or above",2,16,17,815998,716876,1532874,815998,716876,1532874,Basketball
34792,2017,100724,Alabama State University,Montgomery,AL,36104,2,NCAA Division I-FCS,1449,2417,3866,1,"Public, 4-year or above",2,15,15,890245,847880,1738125,890245,847880,1738125,Basketball
52421,2018,100724,Alabama State University,Montgomery,AL,36104,2,NCAA Division I-FCS,1332,2311,3643,1,"Public, 4-year or above",2,16,17,992694,802316,1795010,992694,802316,1795010,Basketball
70249,2019,100724,Alabama State University,Montgomery,AL,36104,2,NCAA Division I-FCS,1258,2188,3446,1,"Public, 4-year or above",2,18,16,966118,762216,1728334,966118,762216,1728334,Basketball
3135,2015,138716,Albany State University,Albany,GA,31705,4,NCAA Division II with football,900,1649,2549,1,"Public, 4-year or above",2,17,17,143837,171218,315055,167338,164443,331781,Basketball
20505,2016,138716,Albany State University,Albany,GA,31705,4,NCAA Division II with football,747,1440,2187,1,"Public, 4-year or above",2,15,18,174711,181742,356453,174711,181742,356453,Basketball
37963,2017,138716,Albany State University,Albany,GA,31705,4,NCAA Division II with football,1195,2593,3788,1,"Public, 4-year or above",2,25,21,166576,152451,319027,166576,152451,319027,Basketball
55615,2018,138716,Albany State University,Albany,GA,31705,4,NCAA Division II with football,1152,2872,4024,1,"Public, 4-year or above",2,15,18,88125,96217,184342,255918,203795,459713,Basketball
81713,2019,138716,Albany State University,Albany,GA,31705,4,NCAA Division II with football,1112,2864,3976,1,"Public, 4-year or above",2,12,17,76553,87379,163932,215561,178474,394035,Basketball
2323,2015,128498,Albertus Magnus College,New Haven,CT,65111189,7,NCAA Division III without football,352,671,1023,2,"Private nonprofit, 4-year or above",2,16,12,51247,42761,94008,51247,42761,94008,Basketball
19695,2016,128498,Albertus Magnus College,New Haven,CT,6511,7,NCAA Division III without football,363,671,1034,2,"Private nonprofit, 4-year or above",2,17,19,60463,49713,110176,60463,49713,110176,Basketball
37134,2017,128498,Albertus Magnus College,New Haven,CT,6511,7,NCAA Division III without football,340,670,1010,2,"Private nonprofit, 4-year or above",2,17,11,57861,46184,104045,57861,46184,104045,Basketball
54770,2018,128498,Albertus Magnus College,New Haven,CT,6511,7,NCAA Division III without football,331,623,954,2,"Private nonprofit, 4-year or above",2,16,14,64585,54143,118728,64585,54143,118728,Basketball
78798,2019,128498,Albertus Magnus College,New Haven,CT,6511,7,NCAA Division III without football,378,606,984,2,"Private nonprofit, 4-year or above",2,18,15,76006,69113,145119,76006,69113,145119,Basketball
7008,2015,168546,Albion College,Albion,MI,49224,6,NCAA Division III with football,677,677,1354,2,"Private nonprofit, 4-year or above",2,35,22,185972,171472,357444,185972,171472,357444,Basketball
24400,2016,168546,Albion College,Albion,MI,49224,6,NCAA Division III with football,666,718,1384,2,"Private nonprofit, 4-year or above",2,29,22,232025,151016,383041,232025,151016,383041,Basketball
41899,2017,168546,Albion College,Albion,MI,49224,6,NCAA Division III with football,737,815,1552,2,"Private nonprofit, 4-year or above",2,35,24,209576,201885,411461,209576,201885,411461,Basketball
59593,2018,168546,Albion College,Albion,MI,49224,6,NCAA Division III with football,689,816,1505,2,"Private nonprofit, 4-year or above",2,27,18,194043,152559,346602,194043,152559,346602,Basketball
94625,2019,168546,Albion College,Albion,MI,49224,6,NCAA Division III with football,676,772,1448,2,"Private nonprofit, 4-year or above",2,31,23,188489,168851,357340,188489,168851,357340,Basketball
12512,2015,210571,Albright College,Reading,PA,196125234,6,NCAA Division III with football,880,1339,2219,2,"Private nonprofit, 4-year or above",2,18,17,157435,122878,280313,157435,122878,280313,Basketball
29961,2016,210571,Albright College,Reading,PA,19612,6,NCAA Division III with football,905,1379,2284,2,"Private nonprofit, 4-year or above",2,15,14,144397,138513,282910,144397,138513,282910,Basketball
47458,2017,210571,Albright College,Reading,PA,19612,6,NCAA Division III with football,808,1185,1993,2,"Private nonprofit, 4-year or above",2,19,12,142059,118359,260418,142059,118359,260418,Basketball
65206,2018,210571,Albright College,Reading,PA,19612,6,NCAA Division III with football,753,1134,1887,2,"Private nonprofit, 4-year or above",2,20,15,130420,106953,237373,130420,106953,237373,Basketball
114165,2019,210571,Albright College,Reading,PA,19612,6,NCAA Division III with football,681,1020,1701,2,"Private nonprofit, 4-year or above",2,21,12,126712,110381,237093,126712,110381,237093,Basketball
7866,2015,175342,Alcorn State University,Alcorn State,MS,390967500,2,NCAA Division I-FCS,949,1607,2556,1,"Public, 4-year or above",2,18,17,629683,439676,1069359,629683,439676,1069359,Basketball
25280,2016,175342,Alcorn State University,Alcorn State,MS,39096,2,NCAA Division I-FCS,950,1639,2589,1,"Public, 4-year or above",2,14,15,465614,337965,803579,465614,337965,803579,Basketball
42781,2017,175342,Alcorn State University,Alcorn State,MS,39096,2,NCAA Division I-FCS,1052,1841,2893,1,"Public, 4-year or above",2,15,13,550993,452503,1003496,550993,452503,1003496,Basketball
60486,2018,175342,Alcorn State University,Alcorn State,MS,39096,2,NCAA Division I-FCS,1029,1815,2844,1,"Public, 4-year or above",2,14,15,533743,561782,1095525,533743,561782,1095525,Basketball
97699,2019,175342,Alcorn State University,Alcorn State,MS,39096,2,NCAA Division I-FCS,939,1704,2643,1,"Public, 4-year or above",2,17,15,548863,554701,1103564,548863,554701,1103564,Basketball
16236,2015,237118,Alderson Broaddus University,Philippi,WV,264162035,4,NCAA Division II with football,573,472,1045,2,"Private nonprofit, 4-year or above",2,33,28,291302,308947,600249,289571,310369,599940,Basketball
33710,2016,237118,Alderson Broaddus University,Philippi,WV,26416,4,NCAA Division II with football,517,417,934,2,"Private nonprofit, 4-year or above",2,36,23,441931,291217,733148,434660,290813,725473,Basketball
51264,2017,237118,Alderson Broaddus University,Philippi,WV,26416,4,NCAA Division II with football,513,390,903,2,"Private nonprofit, 4-year or above",2,29,16,443423,343143,786566,439710,340647,780357,Basketball
69012,2018,237118,Alderson Broaddus University,Philippi,WV,26416,4,NCAA Division II with football,441,350,791,2,"Private nonprofit, 4-year or above",2,25,18,407537,407970,815507,412126,399759,811885,Basketball
127876,2019,237118,Alderson Broaddus University,Philippi,WV,26416,4,NCAA Division II with football,463,327,790,2,"Private nonprofit, 4-year or above",2,27,24,448312,462321,910633,448312,462321,910633,Basketball
9395,2015,188641,Alfred University,Alfred,NY,148021205,6,NCAA Division III with football,870,860,1730,2,"Private nonprofit, 4-year or above",2,16,12,127512,107266,234778,127512,107266,234778,Basketball
26813,2016,188641,Alfred University,Alfred,NY,14802,6,NCAA Division III with football,900,800,1700,2,"Private nonprofit, 4-year or above",2,16,11,154347,121736,276083,154347,121736,276083,Basketball
44305,2017,188641,Alfred University,Alfred,NY,14802,6,NCAA Division III with football,832,754,1586,2,"Private nonprofit, 4-year or above",2,14,14,137789,126719,264508,137789,126719,264508,Basketball
62028,2018,188641,Alfred University,Alfred,NY,14802,6,NCAA Division III with football,803,761,1564,2,"Private nonprofit, 4-year or above",2,16,13,147160,129259,276419,147160,129259,276419,Basketball
103387,2019,188641,Alfred University,Alfred,NY,14802,6,NCAA Division III with football,863,776,1639,2,"Private nonprofit, 4-year or above",2,19,15,181387,129869,311256,181387,129869,311256,Basketball
12532,2015,210669,Allegheny College,Meadville,PA,163353902,6,NCAA Division III with football,873,1009,1882,2,"Private nonprofit, 4-year or above",2,14,19,163910,156516,320426,163910,156516,320426,Basketball
29981,2016,210669,Allegheny College,Meadville,PA,16335,6,NCAA Division III with football,889,976,1865,2,"Private nonprofit, 4-year or above",2,17,19,177567,167007,344574,177567,167007,344574,Basketball
47477,2017,210669,Allegheny College,Meadville,PA,16335,6,NCAA Division III with football,799,949,1748,2,"Private nonprofit, 4-year or above",2,17,17,170483,147856,318339,170483,147856,318339,Basketball
65226,2018,210669,Allegheny College,Meadville,PA,16335,6,NCAA Division III with football,773,947,1720,2,"Private nonprofit, 4-year or above",2,17,15,178600,145533,324133,178600,145533,324133,Basketball
114209,2019,210669,Allegheny College,Meadville,PA,16335,6,NCAA Division III with football,759,952,1711,2,"Private nonprofit, 4-year or above",2,16,19,197783,154736,352519,197783,154736,352519,Basketball
7022,2015,168591,Alma College,Alma,MI,488011599,6,NCAA Division III with football,571,758,1329,2,"Private nonprofit, 4-year or above",2,32,23,218380,161358,379738,218380,161358,379738,Basketball
24414,2016,168591,Alma College,Alma,MI,48801,6,NCAA Division III with football,598,785,1383,2,"Private nonprofit, 4-year or above",2,25,21,227041,177332,404373,227041,177332,404373,Basketball
41914,2017,168591,Alma College,Alma,MI,48801,6,NCAA Division III with football,597,784,1381,2,"Private nonprofit, 4-year or above",2,24,16,263580,201897,465477,263580,201897,465477,Basketball
59609,2018,168591,Alma College,Alma,MI,48801,6,NCAA Division III with football,578,813,1391,2,"Private nonprofit, 4-year or above",2,21,20,221390,170239,391629,221390,170239,391629,Basketball
94663,2019,168591,Alma College,Alma,MI,48801,6,NCAA Division III with football,587,809,1396,2,"Private nonprofit, 4-year or above",2,27,27,195382,160001,355383,195382,160001,355383,Basketball
12553,2015,210775,Alvernia University,Reading,PA,196071799,7,NCAA Division III without football,521,1243,1764,2,"Private nonprofit, 4-year or above",2,15,12,68943,77045,145988,68943,75761,144704,Basketball
30003,2016,210775,Alvernia University,Reading,PA,19607,7,NCAA Division III without football,483,1234,1717,2,"Private nonprofit, 4-year or above",2,21,17,72191,77250,149441,72191,71816,144007,Basketball
47499,2017,210775,Alvernia University,Reading,PA,19607,7,NCAA Division III without football,502,1168,1670,2,"Private nonprofit, 4-year or above",2,17,17,68915,71088,140003,68915,68939,137854,Basketball
65248,2018,210775,Alvernia University,Reading,PA,19607,6,NCAA Division III with football,565,1125,1690,2,"Private nonprofit, 4-year or above",2,14,18,64288,69249,133537,64288,62835,127123,Basketball
114285,2019,210775,Alvernia University,Reading,PA,19607,6,NCAA Division III with football,565,1090,1655,2,"Private nonprofit, 4-year or above",2,14,20,72538,79926,152464,72538,77523,150061,Basketball
6326,2015,164447,American International College,Springfield,MA,1109,4,NCAA Division II with football,571,821,1392,2,"Private nonprofit, 4-year or above",2,15,15,631170,710208,1341378,631170,710208,1341378,Basketball
23709,2016,164447,American International College,Springfield,MA,1109,4,NCAA Division II with football,543,804,1347,2,"Private nonprofit, 4-year or above",2,16,13,582505,590210,1172715,582505,590210,1172715,Basketball
41213,2017,164447,American International College,Springfield,MA,1109,4,NCAA Division II with football,527,727,1254,2,"Private nonprofit, 4-year or above",2,15,15,651922,609624,1261546,651922,609624,1261546,Basketball
58912,2018,164447,American International College,Springfield,MA,1109,4,NCAA Division II with football,456,755,1211,2,"Private nonprofit, 4-year or above",2,15,15,639194,619116,1258310,639194,619116,1258310,Basketball
92846,2019,164447,American International College,Springfield,MA,1109,4,NCAA Division II with football,497,774,1271,2,"Private nonprofit, 4-year or above",2,18,15,568519,520422,1088941,568519,520422,1088941,Basketball
2607,2015,131159,American University,Washington,DC,200168001,3,NCAA Division I without football,2607,4432,7039,2,"Private nonprofit, 4-year or above",2,15,15,1934639,1561413,3496052,1934639,1561413,3496052,Basketball
19980,2016,131159,American University,Washington,DC,20016,3,NCAA Division I without football,2533,4448,6981,2,"Private nonprofit, 4-year or above",2,15,16,1999512,1650501,3650013,1999512,1650501,3650013,Basketball
37419,2017,131159,American University,Washington,DC,20016,3,NCAA Division I without football,2647,4522,7169,2,"Private nonprofit, 4-year or above",2,15,14,2065691,1567244,3632935,2065691,1567244,3632935,Basketball
55061,2018,131159,American University,Washington,DC,20016,3,NCAA Division I without football,2702,4551,7253,2,"Private nonprofit, 4-year or above",2,15,12,2072510,1682790,3755300,2072510,1682790,3755300,Basketball
79418,2019,131159,American University,Washington,DC,20016,3,NCAA Division I without football,2759,4659,7418,2,"Private nonprofit, 4-year or above",2,14,14,2004795,1682055,3686850,2004795,1682055,3686850,Basketball
6340,2015,164465,Amherst College,Amherst,MA,10025000,6,NCAA Division III with football,891,904,1795,2,"Private nonprofit, 4-year or above",2,17,12,398365,255102,653467,335148,248942,584090,Basketball
23723,2016,164465,Amherst College,Amherst,MA,1002,6,NCAA Division III with football,921,925,1846,2,"Private nonprofit, 4-year or above",2,19,14,339362,312331,651693,339362,312331,651693,Basketball
41227,2017,164465,Amherst College,Amherst,MA,1002,6,NCAA Division III with football,928,907,1835,2,"Private nonprofit, 4-year or above",2,15,11,418850,316898,735748,386644,306867,693511,Basketball
58926,2018,164465,Amherst College,Amherst,MA,1002,6,NCAA Division III with football,919,936,1855,2,"Private nonprofit, 4-year or above",2,16,11,351756,293685,645441,332754,285499,618253,Basketball
92860,2019,164465,Amherst College,Amherst,MA,1002,6,NCAA Division III with football,915,924,1839,2,"Private nonprofit, 4-year or above",2,17,13,295418,265451,560869,295418,265451,560869,Basketball
4312,2015,150066,Anderson University,Anderson,IN,460123495,6,NCAA Division III with football,639,970,1609,2,"Private nonprofit, 4-year or above",2,16,12,148143,98352,246495,146617,98343,244960,Basketball
13896,2015,217633,Anderson University,Anderson,SC,296214035,5,NCAA Division II without football,784,1614,2398,2,"Private nonprofit, 4-year or above",2,28,14,461528,435603,897131,458744,419732,878476,Basketball
21680,2016,150066,Anderson University,Anderson,IN,46012,6,NCAA Division III with football,661,929,1590,2,"Private nonprofit, 4-year or above",2,16,11,200428,93549,293977,166962,94601,261563,Basketball
31350,2016,217633,Anderson University,Anderson,SC,29621,5,NCAA Division II without football,802,1678,2480,2,"Private nonprofit, 4-year or above",2,17,18,484948,463300,948248,458611,446238,904849,Basketball
39150,2017,150066,Anderson University,Anderson,IN,46012,6,NCAA Division III with football,590,840,1430,2,"Private nonprofit, 4-year or above",2,17,16,173466,149043,322509,170991,139766,310757,Basketball
48863,2017,217633,Anderson University,Anderson,SC,29621,5,NCAA Division II without football,794,1755,2549,2,"Private nonprofit, 4-year or above",2,15,16,474784,513735,988519,438091,523796,961887,Basketball
56807,2018,150066,Anderson University,Anderson,IN,46012,6,NCAA Division III with football,529,801,1330,2,"Private nonprofit, 4-year or above",2,18,19,191003,142494,333497,184878,140183,325061,Basketball
66620,2018,217633,Anderson University,Anderson,SC,29621,5,NCAA Division II without football,785,1740,2525,2,"Private nonprofit, 4-year or above",2,18,19,525887,560061,1085948,509257,543447,1052704,Basketball
85924,2019,150066,Anderson University,Anderson,IN,46012,6,NCAA Division III with football,509,704,1213,2,"Private nonprofit, 4-year or above",2,18,19,204426,158650,363076,189582,138910,328492,Basketball
118349,2019,217633,Anderson University,Anderson,SC,29621,5,NCAA Division II without football,805,1739,2544,2,"Private nonprofit, 4-year or above",2,19,21,568502,579413,1147915,553207,577224,1130431,Basketball
14640,2015,222831,Angelo State University,San Angelo,TX,76909,4,NCAA Division II with football,2116,2576,4692,1,"Public, 4-year or above",2,19,15,544642,490790,1035432,497122,413101,910223,Basketball
32110,2016,222831,Angelo State University,San Angelo,TX,76909,4,NCAA Division II with football,2253,2723,4976,1,"Public, 4-year or above",2,21,14,593726,469618,1063344,593250,475670,1068920,Basketball
49630,2017,222831,Angelo State University,San Angelo,TX,76909,4,NCAA Division II with football,2325,2825,5150,1,"Public, 4-year or above",2,17,13,622115,494693,1116808,622115,494693,1116808,Basketball
67400,2018,222831,Angelo State University,San Angelo,TX,76909,4,NCAA Division II with football,2398,2951,5349,1,"Public, 4-year or above",2,16,13,612488,549183,1161671,609943,520901,1130844,Basketball
121316,2019,222831,Angelo State University,San Angelo,TX,76909,4,NCAA Division II with football,2305,3020,5325,1,"Public, 4-year or above",2,17,15,615251,526076,1141327,583935,508638,1092573,Basketball
6354,2015,164492,Anna Maria College,Paxton,MA,16121198,6,NCAA Division III with football,305,506,811,2,"Private nonprofit, 4-year or above",2,18,13,69600,53256,122856,69600,53256,122856,Basketball
23737,2016,164492,Anna Maria College,Paxton,MA,1612,6,NCAA Division III with football,271,509,780,2,"Private nonprofit, 4-year or above",2,17,15,69099,51194,120293,69099,51194,120293,Basketball
41243,2017,164492,Anna Maria College,Paxton,MA,1612,6,NCAA Division III with football,349,517,866,2,"Private nonprofit, 4-year or above",2,18,12,80396,68567,148963,80396,68567,148963,Basketball
58942,2018,164492,Anna Maria College,Paxton,MA,1612,6,NCAA Division III with football,403,534,937,2,"Private nonprofit, 4-year or above",2,19,13,76376,66467,142843,76376,66467,142843,Basketball
92898,2019,164492,Anna Maria College,Paxton,MA,1612,6,NCAA Division III with football,421,503,924,2,"Private nonprofit, 4-year or above",2,20,13,65918,58140,124058,65918,58140,124058,Basketball
10765,2015,197869,Appalachian State University,Boone,NC,28608,1,NCAA Division I-FBS,7083,8184,15267,1,"Public, 4-year or above",2,21,20,1588454,1400078,2988532,1588454,1400078,2988532,Basketball
28197,2016,197869,Appalachian State University,Boone,NC,28608,1,NCAA Division I-FBS,6975,8475,15450,1,"Public, 4-year or above",2,16,17,1706179,1463982,3170161,1706179,1463982,3170161,Basketball
45695,2017,197869,Appalachian State University,Boone,NC,28608,1,NCAA Division I-FBS,7172,8834,16006,1,"Public, 4-year or above",2,16,15,1713547,1475059,3188606,1713547,1475059,3188606,Basketball
63406,2018,197869,Appalachian State University,Boone,NC,28608,1,NCAA Division I-FBS,7211,9146,16357,1,"Public, 4-year or above",2,15,16,1952593,1657819,3610412,1952593,1657819,3610412,Basketball
107607,2019,197869,Appalachian State University,Boone,NC,28608,1,NCAA Division I-FBS,7235,9322,16557,1,"Public, 4-year or above",2,15,18,1978717,1665332,3644049,1978717,1665332,3644049,Basketball
12574,2015,211088,Arcadia University,Glenside,PA,190383295,7,NCAA Division III without football,737,1642,2379,2,"Private nonprofit, 4-year or above",2,21,15,125689,124644,250333,125689,124644,250333,Basketball
30024,2016,211088,Arcadia University,Glenside,PA,19038,7,NCAA Division III without football,692,1570,2262,2,"Private nonprofit, 4-year or above",2,15,13,118009,116013,234022,118009,116013,234022,Basketball
47520,2017,211088,Arcadia University,Glenside,PA,19038,7,NCAA Division III without football,678,1497,2175,2,"Private nonprofit, 4-year or above",2,15,12,115578,114696,230274,115578,114696,230274,Basketball
65270,2018,211088,Arcadia University,Glenside,PA,19038,7,NCAA Division III without football,624,1325,1949,2,"Private nonprofit, 4-year or above",2,17,20,124468,112677,237145,124468,112677,237145,Basketball
114399,2019,211088,Arcadia University,Glenside,PA,19038,7,NCAA Division III without football,634,1295,1929,2,"Private nonprofit, 4-year or above",2,17,19,113519,107756,221275,113519,107756,221275,Basketball
313,2015,104151,Arizona State University-Tempe,Tempe,AZ,85287,1,NCAA Division I-FBS,21333,16420,37753,1,"Public, 4-year or above",2,15,39,7223131,702603,7925734,6199000,3537229,9736229,Basketball
17655,2016,104151,Arizona State University-Tempe,Tempe,AZ,85287,1,NCAA Division I-FBS,22020,16741,38761,1,"Public, 4-year or above",2,16,45,7693224,797215,8490439,6581872,3724553,10306425,Basketball
35072,2017,104151,Arizona State University-Tempe,Tempe,AZ,85287,1,NCAA Division I-FBS,21779,16855,38634,1,"Public, 4-year or above",2,19,40,8622647,890343,9512990,7972900,4044625,12017525,Basketball
52700,2018,104151,Arizona State University-Tempe,Tempe,AZ,85287,1,NCAA Division I-FBS,21732,17473,39205,1,"Public, 4-year or above",2,18,38,10609465,938604,11548069,8349598,3995174,12344772,Basketball
71638,2019,104151,Arizona State University-Tempe,Tempe,AZ,85287,1,NCAA Division I-FBS,22447,18511,40958,1,"Public, 4-year or above",2,17,40,9776983,711301,10488284,8244857,3905463,12150320,Basketball
502,2015,106458,Arkansas State University-Main Campus,Jonesboro,AR,72401,1,NCAA Division I-FBS,3163,4059,7222,1,"Public, 4-year or above",2,13,14,1389844,1262719,2652563,1389844,1262719,2652563,Basketball
17848,2016,106458,Arkansas State University-Main Campus,Jonesboro,AR,72401,1,NCAA Division I-FBS,3198,4050,7248,1,"Public, 4-year or above",2,14,14,1523524,1215377,2738901,1523524,1215377,2738901,Basketball
35276,2017,106458,Arkansas State University-Main Campus,Jonesboro,AR,72401,1,NCAA Division I-FBS,2944,3916,6860,1,"Public, 4-year or above",2,16,15,1589502,1218311,2807813,1589502,1218311,2807813,Basketball
52895,2018,106458,Arkansas State University-Main Campus,Jonesboro,AR,72401,1,NCAA Division I-FBS,2869,3889,6758,1,"Public, 4-year or above",2,14,15,1578156,1280194,2858350,1578156,1280194,2858350,Basketball
72375,2019,106458,Arkansas State University-Main Campus,Jonesboro,AR,72401,1,NCAA Division I-FBS,2710,3675,6385,1,"Public, 4-year or above",2,16,17,1647193,1285533,2932726,1647193,1285533,2932726,Basketball
511,2015,106467,Arkansas Tech University,Russellville,AR,728012222,4,NCAA Division II with football,3353,3688,7041,1,"Public, 4-year or above",2,17,15,411043,466932,877975,411043,466932,877975,Basketball
17857,2016,106467,Arkansas Tech University,Russellville,AR,72801,4,NCAA Division II with football,3192,3581,6773,1,"Public, 4-year or above",2,23,15,406566,478666,885232,406566,478666,885232,Basketball
35285,2017,106467,Arkansas Tech University,Russellville,AR,72801,4,NCAA Division II with football,3208,3490,6698,1,"Public, 4-year or above",2,17,13,416146,439622,855768,418584,444841,863425,Basketball
52904,2018,106467,Arkansas Tech University,Russellville,AR,72801,4,NCAA Division II with football,3027,3338,6365,1,"Public, 4-year or above",2,17,13,416944,444419,861363,424128,438595,862723,Basketball
72384,2019,106467,Arkansas Tech University,Russellville,AR,72801,4,NCAA Division II with football,3104,3444,6548,1,"Public, 4-year or above",2,15,16,435130,462544,897674,435130,462544,897674,Basketball
3149,2015,138789,Armstrong State University,Savannah,GA,314191997,5,NCAA Division II without football,1549,3071,4620,1,"Public, 4-year or above",2,17,16,441595,396363,837958,441595,396363,837958,Basketball
11405,2015,201104,Ashland University,Ashland,OH,44805,4,NCAA Division II with football,955,1540,2495,2,"Private nonprofit, 4-year or above",2,18,12,523031,509156,1032187,523031,509156,1032187,Basketball
28842,2016,201104,Ashland University,Ashland,OH,44805,4,NCAA Division II with football,1614,1648,3262,2,"Private nonprofit, 4-year or above",2,28,12,531920,561638,1093558,531920,561638,1093558,Basketball
46343,2017,201104,Ashland University,Ashland,OH,44805,4,NCAA Division II with football,1555,1673,3228,2,"Private nonprofit, 4-year or above",2,21,12,562294,639655,1201949,562294,639655,1201949,Basketball
64064,2018,201104,Ashland University,Ashland,OH,44805,4,NCAA Division II with football,1580,1744,3324,2,"Private nonprofit, 4-year or above",2,24,14,601260,704627,1305887,601260,704627,1305887,Basketball
110145,2019,201104,Ashland University,Ashland,OH,44805,4,NCAA Division II with football,1099,1499,2598,2,"Private nonprofit, 4-year or above",2,25,13,553432,572767,1126199,553432,572767,1126199,Basketball
6364,2015,164562,Assumption College,Worcester,MA,16091296,4,NCAA Division II with football,809,1195,2004,2,"Private nonprofit, 4-year or above",2,16,14,789997,754323,1544320,762144,740446,1502590,Basketball
23747,2016,164562,Assumption College,Worcester,MA,1609,4,NCAA Division II with football,828,1154,1982,2,"Private nonprofit, 4-year or above",2,11,14,739968,758721,1498689,698383,739040,1437423,Basketball
41252,2017,164562,Assumption College,Worcester,MA,1609,4,NCAA Division II with football,821,1115,1936,2,"Private nonprofit, 4-year or above",2,13,14,733610,778307,1511917,681236,737024,1418260,Basketball
58951,2018,164562,Assumption College,Worcester,MA,1609,4,NCAA Division II with football,832,1098,1930,2,"Private nonprofit, 4-year or above",2,15,14,808273,769629,1577902,771218,749378,1520596,Basketball
92936,2019,164562,Assumption College,Worcester,MA,1609,4,NCAA Division II with football,847,1099,1946,2,"Private nonprofit, 4-year or above",2,17,15,702429,840583,1543012,659704,807222,1466926,Basketball
63,2015,100858,Auburn University,Auburn University,AL,36849,1,NCAA Division I-FBS,9792,9833,19625,1,"Public, 4-year or above",2,16,24,11662504,292645,11955149,8821985,3959159,12781144,Basketball
17410,2016,100858,Auburn University,Auburn,AL,36849,1,NCAA Division I-FBS,10026,10234,20260,1,"Public, 4-year or above",2,21,26,9900612,280354,10180966,9632816,4354732,13987548,Basketball
34825,2017,100858,Auburn University,Auburn,AL,36849,1,NCAA Division I-FBS,10584,10848,21432,1,"Public, 4-year or above",2,15,23,11214964,264856,11479820,9446382,4362024,13808406,Basketball
52454,2018,100858,Auburn University,Auburn,AL,36849,1,NCAA Division I-FBS,11183,11053,22236,1,"Public, 4-year or above",2,19,21,15593947,538944,16132891,10536653,4536994,15073647,Basketball
70401,2019,100858,Auburn University,Auburn,AL,36849,1,NCAA Division I-FBS,11379,10985,22364,1,"Public, 4-year or above",2,20,15,12258411,241272,12499683,11775810,4284371,16060181,Basketball
57,2015,100830,Auburn University at Montgomery,Montgomery,AL,361173596,5,NCAA Division II without football,1080,1998,3078,1,"Public, 4-year or above",2,14,13,427164,391773,818937,427164,391773,818937,Basketball
17403,2016,100830,Auburn University at Montgomery,Montgomery,AL,36117,5,NCAA Division II without football,1085,2005,3090,1,"Public, 4-year or above",2,14,12,409574,400761,810335,409574,400761,810335,Basketball
34818,2017,100830,Auburn University at Montgomery,Montgomery,AL,36117,5,NCAA Division II without football,1169,2067,3236,1,"Public, 4-year or above",2,15,12,413050,412737,825787,416200,419402,835602,Basketball
52447,2018,100830,Auburn University at Montgomery,Montgomery,AL,36117,5,NCAA Division II without football,1207,2340,3547,1,"Public, 4-year or above",2,15,13,434962,469495,904457,411685,456907,868592,Basketball
70363,2019,100830,Auburn University at Montgomery,Montgomery,AL,36117,5,NCAA Division II without football,1218,2270,3488,1,"Public, 4-year or above",2,16,14,490231,476081,966312,468650,459904,928554,Basketball
7470,2015,173045,Augsburg College,Minneapolis,MN,55454,6,NCAA Division III with football,985,979,1964,2,"Private nonprofit, 4-year or above",2,21,15,188905,129041,317946,188905,129041,317946,Basketball
24882,2016,173045,Augsburg College,Minneapolis,MN,55454,6,NCAA Division III with football,1012,1050,2062,2,"Private nonprofit, 4-year or above",2,22,15,179110,149286,328396,179110,149286,328396,Basketball
42382,2017,173045,Augsburg University,Minneapolis,MN,55454,6,NCAA Division III with football,969,1060,2029,2,"Private nonprofit, 4-year or above",2,18,13,207382,143326,350708,207382,143326,350708,Basketball
60085,2018,173045,Augsburg University,Minneapolis,MN,55454,6,NCAA Division III with football,944,1039,1983,2,"Private nonprofit, 4-year or above",2,25,19,212330,148210,360540,212330,148210,360540,Basketball
96402,2019,173045,Augsburg University,Minneapolis,MN,55454,6,NCAA Division III with football,974,1192,2166,2,"Private nonprofit, 4-year or above",2,23,19,220093,162324,382417,220093,162324,382417,Basketball
17266,2015,482149,Augusta University,Augusta,GA,30912,5,NCAA Division II without football,1365,2582,3947,1,"Public, 4-year or above",2,16,15,417860,333618,751478,417860,333618,751478,Basketball
34672,2016,482149,Augusta University,Augusta,GA,30912,5,NCAA Division II without football,1455,2623,4078,1,"Public, 4-year or above",2,16,15,501372,416029,917401,498927,413472,912399,Basketball
52287,2017,482149,Augusta University,Augusta,GA,30912,5,NCAA Division II without football,1444,2741,4185,1,"Public, 4-year or above",2,16,15,550063,348958,899021,550063,348958,899021,Basketball
70053,2018,482149,Augusta University,Augusta,GA,30912,5,NCAA Division II without football,1481,2874,4355,1,"Public, 4-year or above",2,14,15,584812,427337,1012149,584812,427336,1012148,Basketball
131908,2019,482149,Augusta University,Augusta,GA,30912,5,NCAA Division II without football,1540,2964,4504,1,"Public, 4-year or above",2,17,15,582874,417608,1000482,582874,417608,1000482,Basketball
3589,2015,143084,Augustana College,Rock Island,IL,612012296,6,NCAA Division III with football,1030,1413,2443,2,"Private nonprofit, 4-year or above",2,26,16,263398,121841,385239,263398,121841,385239,Basketball
20959,2016,143084,Augustana College,Rock Island,IL,61201,6,NCAA Division III with football,1074,1440,2514,2,"Private nonprofit, 4-year or above",2,20,20,320257,207568,527825,320257,207568,527825,Basketball
38416,2017,143084,Augustana College,Rock Island,IL,61201,6,NCAA Division III with football,1110,1516,2626,2,"Private nonprofit, 4-year or above",2,22,20,325441,145376,470817,325441,145376,470817,Basketball
56069,2018,143084,Augustana College,Rock Island,IL,61201,6,NCAA Division III with football,1094,1429,2523,2,"Private nonprofit, 4-year or above",2,18,21,409478,198146,607624,409478,198146,607624,Basketball
83149,2019,143084,Augustana College,Rock Island,IL,61201,6,NCAA Division III with football,1102,1421,2523,2,"Private nonprofit, 4-year or above",2,21,19,323523,148685,472208,323523,148685,472208,Basketball
14179,2015,219000,Augustana University,Sioux Falls,SD,571970001,4,NCAA Division II with football,602,894,1496,2,"Private nonprofit, 4-year or above",2,21,18,981115,664145,1645260,981115,664145,1645260,Basketball
31637,2016,219000,Augustana University,Sioux Falls,SD,57197,4,NCAA Division II with football,617,936,1553,2,"Private nonprofit, 4-year or above",2,26,17,864804,718609,1583413,864804,718609,1583413,Basketball
49153,2017,219000,Augustana University,Sioux Falls,SD,57197,4,NCAA Division II with football,631,1028,1659,2,"Private nonprofit, 4-year or above",2,16,17,920722,718806,1639528,920722,718806,1639528,Basketball
66916,2018,219000,Augustana University,Sioux Falls,SD,57197,4,NCAA Division II with football,621,1078,1699,2,"Private nonprofit, 4-year or above",2,16,17,809276,752345,1561621,809276,752345,1561621,Basketball
119524,2019,219000,Augustana University,Sioux Falls,SD,57197,4,NCAA Division II with football,618,1092,1710,2,"Private nonprofit, 4-year or above",2,18,17,844415,720623,1565038,844415,720623,1565038,Basketball
3601,2015,143118,Aurora University,Aurora,IL,605064892,6,NCAA Division III with football,1174,1958,3132,2,"Private nonprofit, 4-year or above",2,27,17,132681,158043,290724,130516,157687,288203,Basketball
20971,2016,143118,Aurora University,Aurora,IL,60506,6,NCAA Division III with football,1218,2084,3302,2,"Private nonprofit, 4-year or above",2,30,18,167019,161010,328029,164419,161010,325429,Basketball
38429,2017,143118,Aurora University,Aurora,IL,60506,6,NCAA Division III with football,1278,2183,3461,2,"Private nonprofit, 4-year or above",2,38,21,193329,166771,360100,187953,166771,354724,Basketball
56082,2018,143118,Aurora University,Aurora,IL,60506,6,NCAA Division III with football,1268,2269,3537,2,"Private nonprofit, 4-year or above",2,36,17,205149,117998,323147,202636,117998,320634,Basketball
83187,2019,143118,Aurora University,Aurora,IL,60506,6,NCAA Division III with football,1303,2376,3679,2,"Private nonprofit, 4-year or above",2,35,19,204280,135842,340122,202280,135842,338122,Basketball
14651,2015,222983,Austin College,Sherman,TX,750904400,6,NCAA Division III with football,585,640,1225,2,"Private nonprofit, 4-year or above",2,20,24,109640,134890,244530,109640,134890,244530,Basketball
32121,2016,222983,Austin College,Sherman,TX,75090,6,NCAA Division III with football,610,648,1258,2,"Private nonprofit, 4-year or above",2,24,24,107046,104350,211396,107046,104350,211396,Basketball
49642,2017,222983,Austin College,Sherman,TX,75090,6,NCAA Division III with football,589,615,1204,2,"Private nonprofit, 4-year or above",2,16,20,105529,122443,227972,105529,122443,227972,Basketball
67412,2018,222983,Austin College,Sherman,TX,75090,6,NCAA Division III with football,623,652,1275,2,"Private nonprofit, 4-year or above",2,17,19,129617,130208,259825,129617,130208,259825,Basketball
121364,2019,222983,Austin College,Sherman,TX,75090,6,NCAA Division III with football,619,671,1290,2,"Private nonprofit, 4-year or above",2,17,19,119727,125575,245302,119727,125575,245302,Basketball
14273,2015,219602,Austin Peay State University,Clarksville,TN,37044,2,NCAA Division I-FCS,2697,4041,6738,1,"Public, 4-year or above",2,15,14,1338794,858856,2197650,1304155,849613,2153768,Basketball
31735,2016,219602,Austin Peay State University,Clarksville,TN,37044,2,NCAA Division I-FCS,2828,4107,6935,1,"Public, 4-year or above",2,15,14,1362961,914370,2277331,1347568,901387,2248955,Basketball
49249,2017,219602,Austin Peay State University,Clarksville,TN,37044,2,NCAA Division I-FCS,2857,4199,7056,1,"Public, 4-year or above",2,14,16,2021134,958276,2979410,1906154,1001493,2907647,Basketball
67018,2018,219602,Austin Peay State University,Clarksville,TN,37044,2,NCAA Division I-FCS,2798,4144,6942,1,"Public, 4-year or above",2,15,13,2338400,970360,3308760,1904820,960807,2865627,Basketball
119878,2019,219602,Austin Peay State University,Clarksville,TN,37044,2,NCAA Division I-FCS,2689,4022,6711,1,"Public, 4-year or above",2,14,14,525037,55934,580971,1689453,1037591,2727044,Basketball
15567,2015,231420,Averett University,Danville,VA,24541,6,NCAA Division III with football,422,426,848,2,"Private nonprofit, 4-year or above",2,20,14,161190,127660,288850,161190,127660,288850,Basketball
33036,2016,231420,Averett University,Danville,VA,24541,6,NCAA Division III with football,424,404,828,2,"Private nonprofit, 4-year or above",2,20,14,146341,118257,264598,146341,118257,264598,Basketball
50571,2017,231420,Averett University,Danville,VA,24541,6,NCAA Division III with football,494,396,890,2,"Private nonprofit, 4-year or above",2,21,12,131861,111229,243090,131861,111229,243090,Basketball
68316,2018,231420,Averett University,Danville,VA,24541,6,NCAA Division III with football,538,392,930,2,"Private nonprofit, 4-year or above",2,18,16,128669,117364,246033,128669,117364,246033,Basketball
125167,2019,231420,Averett University,Danville,VA,24541,6,NCAA Division III with football,490,378,868,2,"Private nonprofit, 4-year or above",2,20,14,147678,107659,255337,147678,107659,255337,Basketball
674,2015,109785,Azusa Pacific University,Azusa,CA,917027000,4,NCAA Division II with football,1893,3463,5356,2,"Private nonprofit, 4-year or above",2,16,22,831931,544060,1375991,748923,545985,1294908,Basketball
18021,2016,109785,Azusa Pacific University,Azusa,CA,91702,4,NCAA Division II with football,1803,3456,5259,2,"Private nonprofit, 4-year or above",2,16,15,847944,676796,1524740,808212,655711,1463923,Basketball
35455,2017,109785,Azusa Pacific University,Azusa,CA,91702,4,NCAA Division II with football,1726,3244,4970,2,"Private nonprofit, 4-year or above",2,16,20,892823,686773,1579596,860623,678914,1539537,Basketball
53076,2018,109785,Azusa Pacific University,Azusa,CA,91702,4,NCAA Division II with football,1730,3164,4894,2,"Private nonprofit, 4-year or above",2,15,19,774239,685027,1459266,753364,664570,1417934,Basketball
73162,2019,109785,Azusa Pacific University,Azusa,CA,91702,4,NCAA Division II with football,1541,2862,4403,2,"Private nonprofit, 4-year or above",2,16,16,692739,611253,1303992,661304,605798,1267102,Basketball
6378,2015,164580,Babson College,Wellesley,MA,24570310,7,NCAA Division III without football,1105,1036,2141,2,"Private nonprofit, 4-year or above",2,16,14,196107,189486,385593,196107,189486,385593,Basketball
23761,2016,164580,Babson College,Wellesley,MA,2457,7,NCAA Division III without football,1198,1085,2283,2,"Private nonprofit, 4-year or above",2,15,16,282433,228612,511045,278424,208009,486433,Basketball
41266,2017,164580,Babson College,Wellesley,MA,2457,7,NCAA Division III without football,1210,1132,2342,2,"Private nonprofit, 4-year or above",2,14,16,258950,175648,434598,258950,175648,434598,Basketball
58965,2018,164580,Babson College,Wellesley,MA,2457,7,NCAA Division III without football,1220,1141,2361,2,"Private nonprofit, 4-year or above",2,14,16,241637,253716,495353,241637,253716,495353,Basketball
92950,2019,164580,Babson College,Babson Park,MA,2457,7,NCAA Division III without football,1251,1073,2324,2,"Private nonprofit, 4-year or above",2,16,15,251211,234529,485740,251211,234529,485740,Basketball
11416,2015,201195,Baldwin Wallace University,Berea,OH,440172088,6,NCAA Division III with football,1386,1634,3020,2,"Private nonprofit, 4-year or above",2,24,21,180496,185994,366490,180496,185994,366490,Basketball
28853,2016,201195,Baldwin Wallace University,Berea,OH,44017,6,NCAA Division III with football,1393,1620,3013,2,"Private nonprofit, 4-year or above",2,21,19,215263,193703,408966,215263,193703,408966,Basketball
46355,2017,201195,Baldwin Wallace University,Berea,OH,44017,6,NCAA Division III with football,1350,1583,2933,2,"Private nonprofit, 4-year or above",2,20,20,206881,201712,408593,206881,201712,408593,Basketball
64077,2018,201195,Baldwin Wallace University,Berea,OH,44017,6,NCAA Division III with football,1336,1538,2874,2,"Private nonprofit, 4-year or above",2,19,17,194518,187291,381809,194518,187291,381809,Basketball
110158,2019,201195,Baldwin Wallace University,Berea,OH,44017,6,NCAA Division III with football,1280,1487,2767,2,"Private nonprofit, 4-year or above",2,20,19,195557,187845,383402,195557,187845,383402,Basketball
4321,2015,150136,Ball State University,Muncie,IN,47306,1,NCAA Division I-FBS,5993,8634,14627,1,"Public, 4-year or above",2,17,14,1905730,1615646,3521376,1905730,1615646,3521376,Basketball
21690,2016,150136,Ball State University,Muncie,IN,47306,1,NCAA Division I-FBS,6144,8874,15018,1,"Public, 4-year or above",2,15,15,1922864,2119723,4042587,1922864,2119723,4042587,Basketball
39158,2017,150136,Ball State University,Muncie,IN,47306,1,NCAA Division I-FBS,6190,8938,15128,1,"Public, 4-year or above",2,16,26,1994305,1693597,3687902,1994305,1693597,3687902,Basketball
56818,2018,150136,Ball State University,Muncie,IN,47306,1,NCAA Division I-FBS,5922,8662,14584,1,"Public, 4-year or above",2,15,22,1975432,1525995,3501427,1975432,1525995,3501427,Basketball
85962,2019,150136,Ball State University,Muncie,IN,47306,1,NCAA Division I-FBS,5892,8856,14748,1,"Public, 4-year or above",2,14,26,1877688,1625727,3503415,1877688,1625727,3503415,Basketball
9409,2015,189088,Bard College,Annandale-On-Hudson,NY,125045000,7,NCAA Division III without football,869,1064,1933,2,"Private nonprofit, 4-year or above",2,15,10,150567,73658,224225,96440,70316,166756,Basketball
26828,2016,189088,Bard College,Annandale-On-Hudson,NY,12504,7,NCAA Division III without football,785,1082,1867,2,"Private nonprofit, 4-year or above",2,14,10,195633,105161,300794,150928,104599,255527,Basketball
44319,2017,189088,Bard College,Annandale,NY,12504,7,NCAA Division III without football,755,1048,1803,2,"Private nonprofit, 4-year or above",2,15,13,215991,113493,329484,147945,112361,260306,Basketball
62042,2018,189088,Bard College,Annandale,NY,12504,7,NCAA Division III without football,719,1047,1766,2,"Private nonprofit, 4-year or above",2,14,11,266475,135054,401529,208168,132508,340676,Basketball
103402,2019,189088,Bard College,Annandale,NY,12504,7,NCAA Division III without football,719,1095,1814,2,"Private nonprofit, 4-year or above",2,12,9,152186,127900,280086,137341,127900,265241,Basketball
2689,2015,132471,Barry University,Miami,FL,331616695,5,NCAA Division II without football,1180,1955,3135,2,"Private nonprofit, 4-year or above",2,17,17,597031,515634,1112665,597031,515634,1112665,Basketball
20062,2016,132471,Barry University,Miami,FL,33161,5,NCAA Division II without football,1058,1831,2889,2,"Private nonprofit, 4-year or above",2,19,16,619287,528915,1148202,619287,528915,1148202,Basketball
37501,2017,132471,Barry University,Miami,FL,33161,5,NCAA Division II without football,1129,1834,2963,2,"Private nonprofit, 4-year or above",2,18,16,692976,574541,1267517,692976,574541,1267517,Basketball
55145,2018,132471,Barry University,Miami,FL,33161,5,NCAA Division II without football,1082,1867,2949,2,"Private nonprofit, 4-year or above",2,17,14,647423,582790,1230213,647423,582790,1230213,Basketball
79695,2019,132471,Barry University,Miami,FL,33161,5,NCAA Division II without football,1045,1950,2995,2,"Private nonprofit, 4-year or above",2,20,16,700718,591856,1292574,700718,591856,1292574,Basketball
10776,2015,197911,Barton College,Wilson,NC,278937000,5,NCAA Division II without football,288,622,910,2,"Private nonprofit, 4-year or above",2,17,17,410789,365665,776454,409153,378582,787735,Basketball
28208,2016,197911,Barton College,Wilson,NC,27893,5,NCAA Division II without football,294,609,903,2,"Private nonprofit, 4-year or above",2,18,17,428419,386619,815038,415863,383896,799759,Basketball
45706,2017,197911,Barton College,Wilson,NC,27893,5,NCAA Division II without football,265,565,830,2,"Private nonprofit, 4-year or above",2,19,18,462912,404698,867610,462912,404698,867610,Basketball
63417,2018,197911,Barton College,Wilson,NC,27893,5,NCAA Division II without football,358,572,930,2,"Private nonprofit, 4-year or above",2,20,17,441824,445048,886872,441824,445048,886872,Basketball
107645,2019,197911,Barton College,Wilson,NC,27893,5,NCAA Division II without football,430,560,990,2,"Private nonprofit, 4-year or above",2,19,18,474352,457946,932298,474352,457946,932298,Basketball
5889,2015,160977,Bates College,Lewiston,ME,4240,6,NCAA Division III with football,884,908,1792,2,"Private nonprofit, 4-year or above",2,18,16,210753,161697,372450,189348,137545,326893,Basketball
23273,2016,160977,Bates College,Lewiston,ME,4240,6,NCAA Division III with football,881,899,1780,2,"Private nonprofit, 4-year or above",2,18,14,284142,246029,530171,248397,209599,457996,Basketball
40773,2017,160977,Bates College,Lewiston,ME,4240,6,NCAA Division III with football,882,905,1787,2,"Private nonprofit, 4-year or above",2,17,14,317620,259526,577146,283049,241931,524980,Basketball
58456,2018,160977,Bates College,Lewiston,ME,4240,6,NCAA Division III with football,920,912,1832,2,"Private nonprofit, 4-year or above",2,18,15,237547,195799,433346,227540,195723,423263,Basketball
91295,2019,160977,Bates College,Lewiston,ME,4240,6,NCAA Division III with football,914,906,1820,2,"Private nonprofit, 4-year or above",2,15,13,223597,192335,415932,208622,203367,411989,Basketball
14660,2015,223232,Baylor University,Waco,TX,76798,1,NCAA Division I-FBS,5812,8099,13911,2,"Private nonprofit, 4-year or above",2,18,40,8837724,7277627,16115351,8837724,7277627,16115351,Basketball
32130,2016,223232,Baylor University,Waco,TX,76798,1,NCAA Division I-FBS,5915,8172,14087,2,"Private nonprofit, 4-year or above",2,14,31,9097264,7568184,16665448,9097264,7568184,16665448,Basketball
49651,2017,223232,Baylor University,Waco,TX,76798,1,NCAA Division I-FBS,5801,8284,14085,2,"Private nonprofit, 4-year or above",2,15,33,9185513,8038038,17223551,9185513,8038038,17223551,Basketball
67422,2018,223232,Baylor University,Waco,TX,76798,1,NCAA Division I-FBS,5632,8327,13959,2,"Private nonprofit, 4-year or above",2,17,39,9860432,9485162,19345594,9860432,9485162,19345594,Basketball
121402,2019,223232,Baylor University,Waco,TX,76798,1,NCAA Division I-FBS,5521,8236,13757,2,"Private nonprofit, 4-year or above",2,15,33,9790607,8323428,18114035,9790607,8323428,18114035,Basketball
6391,2015,164720,Becker College,Worcester,MA,16092165,6,NCAA Division III with football,734,847,1581,2,"Private nonprofit, 4-year or above",2,16,15,84053,66508,150561,84053,66508,150561,Basketball
23774,2016,164720,Becker College,Worcester,MA,1609,6,NCAA Division III with football,732,832,1564,2,"Private nonprofit, 4-year or above",2,15,16,84464,66048,150512,84244,68422,152666,Basketball
41280,2017,164720,Becker College,Worcester,MA,1609,6,NCAA Division III with football,728,800,1528,2,"Private nonprofit, 4-year or above",2,14,17,82464,67068,149532,85254,69540,154794,Basketball
58979,2018,164720,Becker College,Worcester,MA,1609,6,NCAA Division III with football,689,772,1461,2,"Private nonprofit, 4-year or above",2,15,16,81986,68456,150442,84542,68548,153090,Basketball
92988,2019,164720,Becker College,Worcester,MA,1609,6,NCAA Division III with football,624,697,1321,2,"Private nonprofit, 4-year or above",2,13,15,78453,68639,147092,81349,68878,150227,Basketball
7876,2015,175421,Belhaven University,Jackson,MS,39202,6,NCAA Division III with football,536,806,1342,2,"Private nonprofit, 4-year or above",2,21,18,380593,410816,791409,377780,410816,788596,Basketball
25290,2016,175421,Belhaven University,Jackson,MS,39202,6,NCAA Division III with football,548,775,1323,2,"Private nonprofit, 4-year or above",2,19,17,220582,235605,456187,219746,235605,455351,Basketball
42791,2017,175421,Belhaven University,Jackson,MS,39202,6,NCAA Division III with football,507,735,1242,2,"Private nonprofit, 4-year or above",2,18,14,195804,182472,378276,193357,182372,375729,Basketball
60496,2018,175421,Belhaven University,Jackson,MS,39202,6,NCAA Division III with football,473,679,1152,2,"Private nonprofit, 4-year or above",2,26,16,169259,165093,334352,169163,165093,334256,Basketball
97737,2019,175421,Belhaven University,Jackson,MS,39202,6,NCAA Division III with football,489,667,1156,2,"Private nonprofit, 4-year or above",2,30,14,203006,170447,373453,203006,170447,373453,Basketball
5465,2015,156286,Bellarmine University,Louisville,KY,402050671,5,NCAA Division II without football,850,1596,2446,2,"Private nonprofit, 4-year or above",2,18,18,1133013,812326,1945339,1133013,812326,1945339,Basketball
22838,2016,156286,Bellarmine University,Louisville,KY,40205,5,NCAA Division II without football,876,1581,2457,2,"Private nonprofit, 4-year or above",2,15,17,1238849,857418,2096267,1238849,857418,2096267,Basketball
40328,2017,156286,Bellarmine University,Louisville,KY,40205,5,NCAA Division II without football,855,1549,2404,2,"Private nonprofit, 4-year or above",2,14,16,1212484,787973,2000457,1212484,787973,2000457,Basketball
58005,2018,156286,Bellarmine University,Louisville,KY,40205,5,NCAA Division II without football,864,1532,2396,2,"Private nonprofit, 4-year or above",2,17,16,1318815,837777,2156592,1318815,837777,2156592,Basketball
89833,2019,156286,Bellarmine University,Louisville,KY,40205,5,NCAA Division II without football,850,1555,2405,2,"Private nonprofit, 4-year or above",2,16,16,1850526,884819,2735345,1850526,884819,2735345,Basketball
10784,2015,197984,Belmont Abbey College,Belmont,NC,280121802,5,NCAA Division II without football,647,734,1381,2,"Private nonprofit, 4-year or above",2,14,18,420061,357688,777749,420061,357688,777749,Basketball
28218,2016,197984,Belmont Abbey College,Belmont,NC,28012,5,NCAA Division II without football,667,736,1403,2,"Private nonprofit, 4-year or above",2,14,19,487806,423939,911745,487806,423939,911745,Basketball
45716,2017,197984,Belmont Abbey College,Belmont,NC,28012,5,NCAA Division II without football,696,682,1378,2,"Private nonprofit, 4-year or above",2,14,12,484445,432259,916704,484445,432259,916704,Basketball
63427,2018,197984,Belmont Abbey College,Belmont,NC,28012,5,NCAA Division II without football,738,700,1438,2,"Private nonprofit, 4-year or above",2,14,14,501265,459530,960795,501265,459530,960795,Basketball
107683,2019,197984,Belmont Abbey College,Belmont,NC,28012,5,NCAA Division II without football,718,667,1385,2,"Private nonprofit, 4-year or above",2,16,15,474234,434295,908529,474234,434295,908529,Basketball
14283,2015,219709,Belmont University,Nashville,TN,372123757,3,NCAA Division I without football,2138,3479,5617,2,"Private nonprofit, 4-year or above",2,16,16,2951040,1457936,4408976,2951040,1457936,4408976,Basketball
31746,2016,219709,Belmont University,Nashville,TN,37212,3,NCAA Division I without football,2163,3762,5925,2,"Private nonprofit, 4-year or above",2,14,23,2688559,1647069,4335628,2688559,1647069,4335628,Basketball
49260,2017,219709,Belmont University,Nashville,TN,37212,3,NCAA Division I without football,2139,3993,6132,2,"Private nonprofit, 4-year or above",2,16,15,3194309,1704679,4898988,3194309,1704679,4898988,Basketball
67029,2018,219709,Belmont University,Nashville,TN,37212,3,NCAA Division I without football,2191,4158,6349,2,"Private nonprofit, 4-year or above",2,16,15,5129856,1778887,6908743,5129856,1778887,6908743,Basketball
119916,2019,219709,Belmont University,Nashville,TN,37212,3,NCAA Division I without football,2279,4257,6536,2,"Private nonprofit, 4-year or above",2,17,13,2739717,1706512,4446229,2739717,1706512,4446229,Basketball
16439,2015,238333,Beloit College,Beloit,WI,535115595,6,NCAA Division III with football,573,693,1266,2,"Private nonprofit, 4-year or above",2,15,15,113801,100587,214388,113801,100587,214388,Basketball
33914,2016,238333,Beloit College,Beloit,WI,53511,6,NCAA Division III with football,610,700,1310,2,"Private nonprofit, 4-year or above",2,19,14,117900,85904,203804,179556,85904,265460,Basketball
51470,2017,238333,Beloit College,Beloit,WI,53511,6,NCAA Division III with football,629,691,1320,2,"Private nonprofit, 4-year or above",2,22,14,142893,117939,260832,142893,117939,260832,Basketball
69215,2018,238333,Beloit College,Beloit,WI,53511,6,NCAA Division III with football,552,656,1208,2,"Private nonprofit, 4-year or above",2,22,11,140982,115005,255987,140982,115005,255987,Basketball
128496,2019,238333,Beloit College,Beloit,WI,53511,6,NCAA Division III with football,491,572,1063,2,"Private nonprofit, 4-year or above",2,24,11,114653,113007,227660,114653,113007,227660,Basketball
7487,2015,173124,Bemidji State University,Bemidji,MN,56601,4,NCAA Division II with football,1560,1810,3370,1,"Public, 4-year or above",2,16,13,388469,359902,748371,388469,359902,748371,Basketball
24899,2016,173124,Bemidji State University,Bemidji,MN,56601,4,NCAA Division II with football,1579,1821,3400,1,"Public, 4-year or above",2,14,16,395167,365085,760252,395167,365085,760252,Basketball
42399,2017,173124,Bemidji State University,Bemidji,MN,56601,4,NCAA Division II with football,1501,1803,3304,1,"Public, 4-year or above",2,17,15,304143,344067,648210,304143,344067,648210,Basketball
60101,2018,173124,Bemidji State University,Bemidji,MN,56601,4,NCAA Division II with football,1537,1721,3258,1,"Public, 4-year or above",2,15,15,433499,382510,816009,433499,382510,816009,Basketball
96445,2019,173124,Bemidji State University,Bemidji,MN,56601,4,NCAA Division II with football,1421,1596,3017,1,"Public, 4-year or above",2,13,18,421831,417536,839367,421831,417536,839367,Basketball
13914,2015,217721,Benedict College,Columbia,SC,292041086,4,NCAA Division II with football,1255,1181,2436,2,"Private nonprofit, 4-year or above",2,18,14,489350,412070,901420,489350,412070,901420,Basketball
31367,2016,217721,Benedict College,Columbia,SC,29204,4,NCAA Division II with football,1164,1085,2249,2,"Private nonprofit, 4-year or above",2,17,15,528030,352034,880064,528030,352034,880064,Basketball
48880,2017,217721,Benedict College,Columbia,SC,29204,4,NCAA Division II with football,1016,1061,2077,2,"Private nonprofit, 4-year or above",2,13,13,462528,377944,840472,462528,377944,840472,Basketball
66637,2018,217721,Benedict College,Columbia,SC,29204,4,NCAA Division II with football,1008,1106,2114,2,"Private nonprofit, 4-year or above",2,16,19,468207,328636,796843,463065,325617,788682,Basketball
118369,2019,217721,Benedict College,Columbia,SC,29204,4,NCAA Division II with football,891,1121,2012,2,"Private nonprofit, 4-year or above",2,18,18,508200,412171,920371,501879,407630,909509,Basketball
3779,2015,145619,Benedictine University,Lisle,IL,605320900,6,NCAA Division III with football,1213,1520,2733,2,"Private nonprofit, 4-year or above",2,39,16,327242,205426,532668,302338,201755,504093,Basketball
21149,2016,145619,Benedictine University,Lisle,IL,60532,6,NCAA Division III with football,1202,1485,2687,2,"Private nonprofit, 4-year or above",2,57,38,416310,352965,769275,378595,343935,722530,Basketball
38604,2017,145619,Benedictine University,Lisle,IL,60532,6,NCAA Division III with football,1096,1369,2465,2,"Private nonprofit, 4-year or above",2,52,45,455304,453288,908592,413413,423926,837339,Basketball
56261,2018,145619,Benedictine University,Lisle,IL,60532,6,NCAA Division III with football,1076,1288,2364,2,"Private nonprofit, 4-year or above",2,50,47,531711,382511,914222,463197,354476,817673,Basketball
84022,2019,145619,Benedictine University,Lisle,IL,60532,6,NCAA Division III with football,1006,1123,2129,2,"Private nonprofit, 4-year or above",2,57,46,965963,838932,1804895,783566,986523,1770089,Basketball
6403,2015,164739,Bentley University,Waltham,MA,24524705,4,NCAA Division II with football,2425,1651,4076,2,"Private nonprofit, 4-year or above",2,15,13,996396,993567,1989963,971754,994300,1966054,Basketball
23786,2016,164739,Bentley University,Waltham,MA,2452,4,NCAA Division II with football,2409,1667,4076,2,"Private nonprofit, 4-year or above",2,14,14,964896,998887,1963783,958414,997306,1955720,Basketball
41292,2017,164739,Bentley University,Waltham,MA,2452,4,NCAA Division II with football,2424,1687,4111,2,"Private nonprofit, 4-year or above",2,12,15,1048098,1107509,2155607,1044213,1103802,2148015,Basketball
58989,2018,164739,Bentley University,Waltham,MA,2452,4,NCAA Division II with football,2461,1650,4111,2,"Private nonprofit, 4-year or above",2,12,12,1096176,1115187,2211363,1097420,1102801,2200221,Basketball
93026,2019,164739,Bentley University,Waltham,MA,2452,4,NCAA Division II with football,2432,1676,4108,2,"Private nonprofit, 4-year or above",2,15,13,1108186,1145896,2254082,1102954,1134302,2237256,Basketball
5476,2015,156295,Berea College,Berea,KY,404042182,7,NCAA Division III without football,673,917,1590,2,"Private nonprofit, 4-year or above",2,17,11,154957,107092,262049,154957,107092,262049,Basketball
22850,2016,156295,Berea College,Berea,KY,40404,7,NCAA Division III without football,698,912,1610,2,"Private nonprofit, 4-year or above",2,14,11,153909,106977,260886,153909,106977,260886,Basketball
40340,2017,156295,Berea College,Berea,KY,40404,7,NCAA Division III without football,680,929,1609,2,"Private nonprofit, 4-year or above",2,13,14,162357,106345,268702,162357,106345,268702,Basketball
58017,2018,156295,Berea College,Berea,KY,40404,7,NCAA Division III without football,693,933,1626,2,"Private nonprofit, 4-year or above",2,14,13,155205,110864,266069,155205,110864,266069,Basketball
89871,2019,156295,Berea College,Berea,KY,40404,7,NCAA Division III without football,693,956,1649,2,"Private nonprofit, 4-year or above",2,15,14,171480,114299,285779,171480,114299,285779,Basketball
3176,2015,139144,Berry College,Mount Berry,GA,30149,6,NCAA Division III with football,790,1284,2074,2,"Private nonprofit, 4-year or above",2,21,17,197593,187120,384713,195573,184690,380263,Basketball
20540,2016,139144,Berry College,Mount Berry,GA,30149,6,NCAA Division III with football,812,1234,2046,2,"Private nonprofit, 4-year or above",2,19,18,208919,228357,437276,197365,224752,422117,Basketball
37999,2017,139144,Berry College,Mount Berry,GA,30149,6,NCAA Division III with football,761,1181,1942,2,"Private nonprofit, 4-year or above",2,19,14,259052,213413,472465,240455,206606,447061,Basketball
55651,2018,139144,Berry College,Mount Berry,GA,30149,6,NCAA Division III with football,738,1160,1898,2,"Private nonprofit, 4-year or above",2,16,14,210712,212257,422969,201829,206779,408608,Basketball
81837,2019,139144,Berry College,Mount Berry,GA,30149,6,NCAA Division III with football,751,1158,1909,2,"Private nonprofit, 4-year or above",2,17,17,225231,219823,445054,221678,213853,435531,Basketball
16251,2015,237181,Bethany College,Bethany,WV,26032,6,NCAA Division III with football,416,280,696,2,"Private nonprofit, 4-year or above",2,16,16,134011,91143,225154,134011,91143,225154,Basketball
33725,2016,237181,Bethany College,Bethany,WV,26032,6,NCAA Division III with football,387,244,631,2,"Private nonprofit, 4-year or above",2,15,14,140568,93237,233805,140568,93237,233805,Basketball
51279,2017,237181,Bethany College,Bethany,WV,26032,6,NCAA Division III with football,360,233,593,2,"Private nonprofit, 4-year or above",2,19,25,114019,76735,190754,114019,76735,190754,Basketball
69027,2018,237181,Bethany College,Bethany,WV,26032,6,NCAA Division III with football,332,221,553,2,"Private nonprofit, 4-year or above",2,18,19,114541,80410,194951,114541,80410,194951,Basketball
127917,2019,237181,Bethany College,Bethany,WV,26032,6,NCAA Division III with football,278,223,501,2,"Private nonprofit, 4-year or above",2,15,12,179072,116294,295366,179072,116294,295366,Basketball
7499,2015,173142,Bethany Lutheran College,Mankato,MN,56001,7,NCAA Division III without football,220,258,478,2,"Private nonprofit, 4-year or above",2,18,15,76456,81825,158281,68517,71365,139882,Basketball
24911,2016,173142,Bethany Lutheran College,Mankato,MN,56001,7,NCAA Division III without football,219,285,504,2,"Private nonprofit, 4-year or above",2,16,16,103062,71869,174931,100274,70521,170795,Basketball
42411,2017,173142,Bethany Lutheran College,Mankato,MN,56001,7,NCAA Division III without football,245,269,514,2,"Private nonprofit, 4-year or above",2,24,17,173753,151444,325197,138661,133849,272510,Basketball
60113,2018,173142,Bethany Lutheran College,Mankato,MN,56001,7,NCAA Division III without football,281,298,579,2,"Private nonprofit, 4-year or above",2,19,18,129516,115704,245220,129516,115704,245220,Basketball
96483,2019,173142,Bethany Lutheran College,Mankato,MN,56001,7,NCAA Division III without football,267,314,581,2,"Private nonprofit, 4-year or above",2,20,19,124833,117950,242783,131566,118904,250470,Basketball
7509,2015,173160,Bethel University,Saint Paul,MN,55112,6,NCAA Division III with football,923,1449,2372,2,"Private nonprofit, 4-year or above",2,27,21,174474,94195,268669,174474,94195,268669,Basketball
24921,2016,173160,Bethel University,Saint Paul,MN,551126999,6,NCAA Division III with football,941,1436,2377,2,"Private nonprofit, 4-year or above",2,22,19,208860,123482,332342,208860,123482,332342,Basketball
42419,2017,173160,Bethel University,Saint Paul,MN,55112,6,NCAA Division III with football,901,1423,2324,2,"Private nonprofit, 4-year or above",2,32,20,214205,123221,337426,214205,123221,337426,Basketball
60123,2018,173160,Bethel University,Saint Paul,MN,55112,6,NCAA Division III with football,878,1433,2311,2,"Private nonprofit, 4-year or above",2,26,19,172545,135624,308169,172545,135624,308169,Basketball
96521,2019,173160,Bethel University,Saint Paul,MN,55112,6,NCAA Division III with football,839,1409,2248,2,"Private nonprofit, 4-year or above",2,28,20,172222,135790,308012,172222,135790,308012,Basketball
2697,2015,132602,Bethune-Cookman University,Daytona Beach,FL,321143099,2,NCAA Division I-FCS,1456,2041,3497,2,"Private nonprofit, 4-year or above",2,14,15,1203595,1266394,2469989,1203595,1266394,2469989,Basketball
20070,2016,132602,Bethune-Cookman University,Daytona Beach,FL,32114,2,NCAA Division I-FCS,1425,2158,3583,2,"Private nonprofit, 4-year or above",2,15,14,1080842,1133549,2214391,1080842,1133549,2214391,Basketball
37509,2017,132602,Bethune-Cookman University,Daytona Beach,FL,32114,2,NCAA Division I-FCS,1435,2316,3751,2,"Private nonprofit, 4-year or above",2,14,14,985331,1029156,2014487,985331,1029156,2014487,Basketball
55153,2018,132602,Bethune-Cookman University,Daytona Beach,FL,32114,2,NCAA Division I-FCS,1301,2181,3482,2,"Private nonprofit, 4-year or above",2,13,15,1079602,1057743,2137345,1079602,1057743,2137345,Basketball
79704,2019,132602,Bethune-Cookman University,Daytona Beach,FL,32114,2,NCAA Division I-FCS,1007,1701,2708,2,"Private nonprofit, 4-year or above",2,15,17,735933,795831,1531764,735933,435411,1171344,Basketball
45375,2017,196079,Binghamton University,Vestal,NY,13850,3,NCAA Division I without football,6779,6564,13343,1,"Public, 4-year or above",2,15,15,1643098,1359937,3003035,1643098,1359937,3003035,Basketball
63085,2018,196079,Binghamton University,Vestal,NY,13850,3,NCAA Division I without football,6826,6801,13627,1,"Public, 4-year or above",2,15,13,1753592,1393152,3146744,1753592,1393152,3146744,Basketball
106641,2019,196079,Binghamton University,Vestal,NY,13850,3,NCAA Division I without football,6856,6988,13844,1,"Public, 4-year or above",2,14,16,2080138,1695751,3775889,2080138,1695751,3775889,Basketball
18050,2016,110097,Biola University,La Mirada,CA,90639,5,NCAA Division II without football,1425,2522,3947,2,"Private nonprofit, 4-year or above",2,14,14,679354,468126,1147480,661653,463208,1124861,Basketball
35486,2017,110097,Biola University,La Mirada,CA,90639,5,NCAA Division II without football,1392,2487,3879,2,"Private nonprofit, 4-year or above",2,14,14,679523,556271,1235794,659839,556271,1216110,Basketball
53106,2018,110097,Biola University,La Mirada,CA,90639,5,NCAA Division II without football,1378,2400,3778,2,"Private nonprofit, 4-year or above",2,15,12,803093,632078,1435171,788467,622041,1410508,Basketball
73289,2019,110097,Biola University,La Mirada,CA,90639,5,NCAA Division II without football,1373,2396,3769,2,"Private nonprofit, 4-year or above",2,12,14,841563,526003,1367566,812484,513996,1326480,Basketball
75,2015,100937,Birmingham Southern College,Birmingham,AL,35254,6,NCAA Division III with football,673,664,1337,2,"Private nonprofit, 4-year or above",2,23,16,197692,168107,365799,197692,168107,365799,Basketball
17422,2016,100937,Birmingham Southern College,Birmingham,AL,35254,6,NCAA Division III with football,630,652,1282,2,"Private nonprofit, 4-year or above",2,27,18,223759,180773,404532,223759,180773,404532,Basketball
34837,2017,100937,Birmingham Southern College,Birmingham,AL,35254,6,NCAA Division III with football,615,657,1272,2,"Private nonprofit, 4-year or above",2,20,13,256671,176433,433104,256671,176433,433104,Basketball
52466,2018,100937,Birmingham Southern College,Birmingham,AL,35254,6,NCAA Division III with football,604,656,1260,2,"Private nonprofit, 4-year or above",2,15,11,218591,174385,392976,218591,174385,392976,Basketball
70439,2019,100937,Birmingham-Southern College,Birmingham,AL,35254,6,NCAA Division III with football,568,631,1199,2,"Private nonprofit, 4-year or above",2,15,16,245278,188450,433728,245278,188450,433728,Basketball
14188,2015,219046,Black Hills State University,Spearfish,SD,577999500,4,NCAA Division II with football,847,1313,2160,1,"Public, 4-year or above",2,15,15,331642,337912,669554,331642,337912,669554,Basketball
31647,2016,219046,Black Hills State University,Spearfish,SD,57799,4,NCAA Division II with football,828,1328,2156,1,"Public, 4-year or above",2,17,18,476247,386944,863191,497750,407057,904807,Basketball
49163,2017,219046,Black Hills State University,Spearfish,SD,57799,4,NCAA Division II with football,812,1306,2118,1,"Public, 4-year or above",2,16,19,536447,495828,1032275,505697,499138,1004835,Basketball
66926,2018,219046,Black Hills State University,Spearfish,SD,57799,4,NCAA Division II with football,737,1219,1956,1,"Public, 4-year or above",2,18,16,584752,516718,1101470,524539,483242,1007781,Basketball
119562,2019,219046,Black Hills State University,Spearfish,SD,57799,4,NCAA Division II with football,675,1198,1873,1,"Public, 4-year or above",2,21,19,457336,393414,850750,684549,470833,1155382,Basketball
3625,2015,143288,Blackburn College,Carlinville,IL,62626,7,NCAA Division III without football,257,304,561,2,"Private nonprofit, 4-year or above",2,24,12,84679,76007,160686,84679,76007,160686,Basketball
20995,2016,143288,Blackburn College,Carlinville,IL,62626,7,NCAA Division III without football,262,307,569,2,"Private nonprofit, 4-year or above",2,20,15,99572,98130,197702,97999,92748,190747,Basketball
38453,2017,143288,Blackburn College,Carlinville,IL,62626,7,NCAA Division III without football,234,312,546,2,"Private nonprofit, 4-year or above",2,20,14,93682,71762,165444,93682,71762,165444,Basketball
56106,2018,143288,Blackburn College,Carlinville,IL,62626,7,NCAA Division III without football,220,328,548,2,"Private nonprofit, 4-year or above",2,23,14,111148,71399,182547,111148,71399,182547,Basketball
83299,2019,143288,Blackburn College,Carlinville,IL,62626,7,NCAA Division III without football,205,262,467,2,"Private nonprofit, 4-year or above",2,18,9,83745,59020,142765,83745,59020,142765,Basketball
8914,2015,183822,Bloomfield College,Bloomfield,NJ,7003,5,NCAA Division II without football,643,1110,1753,2,"Private nonprofit, 4-year or above",2,18,15,395437,370773,766210,395437,370773,766210,Basketball
26339,2016,183822,Bloomfield College,Bloomfield,NJ,7003,5,NCAA Division II without football,676,1092,1768,2,"Private nonprofit, 4-year or above",2,17,17,384294,373007,757301,384294,373007,757301,Basketball
43836,2017,183822,Bloomfield College,Bloomfield,NJ,7003,5,NCAA Division II without football,649,1047,1696,2,"Private nonprofit, 4-year or above",2,17,17,380904,371012,751916,380904,371012,751916,Basketball
61553,2018,183822,Bloomfield College,Bloomfield,NJ,7003,5,NCAA Division II without football,586,969,1555,2,"Private nonprofit, 4-year or above",2,18,17,425522,384649,810171,425522,384649,810171,Basketball
101745,2019,183822,Bloomfield College,Bloomfield,NJ,7003,5,NCAA Division II without football,588,927,1515,2,"Private nonprofit, 4-year or above",2,17,18,391418,334093,725511,391418,334093,725511,Basketball
12585,2015,211158,Bloomsburg University of Pennsylvania,Bloomsburg,PA,17815,4,NCAA Division II with football,3614,4767,8381,1,"Public, 4-year or above",2,16,12,255511,243885,499396,282068,266217,548285,Basketball
30035,2016,211158,Bloomsburg University of Pennsylvania,Bloomsburg,PA,17815,4,NCAA Division II with football,3550,4628,8178,1,"Public, 4-year or above",2,13,12,290367,260530,550897,288083,286642,574725,Basketball
47531,2017,211158,Bloomsburg University of Pennsylvania,Bloomsburg,PA,17815,4,NCAA Division II with football,3371,4389,7760,1,"Public, 4-year or above",2,13,15,296307,261217,557524,296307,261217,557524,Basketball
65281,2018,211158,Bloomsburg University of Pennsylvania,Bloomsburg,PA,17815,4,NCAA Division II with football,3169,4211,7380,1,"Public, 4-year or above",2,15,14,305959,285596,591555,305959,285596,591555,Basketball
114411,2019,211158,Bloomsburg University of Pennsylvania,Bloomsburg,PA,17815,4,NCAA Division II with football,2965,4135,7100,1,"Public, 4-year or above",2,14,18,317238,312083,629321,317238,312083,629321,Basketball
16265,2015,237215,Bluefield State College,Bluefield,WV,24701,5,NCAA Division II without football,499,717,1216,1,"Public, 4-year or above",2,11,10,125934,106206,232140,118779,104956,223735,Basketball
33738,2016,237215,Bluefield State College,Bluefield,WV,24701,5,NCAA Division II without football,447,669,1116,1,"Public, 4-year or above",2,18,12,124573,114567,239140,119573,111467,231040,Basketball
51290,2017,237215,Bluefield State College,Bluefield,WV,24701,5,NCAA Division II without football,418,681,1099,1,"Public, 4-year or above",2,24,18,207565,149325,356890,193656,145706,339362,Basketball
69040,2018,237215,Bluefield State College,Bluefield,WV,24701,5,NCAA Division II without football,364,620,984,1,"Public, 4-year or above",2,22,21,210669,162401,373070,197779,151587,349366,Basketball
127954,2019,237215,Bluefield State College,Bluefield,WV,24701,5,NCAA Division II without football,343,607,950,1,"Public, 4-year or above",2,26,19,246145,205955,452100,249145,198439,447584,Basketball
11428,2015,201371,Bluffton University,Bluffton,OH,458172104,6,NCAA Division III with football,379,363,742,2,"Private nonprofit, 4-year or above",2,22,18,110674,82387,193061,110674,82387,193061,Basketball
28865,2016,201371,Bluffton University,Bluffton,OH,45817,6,NCAA Division III with football,376,347,723,2,"Private nonprofit, 4-year or above",2,23,18,125566,111352,236918,125566,111352,236918,Basketball
46367,2017,201371,Bluffton University,Bluffton,OH,45817,6,NCAA Division III with football,335,321,656,2,"Private nonprofit, 4-year or above",2,21,21,123094,114440,237534,123094,114440,237534,Basketball
64089,2018,201371,Bluffton University,Bluffton,OH,45817,6,NCAA Division III with football,345,260,605,2,"Private nonprofit, 4-year or above",2,27,17,125269,96020,221289,125269,96020,221289,Basketball
110196,2019,201371,Bluffton University,Bluffton,OH,45817,6,NCAA Division III with football,361,265,626,2,"Private nonprofit, 4-year or above",2,28,15,120760,86835,207595,120760,86835,207595,Basketball
3523,2015,142115,Boise State University,Boise,ID,83725,1,NCAA Division I-FBS,5823,6181,12004,1,"Public, 4-year or above",2,15,14,4003168,428050,4431218,2503447,1567408,4070855,Basketball
20893,2016,142115,Boise State University,Boise,ID,83725,1,NCAA Division I-FBS,5855,6495,12350,1,"Public, 4-year or above",2,14,17,3688228,367353,4055581,2821386,1547049,4368435,Basketball
38349,2017,142115,Boise State University,Boise,ID,83725,1,NCAA Division I-FBS,5682,6762,12444,1,"Public, 4-year or above",2,15,14,4184145,429749,4613894,2649924,1612352,4262276,Basketball
56002,2018,142115,Boise State University,Boise,ID,83725,1,NCAA Division I-FBS,5748,6998,12746,1,"Public, 4-year or above",2,19,17,5146160,1075903,6222063,3678140,2381997,6060137,Basketball
82942,2019,142115,Boise State University,Boise,ID,83725,1,NCAA Division I-FBS,5817,7218,13035,1,"Public, 4-year or above",2,17,20,5198696,1036551,6235247,3446875,2482994,5929869,Basketball
6416,2015,164924,Boston College,Chestnut Hill,MA,2467,1,NCAA Division I-FBS,4411,4954,9365,2,"Private nonprofit, 4-year or above",2,15,23,6947674,415753,7363427,6024594,3592531,9617125,Basketball
23799,2016,164924,Boston College,Chestnut Hill,MA,2467,1,NCAA Division I-FBS,4413,5073,9486,2,"Private nonprofit, 4-year or above",2,16,14,6814030,473994,7288024,6212181,3578090,9790271,Basketball
41305,2017,164924,Boston College,Chestnut Hill,MA,2467,1,NCAA Division I-FBS,4495,5030,9525,2,"Private nonprofit, 4-year or above",2,18,14,7033947,489757,7523704,6611108,4015449,10626557,Basketball
59002,2018,164924,Boston College,Chestnut Hill,MA,2467,1,NCAA Division I-FBS,4508,5018,9526,2,"Private nonprofit, 4-year or above",2,17,15,7225974,536766,7762740,6872835,4193201,11066036,Basketball
93064,2019,164924,Boston College,Chestnut Hill,MA,2467,1,NCAA Division I-FBS,4466,5049,9515,2,"Private nonprofit, 4-year or above",2,18,12,7107365,506410,7613775,6979235,3942317,10921552,Basketball
6432,2015,164988,Boston University,Boston,MA,2215,3,NCAA Division I without football,6273,9809,16082,2,"Private nonprofit, 4-year or above",2,16,19,1758899,1562983,3321882,2093165,1858448,3951613,Basketball
23815,2016,164988,Boston University,Boston,MA,2215,3,NCAA Division I without football,6250,9949,16199,2,"Private nonprofit, 4-year or above",2,16,21,1604601,1902279,3506880,2521092,1887428,4408520,Basketball
41321,2017,164988,Boston University,Boston,MA,2215,3,NCAA Division I without football,6399,9951,16350,2,"Private nonprofit, 4-year or above",2,13,13,2554475,2225119,4779594,2554475,2225119,4779594,Basketball
59018,2018,164988,Boston University,Boston,MA,2215,3,NCAA Division I without football,6729,10177,16906,2,"Private nonprofit, 4-year or above",2,14,12,2669686,1842923,4512609,2669686,1842923,4512609,Basketball
93101,2019,164988,Boston University,Boston,MA,2215,3,NCAA Division I without football,6789,9810,16599,2,"Private nonprofit, 4-year or above",2,16,15,2814251,2114471,4928722,2814251,2114471,4928722,Basketball
5905,2015,161004,Bowdoin College,Brunswick,ME,4011,6,NCAA Division III with football,902,891,1793,2,"Private nonprofit, 4-year or above",2,14,15,170537,195961,366498,166008,183507,349515,Basketball
23290,2016,161004,Bowdoin College,Brunswick,ME,4011,6,NCAA Division III with football,901,897,1798,2,"Private nonprofit, 4-year or above",2,13,16,186027,257300,443327,181558,228439,409997,Basketball
40789,2017,161004,Bowdoin College,Brunswick,ME,4011,6,NCAA Division III with football,907,904,1811,2,"Private nonprofit, 4-year or above",2,14,14,245831,285332,531163,230423,258291,488714,Basketball
58473,2018,161004,Bowdoin College,Brunswick,ME,4011,6,NCAA Division III with football,903,921,1824,2,"Private nonprofit, 4-year or above",2,16,14,203216,285414,488630,200129,239494,439623,Basketball
91333,2019,161004,Bowdoin College,Brunswick,ME,4011,6,NCAA Division III with football,894,938,1832,2,"Private nonprofit, 4-year or above",2,17,15,201141,294528,495669,199626,265074,464700,Basketball
6053,2015,162007,Bowie State University,Bowie,MD,207159465,4,NCAA Division II with football,1343,2184,3527,1,"Public, 4-year or above",2,16,12,513722,285973,799695,489006,277036,766042,Basketball
23441,2016,162007,Bowie State University,Bowie,MD,20715,4,NCAA Division II with football,1521,2410,3931,1,"Public, 4-year or above",2,13,13,524118,388422,912540,481078,370867,851945,Basketball
40943,2017,162007,Bowie State University,Bowie,MD,20715,4,NCAA Division II with football,1674,2711,4385,1,"Public, 4-year or above",2,14,14,565954,438724,1004678,543253,423948,967201,Basketball
58635,2018,162007,Bowie State University,Bowie,MD,20715,4,NCAA Division II with football,1687,2727,4414,1,"Public, 4-year or above",2,14,13,521288,442206,963494,521283,442159,963442,Basketball
91918,2019,162007,Bowie State University,Bowie,MD,20715,4,NCAA Division II with football,1703,2622,4325,1,"Public, 4-year or above",2,16,15,566361,470380,1036741,555244,476115,1031359,Basketball
11435,2015,201441,Bowling Green State University-Main Campus,Bowling Green,OH,43403,1,NCAA Division I-FBS,5581,7562,13143,1,"Public, 4-year or above",2,14,14,2389470,1366969,3756439,2389470,1366969,3756439,Basketball
28872,2016,201441,Bowling Green State University-Main Campus,Bowling Green,OH,43403,1,NCAA Division I-FBS,5661,7450,13111,1,"Public, 4-year or above",2,13,13,2580920,1430297,4011217,2580920,1430297,4011217,Basketball
46375,2017,201441,Bowling Green State University-Main Campus,Bowling Green,OH,43403,1,NCAA Division I-FBS,5630,7398,13028,1,"Public, 4-year or above",2,14,15,2231678,1865488,4097166,2231678,1865488,4097166,Basketball
64097,2018,201441,Bowling Green State University-Main Campus,Bowling Green,OH,43403,1,NCAA Division I-FBS,5670,7236,12906,1,"Public, 4-year or above",2,15,15,2544177,1565369,4109546,2544177,1565369,4109546,Basketball
110234,2019,201441,Bowling Green State University-Main Campus,Bowling Green,OH,43403,1,NCAA Division I-FBS,5592,7271,12863,1,"Public, 4-year or above",2,15,15,2524268,1494249,4018517,2524268,1494249,4018517,Basketball
3633,2015,143358,Bradley University,Peoria,IL,616250001,3,NCAA Division I without football,2059,2160,4219,2,"Private nonprofit, 4-year or above",2,13,17,3128419,1480741,4609160,3128419,1480741,4609160,Basketball
21003,2016,143358,Bradley University,Peoria,IL,61625,3,NCAA Division I without football,2102,2176,4278,2,"Private nonprofit, 4-year or above",2,15,15,3359417,1438412,4797829,3359417,1438412,4797829,Basketball
38461,2017,143358,Bradley University,Peoria,IL,61625,3,NCAA Division I without football,2226,2284,4510,2,"Private nonprofit, 4-year or above",2,14,15,3555837,1456071,5011908,3555837,1456071,5011908,Basketball
56114,2018,143358,Bradley University,Peoria,IL,61625,3,NCAA Division I without football,2188,2273,4461,2,"Private nonprofit, 4-year or above",2,13,15,3778660,1589763,5368423,3778660,1589763,5368423,Basketball
83334,2019,143358,Bradley University,Peoria,IL,61625,3,NCAA Division I without football,2210,2296,4506,2,"Private nonprofit, 4-year or above",2,15,12,3412037,1463277,4875314,3412037,1463277,4875314,Basketball
6444,2015,165015,Brandeis University,Waltham,MA,24549110,7,NCAA Division III without football,1554,2047,3601,2,"Private nonprofit, 4-year or above",2,16,16,346266,320716,666982,346266,320716,666982,Basketball
23827,2016,165015,Brandeis University,Waltham,MA,2454,7,NCAA Division III without football,1521,2070,3591,2,"Private nonprofit, 4-year or above",2,14,17,350609,312482,663091,350609,312482,663091,Basketball
41333,2017,165015,Brandeis University,Waltham,MA,2454,7,NCAA Division III without football,1476,2144,3620,2,"Private nonprofit, 4-year or above",2,12,18,308276,315890,624166,308276,315890,624166,Basketball
59030,2018,165015,Brandeis University,Waltham,MA,2454,7,NCAA Division III without football,1425,2193,3618,2,"Private nonprofit, 4-year or above",2,12,18,360561,327186,687747,360561,327186,687747,Basketball
93113,2019,165015,Brandeis University,Waltham,MA,2454,7,NCAA Division III without football,1436,2237,3673,2,"Private nonprofit, 4-year or above",2,13,15,370649,420389,791038,370649,420389,791038,Basketball
10796,2015,198066,Brevard College,Brevard,NC,28712,4,NCAA Division II with football,391,322,713,2,"Private nonprofit, 4-year or above",2,20,13,376755,326088,702843,376755,326088,702843,Basketball
28233,2016,198066,Brevard College,Brevard,NC,28712,4,NCAA Division II with football,391,299,690,2,"Private nonprofit, 4-year or above",2,20,11,271626,182084,453710,271626,182084,453710,Basketball
45731,2017,198066,Brevard College,Brevard,NC,28712,6,NCAA Division III with football,362,292,654,2,"Private nonprofit, 4-year or above",2,21,13,241758,161442,403200,241758,161442,403200,Basketball
63443,2018,198066,Brevard College,Brevard,NC,28712,6,NCAA Division III with football,390,297,687,2,"Private nonprofit, 4-year or above",2,23,13,155241,128942,284183,155241,128942,284183,Basketball
107698,2019,198066,Brevard College,Brevard,NC,28712,6,NCAA Division III with football,402,325,727,2,"Private nonprofit, 4-year or above",2,17,14,150668,131670,282338,150668,131670,282338,Basketball
15585,2015,231581,Bridgewater College,Bridgewater,VA,228121599,6,NCAA Division III with football,857,960,1817,2,"Private nonprofit, 4-year or above",2,16,15,188358,184048,372406,188358,184048,372406,Basketball
33054,2016,231581,Bridgewater College,Bridgewater,VA,22812,6,NCAA Division III with football,870,1000,1870,2,"Private nonprofit, 4-year or above",2,16,15,192822,174202,367024,192822,174202,367024,Basketball
50592,2017,231581,Bridgewater College,Bridgewater,VA,22812,6,NCAA Division III with football,848,1020,1868,2,"Private nonprofit, 4-year or above",2,15,13,242234,180973,423207,242234,180973,423207,Basketball
68337,2018,231581,Bridgewater College,Bridgewater,VA,22812,6,NCAA Division III with football,815,1011,1826,2,"Private nonprofit, 4-year or above",2,15,14,210266,174303,384569,210266,174303,384569,Basketball
125243,2019,231581,Bridgewater College,Bridgewater,VA,22812,6,NCAA Division III with football,763,941,1704,2,"Private nonprofit, 4-year or above",2,13,14,203687,186031,389718,203687,186031,389718,Basketball
6453,2015,165024,Bridgewater State University,Bridgewater,MA,2325,6,NCAA Division III with football,3212,4690,7902,1,"Public, 4-year or above",2,13,13,145223,77130,222353,112278,58500,170778,Basketball
23836,2016,165024,Bridgewater State University,Bridgewater,MA,2325,6,NCAA Division III with football,3182,4607,7789,1,"Public, 4-year or above",2,12,15,114864,79550,194414,97065,70450,167515,Basketball
41342,2017,165024,Bridgewater State University,Bridgewater,MA,2325,6,NCAA Division III with football,3217,4599,7816,1,"Public, 4-year or above",2,15,16,134849,97526,232375,99348,104782,204130,Basketball
59039,2018,165024,Bridgewater State University,Bridgewater,MA,2325,6,NCAA Division III with football,3210,4625,7835,1,"Public, 4-year or above",2,12,14,132471,78673,211144,93174,68287,161461,Basketball
93123,2019,165024,Bridgewater State University,Bridgewater,MA,2325,6,NCAA Division III with football,3118,4509,7627,1,"Public, 4-year or above",2,11,15,116053,90281,206334,82357,86734,169091,Basketball
15377,2015,230047,Brigham Young University-Hawaii,Laie,HI,967621294,5,NCAA Division II without football,981,1394,2375,2,"Private nonprofit, 4-year or above",2,17,16,378417,191067,569484,378417,191067,569484,Basketball
15367,2015,230038,Brigham Young University-Provo,Provo,UT,84602,1,NCAA Division I-FBS,14359,12980,27339,2,"Private nonprofit, 4-year or above",2,18,16,6283414,1836956,8120370,6081807,1836956,7918763,Basketball
32834,2016,230038,Brigham Young University-Provo,Provo,UT,84602,1,NCAA Division I-FBS,14524,13488,28012,2,"Private nonprofit, 4-year or above",2,18,21,8986993,1986133,10973126,6999780,1986133,8985913,Basketball
50366,2017,230038,Brigham Young University-Provo,Provo,UT,84602,1,NCAA Division I-FBS,14388,13768,28156,2,"Private nonprofit, 4-year or above",2,19,21,7702314,550769,8253083,7468917,2143559,9612476,Basketball
68142,2018,230038,Brigham Young University-Provo,Provo,UT,84602,1,NCAA Division I-FBS,14164,14089,28253,2,"Private nonprofit, 4-year or above",2,20,23,7447430,2168100,9615530,7447430,2168100,9615530,Basketball
124674,2019,230038,Brigham Young University-Provo,Provo,UT,84602,1,NCAA Division I-FBS,13997,14291,28288,2,"Private nonprofit, 4-year or above",2,18,23,6176888,515816,6692704,7766836,2183582,9950418,Basketball
13770,2015,217156,Brown University,Providence,RI,2912,2,NCAA Division I-FCS,3006,3296,6302,2,"Private nonprofit, 4-year or above",2,16,14,1044289,821636,1865925,1044289,821636,1865925,Basketball
31224,2016,217156,Brown University,Providence,RI,2912,2,NCAA Division I-FCS,3133,3423,6556,2,"Private nonprofit, 4-year or above",2,15,12,962578,708757,1671335,962578,708757,1671335,Basketball
48736,2017,217156,Brown University,Providence,RI,2912,2,NCAA Division I-FCS,3145,3509,6654,2,"Private nonprofit, 4-year or above",2,14,17,932425,749569,1681994,932425,749569,1681994,Basketball
66490,2018,217156,Brown University,Providence,RI,2912,2,NCAA Division I-FCS,3113,3613,6726,2,"Private nonprofit, 4-year or above",2,15,18,1239495,812289,2051784,1239495,812289,2051784,Basketball
118040,2019,217156,Brown University,Providence,RI,2912,2,NCAA Division I-FCS,3249,3561,6810,2,"Private nonprofit, 4-year or above",2,14,15,1326188,785112,2111300,1326188,785112,2111300,Basketball
13792,2015,217165,Bryant University,Smithfield,RI,29171291,2,NCAA Division I-FCS,1990,1386,3376,2,"Private nonprofit, 4-year or above",2,15,19,1796753,1420797,3217550,1796753,1420797,3217550,Basketball
31246,2016,217165,Bryant University,Smithfield,RI,2917,2,NCAA Division I-FCS,2045,1354,3399,2,"Private nonprofit, 4-year or above",2,15,16,1943732,1467315,3411047,1943732,1467315,3411047,Basketball
48758,2017,217165,Bryant University,Smithfield,RI,2917,2,NCAA Division I-FCS,2085,1327,3412,2,"Private nonprofit, 4-year or above",2,15,17,1883608,1376601,3260209,1883608,1376601,3260209,Basketball
66512,2018,217165,Bryant University,Smithfield,RI,2917,2,NCAA Division I-FCS,2133,1314,3447,2,"Private nonprofit, 4-year or above",2,15,19,1883381,1523225,3406606,1883381,1523225,3406606,Basketball
118078,2019,217165,Bryant University,Smithfield,RI,2917,2,NCAA Division I-FCS,2016,1180,3196,2,"Private nonprofit, 4-year or above",2,16,20,1675827,1581886,3257713,1675827,1581886,3257713,Basketball
12504,2015,210492,Bryn Athyn College of the New Church,Bryn Athyn,PA,190090717,7,NCAA Division III without football,141,122,263,2,"Private nonprofit, 4-year or above",2,14,12,48243,51516,99759,48243,51517,99760,Basketball
29953,2016,210492,Bryn Athyn College of the New Church,Bryn Athyn,PA,19009,7,NCAA Division III without football,146,141,287,2,"Private nonprofit, 4-year or above",2,12,11,65014,61717,126731,65014,61717,126731,Basketball
47448,2017,210492,Bryn Athyn College of the New Church,Bryn Athyn,PA,19009,7,NCAA Division III without football,153,157,310,2,"Private nonprofit, 4-year or above",2,14,11,71630,75265,146895,71630,75265,146895,Basketball
65196,2018,210492,Bryn Athyn College of the New Church,Bryn Athyn,PA,19009,7,NCAA Division III without football,131,152,283,2,"Private nonprofit, 4-year or above",2,15,6,73843,73346,147189,73843,73346,147189,Basketball
114155,2019,210492,Bryn Athyn College of the New Church,Bryn Athyn,PA,19009,7,NCAA Division III without football,131,141,272,2,"Private nonprofit, 4-year or above",2,17,11,61622,75135,136757,61622,75135,136757,Basketball
12596,2015,211291,Bucknell University,Lewisburg,PA,17837,2,NCAA Division I-FCS,1678,1835,3513,2,"Private nonprofit, 4-year or above",2,14,22,2172546,1642159,3814705,2172546,1642159,3814705,Basketball
30046,2016,211291,Bucknell University,Lewisburg,PA,17837,2,NCAA Division I-FCS,1741,1784,3525,2,"Private nonprofit, 4-year or above",2,13,23,2544585,1680094,4224679,2544585,1680094,4224679,Basketball
47542,2017,211291,Bucknell University,Lewisburg,PA,17837,2,NCAA Division I-FCS,1770,1811,3581,2,"Private nonprofit, 4-year or above",2,14,14,2776631,1787670,4564301,2776631,1787670,4564301,Basketball
65293,2018,211291,Bucknell University,Lewisburg,PA,17837,2,NCAA Division I-FCS,1755,1822,3577,2,"Private nonprofit, 4-year or above",2,14,21,2624075,2048062,4672137,2624075,2048062,4672137,Basketball
114449,2019,211291,Bucknell University,Lewisburg,PA,17837,2,NCAA Division I-FCS,1764,1838,3602,2,"Private nonprofit, 4-year or above",2,14,16,2331882,1685867,4017749,2331882,1685867,4017749,Basketball
4697,2015,153001,Buena Vista University,Storm Lake,IA,50588,6,NCAA Division III with football,613,1045,1658,2,"Private nonprofit, 4-year or above",2,23,22,227851,179863,407714,217404,173358,390762,Basketball
22059,2016,153001,Buena Vista University,Storm Lake,IA,50588,6,NCAA Division III with football,544,979,1523,2,"Private nonprofit, 4-year or above",2,19,20,222729,210882,433611,218704,210882,429586,Basketball
39532,2017,153001,Buena Vista University,Storm Lake,IA,50588,6,NCAA Division III with football,542,921,1463,2,"Private nonprofit, 4-year or above",2,21,15,207846,197974,405820,196158,196020,392178,Basketball
57194,2018,153001,Buena Vista University,Storm Lake,IA,50588,6,NCAA Division III with football,486,870,1356,2,"Private nonprofit, 4-year or above",2,22,19,192692,159714,352406,182365,159714,342079,Basketball
87237,2019,153001,Buena Vista University,Storm Lake,IA,50588,6,NCAA Division III with football,467,766,1233,2,"Private nonprofit, 4-year or above",2,21,13,200368,180985,381353,200094,180914,381008,Basketball
39180,2017,150163,Butler University,Indianapolis,IN,46208,2,NCAA Division I-FCS,1648,2502,4150,2,"Private nonprofit, 4-year or above",2,12,29,7510164,2095381,9605545,5507238,2060149,7567387,Basketball
56840,2018,150163,Butler University,Indianapolis,IN,46208,2,NCAA Division I-FCS,1827,2668,4495,2,"Private nonprofit, 4-year or above",2,14,37,8228482,2165945,10394427,5760815,2192079,7952894,Basketball
86012,2019,150163,Butler University,Indianapolis,IN,46208,2,NCAA Division I-FCS,1786,2699,4485,2,"Private nonprofit, 4-year or above",2,16,36,7960230,2278554,10238784,5846934,2301091,8148025,Basketball
12622,2015,211352,Cabrini College,Radnor,PA,190873698,7,NCAA Division III without football,479,831,1310,2,"Private nonprofit, 4-year or above",2,16,14,115696,118164,233860,101566,99298,200864,Basketball
30074,2016,211352,Cabrini University,Radnor,PA,19087,7,NCAA Division III without football,519,864,1383,2,"Private nonprofit, 4-year or above",2,17,14,109963,127947,237910,96339,107979,204318,Basketball
47570,2017,211352,Cabrini University,Radnor,PA,19087,7,NCAA Division III without football,587,892,1479,2,"Private nonprofit, 4-year or above",2,17,16,122953,117083,240036,111410,104087,215497,Basketball
65322,2018,211352,Cabrini University,Radnor,PA,19087,7,NCAA Division III without football,559,927,1486,2,"Private nonprofit, 4-year or above",2,19,13,100881,113996,214877,96170,107846,204016,Basketball
114563,2019,211352,Cabrini University,Radnor,PA,19087,7,NCAA Division III without football,546,901,1447,2,"Private nonprofit, 4-year or above",2,18,19,102118,127279,229397,97302,112396,209698,Basketball
13398,2015,215114,Cairn University-Langhorne,Langhorne,PA,190472990,7,NCAA Division III without football,331,393,724,2,"Private nonprofit, 4-year or above",2,20,12,40839,36730,77569,36114,36347,72461,Basketball
30857,2016,215114,Cairn University-Langhorne,Langhorne,PA,19047,7,NCAA Division III without football,314,385,699,2,"Private nonprofit, 4-year or above",2,18,14,41653,33186,74839,34402,32873,67275,Basketball
48366,2017,215114,Cairn University-Langhorne,Langhorne,PA,19047,7,NCAA Division III without football,320,403,723,2,"Private nonprofit, 4-year or above",2,16,14,35784,31970,67754,35784,31970,67754,Basketball
66107,2018,215114,Cairn University-Langhorne,Langhorne,PA,19047,7,NCAA Division III without football,329,424,753,2,"Private nonprofit, 4-year or above",2,18,12,40306,29849,70155,40306,29849,70155,Basketball
116969,2019,215114,Cairn University-Langhorne,Langhorne,PA,19047,7,NCAA Division III without football,360,447,807,2,"Private nonprofit, 4-year or above",2,20,11,79000,66000,145000,79000,66000,145000,Basketball
8935,2015,183910,Caldwell University,Caldwell,NJ,70066195,5,NCAA Division II without football,392,980,1372,2,"Private nonprofit, 4-year or above",2,16,15,514874,374670,889544,488374,374670,863044,Basketball
26360,2016,183910,Caldwell University,Caldwell,NJ,7006,5,NCAA Division II without football,430,1015,1445,2,"Private nonprofit, 4-year or above",2,15,14,532356,392623,924979,530556,375023,905579,Basketball
43856,2017,183910,Caldwell University,Caldwell,NJ,7006,5,NCAA Division II without football,477,963,1440,2,"Private nonprofit, 4-year or above",2,15,10,577679,363120,940799,569941,353382,923323,Basketball
61574,2018,183910,Caldwell University,Caldwell,NJ,7006,5,NCAA Division II without football,518,999,1517,2,"Private nonprofit, 4-year or above",2,15,11,572640,396289,968929,556736,389053,945789,Basketball
101826,2019,183910,Caldwell University,Caldwell,NJ,7006,5,NCAA Division II without football,596,1013,1609,2,"Private nonprofit, 4-year or above",2,15,13,562577,420867,983444,550548,418338,968886,Basketball
732,2015,110361,California Baptist University,Riverside,CA,925043297,5,NCAA Division II without football,2135,3513,5648,2,"Private nonprofit, 4-year or above",2,14,14,1332300,998466,2330766,1181533,971120,2152653,Basketball
18080,2016,110361,California Baptist University,Riverside,CA,92504,5,NCAA Division II without football,2166,3712,5878,2,"Private nonprofit, 4-year or above",2,16,15,1579806,1133027,2712833,1365842,1124706,2490548,Basketball
35515,2017,110361,California Baptist University,Riverside,CA,92504,3,NCAA Division I without football,2407,3959,6366,2,"Private nonprofit, 4-year or above",2,16,12,1768970,1250392,3019362,1756289,1222120,2978409,Basketball
53135,2018,110361,California Baptist University,Riverside,CA,92504,3,NCAA Division I without football,2617,4242,6859,2,"Private nonprofit, 4-year or above",2,16,18,2555371,1650057,4205428,2503353,1650509,4153862,Basketball
73376,2019,110361,California Baptist University,Riverside,CA,92504,3,NCAA Division I without football,2770,4563,7333,2,"Private nonprofit, 4-year or above",2,17,15,2579702,1786618,4366320,2889902,1789846,4679748,Basketball
743,2015,110404,California Institute of Technology,Pasadena,CA,91125,7,NCAA Division III without football,610,391,1001,2,"Private nonprofit, 4-year or above",2,14,9,176147,139854,316001,150362,137746,288108,Basketball
18091,2016,110404,California Institute of Technology,Pasadena,CA,91125,7,NCAA Division III without football,579,400,979,2,"Private nonprofit, 4-year or above",2,15,9,138944,153760,292704,135134,145567,280701,Basketball
35526,2017,110404,California Institute of Technology,Pasadena,CA,91125,7,NCAA Division III without football,532,429,961,2,"Private nonprofit, 4-year or above",2,12,12,162889,123239,286128,154306,123239,277545,Basketball
53146,2018,110404,California Institute of Technology,Pasadena,CA,91125,7,NCAA Division III without football,518,430,948,2,"Private nonprofit, 4-year or above",2,12,11,185726,127181,312907,122615,116114,238729,Basketball
73414,2019,110404,California Institute of Technology,Pasadena,CA,91125,7,NCAA Division III without football,513,425,938,2,"Private nonprofit, 4-year or above",2,19,13,136888,121226,258114,136888,121226,258114,Basketball
753,2015,110413,California Lutheran University,Thousand Oaks,CA,913602787,6,NCAA Division III with football,1140,1531,2671,2,"Private nonprofit, 4-year or above",2,27,23,119130,162875,282005,119130,162875,282005,Basketball
18102,2016,110413,California Lutheran University,Thousand Oaks,CA,91360,6,NCAA Division III with football,1187,1578,2765,2,"Private nonprofit, 4-year or above",2,24,24,133036,169091,302127,133036,169091,302127,Basketball
35536,2017,110413,California Lutheran University,Thousand Oaks,CA,91360,6,NCAA Division III with football,1214,1642,2856,2,"Private nonprofit, 4-year or above",2,24,26,196829,165856,362685,196829,165856,362685,Basketball
53156,2018,110413,California Lutheran University,Thousand Oaks,CA,91360,6,NCAA Division III with football,1274,1667,2941,2,"Private nonprofit, 4-year or above",2,26,29,295435,172713,468148,295435,172713,468148,Basketball
73423,2019,110413,California Lutheran University,Thousand Oaks,CA,91360,6,NCAA Division III with football,1298,1673,2971,2,"Private nonprofit, 4-year or above",2,27,14,254362,132264,386626,254362,132264,386626,Basketball
765,2015,110422,California Polytechnic State University-San Luis Obispo,San Luis Obispo,CA,93407,2,NCAA Division I-FCS,10203,9044,19247,1,"Public, 4-year or above",2,16,19,2095472,1337184,3432656,2095472,1337184,3432656,Basketball
18114,2016,110422,California Polytechnic State University-San Luis Obispo,San Luis Obispo,CA,93407,2,NCAA Division I-FCS,10301,9349,19650,1,"Public, 4-year or above",2,16,15,1973618,1390223,3363841,1973618,1390223,3363841,Basketball
35547,2017,110422,California Polytechnic State University-San Luis Obispo,San Luis Obispo,CA,93407,2,NCAA Division I-FCS,10634,9908,20542,1,"Public, 4-year or above",2,16,17,2045881,1530535,3576416,2045881,1530535,3576416,Basketball
53168,2018,110422,California Polytechnic State University-San Luis Obispo,San Luis Obispo,CA,93407,2,NCAA Division I-FCS,10413,9876,20289,1,"Public, 4-year or above",2,16,20,2181492,1663889,3845381,2181492,1663889,3845381,Basketball
73438,2019,110422,California Polytechnic State University-San Luis Obispo,San Luis Obispo,CA,93407,2,NCAA Division I-FCS,10078,9561,19639,1,"Public, 4-year or above",2,14,20,2236551,1730632,3967183,2236551,1730632,3967183,Basketball
805,2015,110529,California State Polytechnic University-Pomona,Pomona,CA,91768,5,NCAA Division II without football,10764,8815,19579,1,"Public, 4-year or above",2,12,15,492914,366085,858999,564657,432298,996955,Basketball
18154,2016,110529,California State Polytechnic University-Pomona,Pomona,CA,91768,5,NCAA Division II without football,11444,9668,21112,1,"Public, 4-year or above",2,13,12,602721,480200,1082921,602721,475855,1078576,Basketball
35586,2017,110529,California State Polytechnic University-Pomona,Pomona,CA,91768,5,NCAA Division II without football,11491,10145,21636,1,"Public, 4-year or above",2,15,14,616255,514994,1131249,604839,516185,1121024,Basketball
53207,2018,110529,California State Polytechnic University-Pomona,Pomona,CA,91768,5,NCAA Division II without football,11498,10297,21795,1,"Public, 4-year or above",2,14,13,692333,613579,1305912,691500,581759,1273259,Basketball
73533,2019,110529,California State Polytechnic University-Pomona,Pomona,CA,91768,5,NCAA Division II without football,12327,11248,23575,1,"Public, 4-year or above",2,15,13,734430,643647,1378077,713082,619830,1332912,Basketball
777,2015,110486,California State University-Bakersfield,Bakersfield,CA,933111099,3,NCAA Division I without football,2804,4492,7296,1,"Public, 4-year or above",2,14,15,1697054,1370879,3067933,1697054,1370879,3067933,Basketball
18126,2016,110486,California State University-Bakersfield,Bakersfield,CA,93311,3,NCAA Division I without football,2782,4280,7062,1,"Public, 4-year or above",2,15,16,2092139,1293744,3385883,2092139,1293744,3385883,Basketball
35559,2017,110486,California State University-Bakersfield,Bakersfield,CA,93311,3,NCAA Division I without football,2935,4563,7498,1,"Public, 4-year or above",2,16,16,2172991,1400567,3573558,2146588,1369283,3515871,Basketball
53180,2018,110486,California State University-Bakersfield,Bakersfield,CA,93311,3,NCAA Division I without football,3022,4864,7886,1,"Public, 4-year or above",2,15,17,2714877,1538561,4253438,2333990,1455790,3789780,Basketball
73476,2019,110486,California State University-Bakersfield,Bakersfield,CA,93311,3,NCAA Division I without football,3181,5268,8449,1,"Public, 4-year or above",2,13,13,2975591,1494639,4470230,2306800,1375214,3682014,Basketball
810,2015,110538,California State University-Chico,Chico,CA,959290150,5,NCAA Division II without football,6995,7821,14816,1,"Public, 4-year or above",2,16,13,555931,420165,976096,482877,399577,882454,Basketball
18159,2016,110538,California State University-Chico,Chico,CA,95929,5,NCAA Division II without football,7157,8008,15165,1,"Public, 4-year or above",2,17,14,712798,459944,1172742,588695,428793,1017488,Basketball
35591,2017,110538,California State University-Chico,Chico,CA,95929,5,NCAA Division II without football,7228,8144,15372,1,"Public, 4-year or above",2,17,14,631128,432986,1064114,565831,413142,978973,Basketball
53212,2018,110538,California State University-Chico,Chico,CA,95929,5,NCAA Division II without football,7133,8051,15184,1,"Public, 4-year or above",2,15,14,566331,452909,1019240,545085,433177,978262,Basketball
73571,2019,110538,California State University-Chico,Chico,CA,95929,5,NCAA Division II without football,7006,7943,14949,1,"Public, 4-year or above",2,17,13,650064,464438,1114502,595039,461165,1056204,Basketball
818,2015,110547,California State University-Dominguez Hills,Carson,CA,907470005,5,NCAA Division II without football,3438,5735,9173,1,"Public, 4-year or above",2,12,18,427489,566910,994399,427489,566910,994399,Basketball
18167,2016,110547,California State University-Dominguez Hills,Carson,CA,90747,5,NCAA Division II without football,3516,5804,9320,1,"Public, 4-year or above",2,15,15,500639,375013,875652,500639,375013,875652,Basketball
35599,2017,110547,California State University-Dominguez Hills,Carson,CA,90747,5,NCAA Division II without football,3791,6283,10074,1,"Public, 4-year or above",2,15,15,482265,432773,915038,482265,432773,915038,Basketball
53220,2018,110547,California State University-Dominguez Hills,Carson,CA,90747,5,NCAA Division II without football,3989,6743,10732,1,"Public, 4-year or above",2,15,17,512017,486631,998648,512017,486631,998648,Basketball
73609,2019,110547,California State University-Dominguez Hills,Carson,CA,90747,5,NCAA Division II without football,4591,7510,12101,1,"Public, 4-year or above",2,16,15,506795,472298,979093,506795,472298,979093,Basketball
847,2015,110574,California State University-East Bay,Hayward,CA,94542,5,NCAA Division II without football,4241,6848,11089,1,"Public, 4-year or above",2,20,16,630773,472386,1103159,543014,465746,1008760,Basketball
18196,2016,110574,California State University-East Bay,Hayward,CA,94542,5,NCAA Division II without football,4479,7074,11553,1,"Public, 4-year or above",2,17,18,658607,532752,1191359,658607,532752,1191359,Basketball
35630,2017,110574,California State University-East Bay,Hayward,CA,94542,5,NCAA Division II without football,4393,7120,11513,1,"Public, 4-year or above",2,16,20,575701,549459,1125160,575701,549459,1125160,Basketball
53251,2018,110574,California State University-East Bay,Hayward,CA,94542,5,NCAA Division II without football,3911,6248,10159,1,"Public, 4-year or above",2,19,16,575144,586669,1161813,575144,586669,1161813,Basketball
73720,2019,110574,California State University-East Bay,Hayward,CA,94542,5,NCAA Division II without football,4160,6445,10605,1,"Public, 4-year or above",2,19,19,670744,566557,1237301,670744,566557,1237301,Basketball
825,2015,110556,California State University-Fresno,Fresno,CA,93740,1,NCAA Division I-FBS,7768,10875,18643,1,"Public, 4-year or above",2,17,16,3234934,2255611,5490545,3234934,2255611,5490545,Basketball
18174,2016,110556,California State University-Fresno,Fresno,CA,93740,1,NCAA Division I-FBS,7865,10963,18828,1,"Public, 4-year or above",2,19,16,3291010,2227702,5518712,3291010,2227702,5518712,Basketball
35606,2017,110556,California State University-Fresno,Fresno,CA,93740,1,NCAA Division I-FBS,8030,11382,19412,1,"Public, 4-year or above",2,16,19,3352520,2088065,5440585,3352520,2088065,5440585,Basketball
53227,2018,110556,California State University-Fresno,Fresno,CA,93740,1,NCAA Division I-FBS,7828,11518,19346,1,"Public, 4-year or above",2,15,16,3642878,2316750,5959628,3642878,2316750,5959628,Basketball
73647,2019,110556,California State University-Fresno,Fresno,CA,93740,1,NCAA Division I-FBS,7627,11251,18878,1,"Public, 4-year or above",2,17,18,3221377,2424187,5645564,3221377,2424187,5645564,Basketball
837,2015,110565,California State University-Fullerton,Fullerton,CA,928313599,3,NCAA Division I without football,11886,15150,27036,1,"Public, 4-year or above",2,15,13,1480600,1150730,2631330,1480600,1150730,2631330,Basketball
18186,2016,110565,California State University-Fullerton,Fullerton,CA,92831,3,NCAA Division I without football,12193,15732,27925,1,"Public, 4-year or above",2,15,9,1685827,987978,2673805,1695827,987978,2683805,Basketball
35620,2017,110565,California State University-Fullerton,Fullerton,CA,92831,3,NCAA Division I without football,12274,16152,28426,1,"Public, 4-year or above",2,16,13,1918750,1074642,2993392,1918750,1074642,2993392,Basketball
53241,2018,110565,California State University-Fullerton,Fullerton,CA,92831,3,NCAA Division I without football,12044,15819,27863,1,"Public, 4-year or above",2,17,15,2114807,1246774,3361581,2114807,1246774,3361581,Basketball
73682,2019,110565,California State University-Fullerton,Fullerton,CA,92831,3,NCAA Division I without football,12257,16517,28774,1,"Public, 4-year or above",2,16,14,1789031,1116088,2905119,1891355,1242274,3133629,Basketball
857,2015,110583,California State University-Long Beach,Long Beach,CA,908400115,3,NCAA Division I without football,11989,15688,27677,1,"Public, 4-year or above",2,16,12,2717429,1477540,4194969,2717429,1477540,4194969,Basketball
18206,2016,110583,California State University-Long Beach,Long Beach,CA,90840,3,NCAA Division I without football,11977,15827,27804,1,"Public, 4-year or above",2,15,14,2549979,1460202,4010181,2549979,1460020,4009999,Basketball
35640,2017,110583,California State University-Long Beach,Long Beach,CA,90840,3,NCAA Division I without football,11705,15666,27371,1,"Public, 4-year or above",2,16,14,2682915,1535219,4218134,2682915,1535219,4218134,Basketball
53261,2018,110583,California State University-Long Beach,Long Beach,CA,90840,3,NCAA Division I without football,11753,15716,27469,1,"Public, 4-year or above",2,16,14,2412791,1576467,3989258,2412791,1576467,3989258,Basketball
73758,2019,110583,California State University-Long Beach,Long Beach,CA,90840,3,NCAA Division I without football,12352,16260,28612,1,"Public, 4-year or above",2,16,16,2534581,1583166,4117747,2534581,1583166,4117747,Basketball
867,2015,110592,California State University-Los Angeles,Los Angeles,CA,90032,5,NCAA Division II without football,8375,11984,20359,1,"Public, 4-year or above",2,16,16,597412,491262,1088674,597412,491262,1088674,Basketball
18216,2016,110592,California State University-Los Angeles,Los Angeles,CA,90032,5,NCAA Division II without football,8282,11721,20003,1,"Public, 4-year or above",2,15,14,685266,618871,1304137,685266,618871,1304137,Basketball
35650,2017,110592,California State University-Los Angeles,Los Angeles,CA,90032,5,NCAA Division II without football,8908,12063,20971,1,"Public, 4-year or above",2,17,11,648297,574776,1223073,648297,574776,1223073,Basketball
53271,2018,110592,California State University-Los Angeles,Los Angeles,CA,90032,5,NCAA Division II without football,8703,11991,20694,1,"Public, 4-year or above",2,17,13,646682,617781,1264463,646682,617781,1264463,Basketball
73796,2019,110592,California State University-Los Angeles,Los Angeles,CA,90032,5,NCAA Division II without football,8187,11495,19682,1,"Public, 4-year or above",2,15,15,648944,607833,1256777,648944,607833,1256777,Basketball
17157,2015,409698,California State University-Monterey Bay,Seaside,CA,939558001,5,NCAA Division II without football,2254,3757,6011,1,"Public, 4-year or above",2,16,18,448072,352255,800327,448072,352255,800327,Basketball
34562,2016,409698,California State University-Monterey Bay,Seaside,CA,93955,5,NCAA Division II without football,2287,3802,6089,1,"Public, 4-year or above",2,16,15,431316,350977,782293,431213,350952,782165,Basketball
52167,2017,409698,California State University-Monterey Bay,Seaside,CA,93955,5,NCAA Division II without football,2167,3810,5977,1,"Public, 4-year or above",2,14,15,419654,419139,838793,415568,418480,834048,Basketball
69924,2018,409698,California State University-Monterey Bay,Seaside,CA,93955,5,NCAA Division II without football,2170,3763,5933,1,"Public, 4-year or above",2,14,13,449155,393269,842424,449155,393269,842424,Basketball
131047,2019,409698,California State University-Monterey Bay,Seaside,CA,93955,5,NCAA Division II without football,2198,3756,5954,1,"Public, 4-year or above",2,20,13,504431,404751,909182,504431,404751,909182,Basketball
875,2015,110608,California State University-Northridge,Northridge,CA,91330,3,NCAA Division I without football,13667,16537,30204,1,"Public, 4-year or above",2,19,14,2077745,1332080,3409825,2060900,1404289,3465189,Basketball
18225,2016,110608,California State University-Northridge,Northridge,CA,91330,3,NCAA Division I without football,13103,15953,29056,1,"Public, 4-year or above",2,18,14,2200211,1326324,3526535,2143345,1395279,3538624,Basketball
35660,2017,110608,California State University-Northridge,Northridge,CA,91330,3,NCAA Division I without football,13413,16280,29693,1,"Public, 4-year or above",2,17,14,2636178,1497513,4133691,2686559,1478400,4164959,Basketball
53281,2018,110608,California State University-Northridge,Northridge,CA,91330,3,NCAA Division I without football,13185,16052,29237,1,"Public, 4-year or above",2,16,18,2238825,1709268,3948093,2438136,1518352,3956488,Basketball
73834,2019,110608,California State University-Northridge,Northridge,CA,91330,3,NCAA Division I without football,12972,16313,29285,1,"Public, 4-year or above",2,16,13,1915353,1584446,3499799,2633052,1565934,4198986,Basketball
885,2015,110617,California State University-Sacramento,Sacramento,CA,958192694,2,NCAA Division I-FCS,9502,12577,22079,1,"Public, 4-year or above",2,15,26,1012415,437309,1449724,1433424,1065355,2498779,Basketball
18235,2016,110617,California State University-Sacramento,Sacramento,CA,95819,2,NCAA Division I-FCS,10031,13150,23181,1,"Public, 4-year or above",2,14,34,1567497,1192760,2760257,1567497,1192760,2760257,Basketball
35670,2017,110617,California State University-Sacramento,Sacramento,CA,95819,2,NCAA Division I-FCS,10194,13268,23462,1,"Public, 4-year or above",2,14,30,1683928,1220101,2904029,1683928,1220101,2904029,Basketball
53291,2018,110617,California State University-Sacramento,Sacramento,CA,95819,2,NCAA Division I-FCS,10396,13249,23645,1,"Public, 4-year or above",2,16,29,1667359,1255081,2922440,1667359,1255081,2922440,Basketball
73872,2019,110617,California State University-Sacramento,Sacramento,CA,95819,2,NCAA Division I-FCS,10544,13530,24074,1,"Public, 4-year or above",2,16,24,1596695,1225350,2822045,1596695,1225350,2822045,Basketball
797,2015,110510,California State University-San Bernardino,San Bernardino,CA,924072397,5,NCAA Division II without football,6218,9558,15776,1,"Public, 4-year or above",2,18,14,582180,470957,1053137,506321,405733,912054,Basketball
18146,2016,110510,California State University-San Bernardino,San Bernardino,CA,92407,5,NCAA Division II without football,6475,9950,16425,1,"Public, 4-year or above",2,18,20,653132,504552,1157684,626563,495819,1122382,Basketball
35578,2017,110510,California State University-San Bernardino,San Bernardino,CA,92407,5,NCAA Division II without football,6527,9812,16339,1,"Public, 4-year or above",2,15,18,725084,420264,1145348,724203,423405,1147608,Basketball
53199,2018,110510,California State University-San Bernardino,San Bernardino,CA,92407,5,NCAA Division II without football,6311,9823,16134,1,"Public, 4-year or above",2,16,15,754268,515221,1269489,724745,502436,1227181,Basketball
73525,2019,110510,California State University-San Bernardino,San Bernardino,CA,92407,5,NCAA Division II without football,6448,10061,16509,1,"Public, 4-year or above",2,17,14,774421,472598,1247019,741347,460444,1201791,Basketball
17112,2015,366711,California State University-San Marcos,San Marcos,CA,920960001,5,NCAA Division II without football,3895,6272,10167,1,"Public, 4-year or above",2,16,15,471538,401971,873509,471538,401971,873509,Basketball
34516,2016,366711,California State University-San Marcos,San Marcos,CA,92096,5,NCAA Division II without football,3985,6459,10444,1,"Public, 4-year or above",2,15,15,423037,413210,836247,414482,398489,812971,Basketball
52118,2017,366711,California State University-San Marcos,San Marcos,CA,92096,5,NCAA Division II without football,4361,7247,11608,1,"Public, 4-year or above",2,15,17,467210,465793,933003,472946,451498,924444,Basketball
69874,2018,366711,California State University-San Marcos,San Marcos,CA,92096,5,NCAA Division II without football,4443,7431,11874,1,"Public, 4-year or above",2,15,20,512842,525474,1038316,512842,525474,1038316,Basketball
130623,2019,366711,California State University-San Marcos,San Marcos,CA,92096,5,NCAA Division II without football,4608,7515,12123,1,"Public, 4-year or above",2,13,15,506187,530236,1036423,506187,530236,1036423,Basketball
789,2015,110495,California State University-Stanislaus,Turlock,CA,953820299,5,NCAA Division II without football,2432,4343,6775,1,"Public, 4-year or above",2,15,17,416303,336555,752858,415078,333308,748386,Basketball
18138,2016,110495,California State University-Stanislaus,Turlock,CA,95382,5,NCAA Division II without football,2549,4666,7215,1,"Public, 4-year or above",2,16,17,410788,359546,770334,410788,368972,779760,Basketball
35570,2017,110495,California State University-Stanislaus,Turlock,CA,95382,5,NCAA Division II without football,2590,5031,7621,1,"Public, 4-year or above",2,18,16,567757,357362,925119,619963,411824,1031787,Basketball
53191,2018,110495,California State University-Stanislaus,Turlock,CA,95382,5,NCAA Division II without football,2614,5235,7849,1,"Public, 4-year or above",2,20,15,498010,419562,917572,494607,417818,912425,Basketball
73487,2019,110495,California State University-Stanislaus,Turlock,CA,95382,5,NCAA Division II without football,2831,5424,8255,1,"Public, 4-year or above",2,16,14,392251,357920,750171,494890,426110,921000,Basketball
12633,2015,211361,California University of Pennsylvania,California,PA,154191394,4,NCAA Division II with football,2359,2626,4985,1,"Public, 4-year or above",2,13,12,562072,508355,1070427,562072,508355,1070427,Basketball
30086,2016,211361,California University of Pennsylvania,California,PA,15419,4,NCAA Division II with football,2161,2442,4603,1,"Public, 4-year or above",2,13,16,507483,552672,1060155,507483,552672,1060155,Basketball
47582,2017,211361,California University of Pennsylvania,California,PA,15419,4,NCAA Division II with football,2173,2358,4531,1,"Public, 4-year or above",2,13,14,459286,523588,982874,459286,523588,982874,Basketball
65334,2018,211361,California University of Pennsylvania,California,PA,15419,4,NCAA Division II with football,1973,2233,4206,1,"Public, 4-year or above",2,14,16,413474,528144,941618,413474,528144,941618,Basketball
114601,2019,211361,California University of Pennsylvania,California,PA,15419,4,NCAA Division II with football,1804,2171,3975,1,"Public, 4-year or above",2,17,17,446079,477429,923508,446079,477429,923508,Basketball
7055,2015,169080,Calvin College,Grand Rapids,MI,49546,7,NCAA Division III without football,1640,2059,3699,2,"Private nonprofit, 4-year or above",2,16,18,147570,104166,251736,144908,104166,249074,Basketball
24447,2016,169080,Calvin College,Grand Rapids,MI,49546,7,NCAA Division III without football,1633,1956,3589,2,"Private nonprofit, 4-year or above",2,15,11,134168,137417,271585,134139,136993,271132,Basketball
41948,2017,169080,Calvin College,Grand Rapids,MI,49546,7,NCAA Division III without football,1595,1920,3515,2,"Private nonprofit, 4-year or above",2,15,22,153719,132263,285982,151129,132263,283392,Basketball
59644,2018,169080,Calvin College,Grand Rapids,MI,49546,7,NCAA Division III without football,1561,1854,3415,2,"Private nonprofit, 4-year or above",2,15,15,162651,149809,312460,162651,148076,310727,Basketball
94853,2019,169080,Calvin University,Grand Rapids,MI,49546,7,NCAA Division III without football,1493,1736,3229,2,"Private nonprofit, 4-year or above",2,20,19,180269,143478,323747,180269,140938,321207,Basketball
12054,2015,206914,Cameron University,Lawton,OK,735056377,5,NCAA Division II without football,1286,1884,3170,1,"Public, 4-year or above",2,17,16,382281,346845,729126,382281,345966,728247,Basketball
29495,2016,206914,Cameron University,Lawton,OK,73505,5,NCAA Division II without football,1245,1803,3048,1,"Public, 4-year or above",2,18,12,294535,299390,593925,294535,278769,573304,Basketball
46999,2017,206914,Cameron University,Lawton,OK,73505,5,NCAA Division II without football,1158,1654,2812,1,"Public, 4-year or above",2,13,14,334023,338793,672816,336501,331870,668371,Basketball
64742,2018,206914,Cameron University,Lawton,OK,73505,5,NCAA Division II without football,1072,1638,2710,1,"Public, 4-year or above",2,15,16,320300,345929,666229,343936,345882,689818,Basketball
112278,2019,206914,Cameron University,Lawton,OK,73505,5,NCAA Division II without football,967,1586,2553,1,"Public, 4-year or above",2,16,14,356830,329825,686655,356404,326072,682476,Basketball
10811,2015,198136,Campbell University,Buies Creek,NC,27506,2,NCAA Division I-FCS,1560,2050,3610,2,"Private nonprofit, 4-year or above",2,16,15,1581464,1296057,2877521,1581464,1296057,2877521,Basketball
28248,2016,198136,Campbell University,Buies Creek,NC,27506,2,NCAA Division I-FCS,1651,2083,3734,2,"Private nonprofit, 4-year or above",2,18,13,1676279,1356033,3032312,1676279,1356033,3032312,Basketball
45745,2017,198136,Campbell University,Buies Creek,NC,27506,2,NCAA Division I-FCS,1632,1997,3629,2,"Private nonprofit, 4-year or above",2,16,12,1899527,1418364,3317891,1899527,1418365,3317892,Basketball
63458,2018,198136,Campbell University,Buies Creek,NC,27506,2,NCAA Division I-FCS,1556,1913,3469,2,"Private nonprofit, 4-year or above",2,16,14,2085183,1480398,3565581,2085182,1480397,3565579,Basketball
107749,2019,198136,Campbell University,Buies Creek,NC,27506,2,NCAA Division I-FCS,1472,1783,3255,2,"Private nonprofit, 4-year or above",2,16,13,1676524,1290933,2967457,1676524,1290933,2967457,Basketball
9435,2015,189705,Canisius College,Buffalo,NY,142081098,3,NCAA Division I without football,1147,1370,2517,2,"Private nonprofit, 4-year or above",2,14,14,2027627,1519565,3547192,2027506,1519567,3547073,Basketball
26853,2016,189705,Canisius College,Buffalo,NY,14208,3,NCAA Division I without football,1174,1279,2453,2,"Private nonprofit, 4-year or above",2,14,14,1673040,1469002,3142042,1673040,1469002,3142042,Basketball
44343,2017,189705,Canisius College,Buffalo,NY,14208,3,NCAA Division I without football,1139,1146,2285,2,"Private nonprofit, 4-year or above",2,16,15,1791284,1461452,3252736,1791284,1461452,3252736,Basketball
62068,2018,189705,Canisius College,Buffalo,NY,14208,3,NCAA Division I without football,1105,1048,2153,2,"Private nonprofit, 4-year or above",2,17,13,1639094,1392360,3031454,1639094,1392360,3031454,Basketball
103628,2019,189705,Canisius College,Buffalo,NY,14208,3,NCAA Division I without football,1067,1027,2094,2,"Private nonprofit, 4-year or above",2,13,15,1541328,1374068,2915396,1541328,1374068,2915396,Basketball
11448,2015,201548,Capital University,Columbus,OH,432092394,6,NCAA Division III with football,1061,1417,2478,2,"Private nonprofit, 4-year or above",2,18,18,189347,314467,503814,161871,252092,413963,Basketball
28885,2016,201548,Capital University,Columbus,OH,43209,6,NCAA Division III with football,983,1467,2450,2,"Private nonprofit, 4-year or above",2,19,20,198273,209063,407336,198273,209063,407336,Basketball
46388,2017,201548,Capital University,Columbus,OH,43209,6,NCAA Division III with football,969,1470,2439,2,"Private nonprofit, 4-year or above",2,16,19,204118,219255,423373,204118,219255,423373,Basketball
64110,2018,201548,Capital University,Columbus,OH,43209,6,NCAA Division III with football,862,1411,2273,2,"Private nonprofit, 4-year or above",2,16,17,272156,323676,595832,272156,323676,595832,Basketball
110278,2019,201548,Capital University,Columbus,OH,43209,6,NCAA Division III with football,893,1469,2362,2,"Private nonprofit, 4-year or above",2,15,18,196055,206676,402731,196055,206676,402731,Basketball
7527,2015,173258,Carleton College,Northfield,MN,550574001,6,NCAA Division III with football,968,1027,1995,2,"Private nonprofit, 4-year or above",2,14,17,189823,142819,332642,198213,140766,338979,Basketball
24939,2016,173258,Carleton College,Northfield,MN,55057,6,NCAA Division III with football,1013,1032,2045,2,"Private nonprofit, 4-year or above",2,12,17,210513,147772,358285,194598,145359,339957,Basketball
42436,2017,173258,Carleton College,Northfield,MN,55057,6,NCAA Division III with football,988,1035,2023,2,"Private nonprofit, 4-year or above",2,10,16,204923,151362,356285,198428,150871,349299,Basketball
60140,2018,173258,Carleton College,Northfield,MN,55057,6,NCAA Division III with football,1013,1033,2046,2,"Private nonprofit, 4-year or above",2,12,12,204890,161265,366155,218293,155894,374187,Basketball
96597,2019,173258,Carleton College,Northfield,MN,55057,6,NCAA Division III with football,1013,1052,2065,2,"Private nonprofit, 4-year or above",2,11,10,181131,152747,333878,187002,141202,328204,Basketball
12648,2015,211440,Carnegie Mellon University,Pittsburgh,PA,152133890,6,NCAA Division III with football,3221,2631,5852,2,"Private nonprofit, 4-year or above",2,17,12,226522,221923,448445,226522,221923,448445,Basketball
30102,2016,211440,Carnegie Mellon University,Pittsburgh,PA,15213,6,NCAA Division III with football,3261,2807,6068,2,"Private nonprofit, 4-year or above",2,15,13,237222,222569,459791,237222,222569,459791,Basketball
47598,2017,211440,Carnegie Mellon University,Pittsburgh,PA,15213,6,NCAA Division III with football,3276,3019,6295,2,"Private nonprofit, 4-year or above",2,14,12,235763,215436,451199,235763,215436,451199,Basketball
65350,2018,211440,Carnegie Mellon University,Pittsburgh,PA,15213,6,NCAA Division III with football,3230,3110,6340,2,"Private nonprofit, 4-year or above",2,15,12,243725,217520,461245,243725,217520,461245,Basketball
114645,2019,211440,Carnegie Mellon University,Pittsburgh,PA,15213,6,NCAA Division III with football,3238,3186,6424,2,"Private nonprofit, 4-year or above",2,16,14,257082,236855,493937,253980,235755,489735,Basketball
16456,2015,238458,Carroll University,Waukesha,WI,53186,6,NCAA Division III with football,960,1765,2725,2,"Private nonprofit, 4-year or above",2,23,16,169135,101443,270578,162406,100875,263281,Basketball
33931,2016,238458,Carroll University,Waukesha,WI,53186,6,NCAA Division III with football,944,1771,2715,2,"Private nonprofit, 4-year or above",2,32,12,243310,119668,362978,217681,111211,328892,Basketball
51487,2017,238458,Carroll University,Waukesha,WI,53186,6,NCAA Division III with football,954,1770,2724,2,"Private nonprofit, 4-year or above",2,27,15,283726,144074,427800,272335,144074,416409,Basketball
69232,2018,238458,Carroll University,Waukesha,WI,53186,6,NCAA Division III with football,896,1783,2679,2,"Private nonprofit, 4-year or above",2,23,17,399421,168537,567958,287273,166891,454164,Basketball
128572,2019,238458,Carroll University,Waukesha,WI,53186,6,NCAA Division III with football,884,1868,2752,2,"Private nonprofit, 4-year or above",2,23,16,348870,184877,533747,285175,168509,453684,Basketball
14308,2015,219806,Carson-Newman University,Jefferson City,TN,37760,4,NCAA Division II with football,706,950,1656,2,"Private nonprofit, 4-year or above",2,14,18,524543,475564,1000107,491094,471556,962650,Basketball
31772,2016,219806,Carson-Newman University,Jefferson City,TN,37760,4,NCAA Division II with football,718,992,1710,2,"Private nonprofit, 4-year or above",2,16,16,629489,629489,1258978,574676,472536,1047212,Basketball
49287,2017,219806,Carson-Newman University,Jefferson City,TN,37760,4,NCAA Division II with football,667,926,1593,2,"Private nonprofit, 4-year or above",2,16,15,779244,478552,1257796,598888,480001,1078889,Basketball
67056,2018,219806,Carson-Newman University,Jefferson City,TN,37760,4,NCAA Division II with football,680,973,1653,2,"Private nonprofit, 4-year or above",2,17,15,708149,497974,1206123,597952,497974,1095926,Basketball
119999,2019,219806,Carson-Newman University,Jefferson City,TN,37760,4,NCAA Division II with football,688,1017,1705,2,"Private nonprofit, 4-year or above",2,17,14,738173,488024,1226197,577886,484617,1062503,Basketball
16467,2015,238476,Carthage College,Kenosha,WI,531401994,6,NCAA Division III with football,1241,1394,2635,2,"Private nonprofit, 4-year or above",2,28,14,281542,191479,473021,281542,191479,473021,Basketball
33942,2016,238476,Carthage College,Kenosha,WI,53140,6,NCAA Division III with football,1210,1434,2644,2,"Private nonprofit, 4-year or above",2,23,19,265664,186954,452618,265664,186954,452618,Basketball
51498,2017,238476,Carthage College,Kenosha,WI,53140,6,NCAA Division III with football,1157,1437,2594,2,"Private nonprofit, 4-year or above",2,23,18,293522,219890,513412,293522,219890,513412,Basketball
69243,2018,238476,Carthage College,Kenosha,WI,53140,6,NCAA Division III with football,1173,1476,2649,2,"Private nonprofit, 4-year or above",2,25,16,295845,224696,520541,295845,224696,520541,Basketball
128610,2019,238476,Carthage College,Kenosha,WI,53140,6,NCAA Division III with football,1075,1471,2546,2,"Private nonprofit, 4-year or above",2,25,16,267583,148178,415761,267583,148178,415761,Basketball
11458,2015,201645,Case Western Reserve University,Cleveland,OH,44106,6,NCAA Division III with football,2749,2247,4996,2,"Private nonprofit, 4-year or above",2,16,12,251354,208055,459409,262725,208055,470780,Basketball
28895,2016,201645,Case Western Reserve University,Cleveland,OH,44106,6,NCAA Division III with football,2734,2239,4973,2,"Private nonprofit, 4-year or above",2,15,13,281043,242236,523279,273066,231322,504388,Basketball
46398,2017,201645,Case Western Reserve University,Cleveland,OH,44106,6,NCAA Division III with football,2756,2210,4966,2,"Private nonprofit, 4-year or above",2,17,15,250666,207208,457874,252383,226003,478386,Basketball
64120,2018,201645,Case Western Reserve University,Cleveland,OH,44106,6,NCAA Division III with football,2785,2288,5073,2,"Private nonprofit, 4-year or above",2,19,20,310344,276842,587186,278848,259304,538152,Basketball
110288,2019,201645,Case Western Reserve University,Cleveland,OH,44106,6,NCAA Division III with football,2831,2385,5216,2,"Private nonprofit, 4-year or above",2,18,15,288326,245254,533580,276658,243118,519776,Basketball
15459,2015,230834,Castleton University,Castleton,VT,5735,6,NCAA Division III with football,862,866,1728,1,"Public, 4-year or above",2,17,15,101853,107051,208904,88139,101712,189851,Basketball
32924,2016,230834,Castleton University,Castleton,VT,5735,6,NCAA Division III with football,868,862,1730,1,"Public, 4-year or above",2,16,13,123293,136080,259373,109458,136080,245538,Basketball
50457,2017,230834,Castleton University,Castleton,VT,5735,6,NCAA Division III with football,783,807,1590,1,"Public, 4-year or above",2,19,15,122553,134834,257387,108622,124214,232836,Basketball
68233,2018,230834,Castleton University,Castleton,VT,5735,6,NCAA Division III with football,810,818,1628,1,"Public, 4-year or above",2,22,11,129642,171816,301458,118260,161245,279505,Basketball
124973,2019,230834,Castleton University,Castleton,VT,5735,6,NCAA Division III with football,807,845,1652,1,"Public, 4-year or above",2,12,14,90656,125273,215929,77693,115938,193631,Basketball
10827,2015,198215,Catawba College,Salisbury,NC,28144,4,NCAA Division II with football,580,623,1203,2,"Private nonprofit, 4-year or above",2,20,15,440099,404465,844564,440099,404256,844355,Basketball
28264,2016,198215,Catawba College,Salisbury,NC,28144,4,NCAA Division II with football,584,652,1236,2,"Private nonprofit, 4-year or above",2,19,14,437262,376281,813543,434670,372306,806976,Basketball
45761,2017,198215,Catawba College,Salisbury,NC,28144,4,NCAA Division II with football,602,666,1268,2,"Private nonprofit, 4-year or above",2,37,17,511035,450197,961232,509647,448028,957675,Basketball
63474,2018,198215,Catawba College,Salisbury,NC,28144,4,NCAA Division II with football,583,646,1229,2,"Private nonprofit, 4-year or above",2,48,14,633377,420037,1053414,629284,417038,1046322,Basketball
107825,2019,198215,Catawba College,Salisbury,NC,28144,4,NCAA Division II with football,572,650,1222,2,"Private nonprofit, 4-year or above",2,36,18,611215,481845,1093060,603830,476587,1080417,Basketball
2616,2015,131283,Catholic University of America,Washington,DC,20064,6,NCAA Division III with football,1543,1781,3324,2,"Private nonprofit, 4-year or above",2,21,24,275709,283933,559642,265310,250014,515324,Basketball
19989,2016,131283,Catholic University of America,Washington,DC,20064,6,NCAA Division III with football,1410,1678,3088,2,"Private nonprofit, 4-year or above",2,21,15,267429,254478,521907,267629,252850,520479,Basketball
37428,2017,131283,Catholic University of America,Washington,DC,20064,6,NCAA Division III with football,1453,1735,3188,2,"Private nonprofit, 4-year or above",2,18,20,292940,272519,565459,274418,264422,538840,Basketball
55070,2018,131283,Catholic University of America,Washington,DC,20064,6,NCAA Division III with football,1494,1701,3195,2,"Private nonprofit, 4-year or above",2,17,14,233253,250727,483980,245190,247577,492767,Basketball
9452,2015,189848,Cazenovia College,Cazenovia,NY,13035,7,NCAA Division III without football,251,692,943,2,"Private nonprofit, 4-year or above",2,14,14,45215,42035,87250,45215,42035,87250,Basketball
26870,2016,189848,Cazenovia College,Cazenovia,NY,13035,7,NCAA Division III without football,235,623,858,2,"Private nonprofit, 4-year or above",2,14,11,45440,28755,74195,45440,28755,74195,Basketball
44359,2017,189848,Cazenovia College,Cazenovia,NY,13035,7,NCAA Division III without football,208,505,713,2,"Private nonprofit, 4-year or above",2,15,13,33943,38968,72911,33943,38968,72911,Basketball
62086,2018,189848,Cazenovia College,Cazenovia,NY,13035,7,NCAA Division III without football,212,496,708,2,"Private nonprofit, 4-year or above",2,14,13,39703,35182,74885,39703,35182,74885,Basketball
103704,2019,189848,Cazenovia College,Cazenovia,NY,13035,7,NCAA Division III without football,192,499,691,2,"Private nonprofit, 4-year or above",2,15,13,39557,43561,83118,39557,43561,83118,Basketball
12656,2015,211468,Cedar Crest College,Allentown,PA,181046196,7,NCAA Division III without football,74,700,774,2,"Private nonprofit, 4-year or above",2,0,9,NA,79569,79569,NA,76574,76574,Basketball
30110,2016,211468,Cedar Crest College,Allentown,PA,18104,7,NCAA Division III without football,132,750,882,2,"Private nonprofit, 4-year or above",2,0,11,NA,88978,88978,NA,85541,85541,Basketball
47606,2017,211468,Cedar Crest College,Allentown,PA,18104,7,NCAA Division III without football,116,813,929,2,"Private nonprofit, 4-year or above",2,0,8,NA,93982,93982,NA,87409,87409,Basketball
65359,2018,211468,Cedar Crest College,Allentown,PA,18104,7,NCAA Division III without football,96,832,928,2,"Private nonprofit, 4-year or above",2,0,13,NA,82108,82108,NA,79207,79207,Basketball
114682,2019,211468,Cedar Crest College,Allentown,PA,18104,7,NCAA Division III without football,63,809,872,2,"Private nonprofit, 4-year or above",2,0,11,NA,93454,93454,NA,92408,92408,Basketball
11470,2015,201654,Cedarville University,Cedarville,OH,453140601,5,NCAA Division II without football,1452,1552,3004,2,"Private nonprofit, 4-year or above",2,14,14,547656,546531,1094187,547656,546531,1094187,Basketball
28907,2016,201654,Cedarville University,Cedarville,OH,45314,5,NCAA Division II without football,1457,1553,3010,2,"Private nonprofit, 4-year or above",2,15,14,553530,525137,1078667,553530,525137,1078667,Basketball
46410,2017,201654,Cedarville University,Cedarville,OH,45314,5,NCAA Division II without football,1458,1631,3089,2,"Private nonprofit, 4-year or above",2,15,15,581655,533571,1115226,581655,533571,1115226,Basketball
64132,2018,201654,Cedarville University,Cedarville,OH,45314,5,NCAA Division II without football,1531,1734,3265,2,"Private nonprofit, 4-year or above",2,15,16,610934,605037,1215971,610934,605037,1215971,Basketball
110300,2019,201654,Cedarville University,Cedarville,OH,45314,5,NCAA Division II without football,1583,1842,3425,2,"Private nonprofit, 4-year or above",2,15,13,513725,427509,941234,513725,427509,941234,Basketball
8953,2015,183974,Centenary College,Hackettstown,NJ,7840,7,NCAA Division III without football,571,897,1468,2,"Private nonprofit, 4-year or above",2,19,13,70160,47406,117566,70160,46314,116474,Basketball
5724,2015,158477,Centenary College of Louisiana,Shreveport,LA,711341188,7,NCAA Division III without football,227,285,512,2,"Private nonprofit, 4-year or above",2,16,13,117996,128574,246570,117996,128574,246570,Basketball
23102,2016,158477,Centenary College of Louisiana,Shreveport,LA,71134,7,NCAA Division III without football,205,268,473,2,"Private nonprofit, 4-year or above",2,15,13,141821,122813,264634,141821,122813,264634,Basketball
40599,2017,158477,Centenary College of Louisiana,Shreveport,LA,71134,7,NCAA Division III without football,228,292,520,2,"Private nonprofit, 4-year or above",2,19,15,114962,114225,229187,114962,114225,229187,Basketball
58286,2018,158477,Centenary College of Louisiana,Shreveport,LA,71104,7,NCAA Division III without football,227,311,538,2,"Private nonprofit, 4-year or above",2,26,15,131014,131084,262098,131014,131084,262098,Basketball
90542,2019,158477,Centenary College of Louisiana,Shreveport,LA,71104,7,NCAA Division III without football,215,320,535,2,"Private nonprofit, 4-year or above",2,15,12,138518,134030,272548,138518,134030,272548,Basketball
26378,2016,183974,Centenary University,Hackettstown,NJ,7840,7,NCAA Division III without football,450,782,1232,2,"Private nonprofit, 4-year or above",2,13,14,81636,66154,147790,81636,66154,147790,Basketball
43874,2017,183974,Centenary University,Hackettstown,NJ,7840,7,NCAA Division III without football,407,714,1121,2,"Private nonprofit, 4-year or above",2,16,12,81867,67224,149091,81867,67224,149091,Basketball
61593,2018,183974,Centenary University,Hackettstown,NJ,7840,7,NCAA Division III without football,375,680,1055,2,"Private nonprofit, 4-year or above",2,19,16,67452,58547,125999,67800,57056,124856,Basketball
101901,2019,183974,Centenary University,Hackettstown,NJ,7840,7,NCAA Division III without football,342,696,1038,2,"Private nonprofit, 4-year or above",2,19,14,54921,60309,115230,54921,56815,111736,Basketball
4707,2015,153108,Central College,Pella,IA,50219,6,NCAA Division III with football,579,629,1208,2,"Private nonprofit, 4-year or above",2,35,25,169428,116530,285958,169428,116530,285958,Basketball
22069,2016,153108,Central College,Pella,IA,50219,6,NCAA Division III with football,573,603,1176,2,"Private nonprofit, 4-year or above",2,36,22,127573,133694,261267,127573,133694,261267,Basketball
39542,2017,153108,Central College,Pella,IA,50219,6,NCAA Division III with football,598,581,1179,2,"Private nonprofit, 4-year or above",2,26,21,172214,141095,313309,172214,141095,313309,Basketball
57205,2018,153108,Central College,Pella,IA,50219,6,NCAA Division III with football,531,529,1060,2,"Private nonprofit, 4-year or above",2,22,23,180793,130948,311741,180793,130948,311741,Basketball
87275,2019,153108,Central College,Pella,IA,50219,6,NCAA Division III with football,585,522,1107,2,"Private nonprofit, 4-year or above",2,34,26,172245,134487,306732,172245,134487,306732,Basketball
2340,2015,128771,Central Connecticut State University,New Britain,CT,6050,2,NCAA Division I-FCS,4125,3612,7737,1,"Public, 4-year or above",2,15,14,1943091,1101706,3044797,1511666,1067132,2578798,Basketball
19712,2016,128771,Central Connecticut State University,New Britain,CT,6050,2,NCAA Division I-FCS,4002,3527,7529,1,"Public, 4-year or above",2,14,14,1859470,1155129,3014599,1525439,1066348,2591787,Basketball
37151,2017,128771,Central Connecticut State University,New Britain,CT,6050,2,NCAA Division I-FCS,3976,3617,7593,1,"Public, 4-year or above",2,14,13,2050444,1379878,3430322,1395187,1163158,2558345,Basketball
54788,2018,128771,Central Connecticut State University,New Britain,CT,6050,2,NCAA Division I-FCS,3986,3585,7571,1,"Public, 4-year or above",2,14,14,1402297,1191504,2593801,1402297,1191504,2593801,Basketball
78848,2019,128771,Central Connecticut State University,New Britain,CT,6050,2,NCAA Division I-FCS,3777,3466,7243,1,"Public, 4-year or above",2,15,15,1360085,1633294,2993379,1360085,1633294,2993379,Basketball
7065,2015,169248,Central Michigan University,Mount Pleasant,MI,48859,1,NCAA Division I-FBS,7719,9840,17559,1,"Public, 4-year or above",2,19,24,1646267,1320668,2966935,1646267,1320668,2966935,Basketball
24457,2016,169248,Central Michigan University,Mount Pleasant,MI,48859,1,NCAA Division I-FBS,7413,9664,17077,1,"Public, 4-year or above",2,18,22,1864613,1400552,3265165,1864613,1400552,3265165,Basketball
41959,2017,169248,Central Michigan University,Mount Pleasant,MI,48859,1,NCAA Division I-FBS,6696,8777,15473,1,"Public, 4-year or above",2,18,22,2098994,1711326,3810320,2098994,1711326,3810320,Basketball
59655,2018,169248,Central Michigan University,Mount Pleasant,MI,48859,1,NCAA Division I-FBS,6047,8123,14170,1,"Public, 4-year or above",2,17,25,2168814,1833286,4002100,2168814,1833286,4002100,Basketball
94865,2019,169248,Central Michigan University,Mount Pleasant,MI,48859,1,NCAA Division I-FBS,5284,7436,12720,1,"Public, 4-year or above",2,17,12,2100421,1656694,3757115,2100421,1656694,3757115,Basketball
11479,2015,201690,Central State University,Wilberforce,OH,453841004,4,NCAA Division II with football,740,909,1649,1,"Public, 4-year or above",2,16,14,256388,303884,560272,256388,303884,560272,Basketball
28916,2016,201690,Central State University,Wilberforce,OH,453841004,4,NCAA Division II with football,713,888,1601,1,"Public, 4-year or above",2,16,13,309812,294293,604105,309812,294293,604105,Basketball
46419,2017,201690,Central State University,Wilberforce,OH,45384,4,NCAA Division II with football,692,1014,1706,1,"Public, 4-year or above",2,18,17,347614,330574,678188,347614,330574,678188,Basketball
64141,2018,201690,Central State University,Wilberforce,OH,45384,4,NCAA Division II with football,807,1222,2029,1,"Public, 4-year or above",2,15,19,364427,290806,655233,364427,290806,655233,Basketball
110337,2019,201690,Central State University,Wilberforce,OH,45384,4,NCAA Division II with football,748,1170,1918,1,"Public, 4-year or above",2,15,19,367715,279231,646946,367715,279231,646946,Basketball
15984,2015,234827,Central Washington University,Ellensburg,WA,989267501,4,NCAA Division II with football,4423,4553,8976,1,"Public, 4-year or above",2,16,14,504014,444582,948596,495330,445808,941138,Basketball
33457,2016,234827,Central Washington University,Ellensburg,WA,98926,4,NCAA Division II with football,4617,4788,9405,1,"Public, 4-year or above",2,16,15,560461,450926,1011387,498145,445890,944035,Basketball
51010,2017,234827,Central Washington University,Ellensburg,WA,98926,4,NCAA Division II with football,4924,5348,10272,1,"Public, 4-year or above",2,15,19,523234,456263,979497,554916,451521,1006437,Basketball
68761,2018,234827,Central Washington University,Ellensburg,WA,98926,4,NCAA Division II with football,4667,4892,9559,1,"Public, 4-year or above",2,16,12,536267,421781,958048,480341,421537,901878,Basketball
126652,2019,234827,Central Washington University,Ellensburg,WA,98926,4,NCAA Division II with football,4710,5123,9833,1,"Public, 4-year or above",2,16,14,540561,481425,1021986,519760,480842,1000602,Basketball
5508,2015,156408,Centre College,Danville,KY,404221394,6,NCAA Division III with football,678,673,1351,2,"Private nonprofit, 4-year or above",2,17,21,153437,110011,263448,153437,110011,263448,Basketball
22883,2016,156408,Centre College,Danville,KY,40422,6,NCAA Division III with football,698,722,1420,2,"Private nonprofit, 4-year or above",2,14,19,134845,122796,257641,134845,122796,257641,Basketball
40374,2017,156408,Centre College,Danville,KY,40422,6,NCAA Division III with football,705,735,1440,2,"Private nonprofit, 4-year or above",2,15,19,158236,142867,301103,158236,142867,301103,Basketball
58051,2018,156408,Centre College,Danville,KY,40422,6,NCAA Division III with football,698,727,1425,2,"Private nonprofit, 4-year or above",2,20,20,147344,124367,271711,147344,124367,271711,Basketball
89927,2019,156408,Centre College,Danville,KY,40422,6,NCAA Division III with football,677,724,1401,2,"Private nonprofit, 4-year or above",2,20,18,175192,148931,324123,175192,148931,324123,Basketball
8556,2015,180948,Chadron State College,Chadron,NE,693372690,4,NCAA Division II with football,742,989,1731,1,"Public, 4-year or above",2,17,13,364192,333637,697829,364192,333637,697829,Basketball
25989,2016,180948,Chadron State College,Chadron,NE,69337,4,NCAA Division II with football,747,962,1709,1,"Public, 4-year or above",2,18,15,354883,325972,680855,354883,325972,680855,Basketball
43479,2017,180948,Chadron State College,Chadron,NE,69337,4,NCAA Division II with football,697,915,1612,1,"Public, 4-year or above",2,19,17,449462,397036,846498,449462,397036,846498,Basketball
61197,2018,180948,Chadron State College,Chadron,NE,69337,4,NCAA Division II with football,666,831,1497,1,"Public, 4-year or above",2,18,15,417647,346689,764336,417647,346689,764336,Basketball
100565,2019,180948,Chadron State College,Chadron,NE,69337,4,NCAA Division II with football,655,782,1437,1,"Public, 4-year or above",2,18,17,421871,357971,779842,421871,357971,779842,Basketball
3486,2015,141486,Chaminade University of Honolulu,Honolulu,HI,968161578,5,NCAA Division II without football,450,986,1436,2,"Private nonprofit, 4-year or above",2,17,13,689537,199880,889417,689537,199880,889417,Basketball
20856,2016,141486,Chaminade University of Honolulu,Honolulu,HI,96816,5,NCAA Division II without football,407,945,1352,2,"Private nonprofit, 4-year or above",2,14,13,716647,159499,876146,716647,159499,876146,Basketball
38312,2017,141486,Chaminade University of Honolulu,Honolulu,HI,96816,5,NCAA Division II without football,471,1043,1514,2,"Private nonprofit, 4-year or above",2,16,14,697219,180245,877464,697219,180245,877464,Basketball
55965,2018,141486,Chaminade University of Honolulu,Honolulu,HI,96816,5,NCAA Division II without football,408,985,1393,2,"Private nonprofit, 4-year or above",2,16,17,659162,197754,856916,659162,197754,856916,Basketball
82819,2019,141486,Chaminade University of Honolulu,Honolulu,HI,96816,5,NCAA Division II without football,367,962,1329,2,"Private nonprofit, 4-year or above",2,13,12,671094,202083,873177,671094,202083,873177,Basketball
1049,2015,111948,Chapman University,Orange,CA,92866,6,NCAA Division III with football,2380,3676,6056,2,"Private nonprofit, 4-year or above",2,18,14,214244,176485,390729,214244,176485,390729,Basketball
18402,2016,111948,Chapman University,Orange,CA,92866,6,NCAA Division III with football,2387,3732,6119,2,"Private nonprofit, 4-year or above",2,19,16,194397,187691,382088,194397,187691,382088,Basketball
35837,2017,111948,Chapman University,Orange,CA,92866,6,NCAA Division III with football,2534,3961,6495,2,"Private nonprofit, 4-year or above",2,24,16,217751,173666,391417,217751,173666,391417,Basketball
53460,2018,111948,Chapman University,Orange,CA,92866,6,NCAA Division III with football,2627,4148,6775,2,"Private nonprofit, 4-year or above",2,18,15,216939,204801,421740,216939,204801,421740,Basketball
74307,2019,111948,Chapman University,Orange,CA,92866,6,NCAA Division III with football,2734,4301,7035,2,"Private nonprofit, 4-year or above",2,20,20,224563,174261,398824,224563,174261,398824,Basketball
13905,2015,217688,Charleston Southern University,Charleston,SC,294069121,2,NCAA Division I-FCS,1046,1750,2796,2,"Private nonprofit, 4-year or above",2,16,14,1458792,1133581,2592373,1458792,1133581,2592373,Basketball
31358,2016,217688,Charleston Southern University,Charleston,SC,29406,2,NCAA Division I-FCS,1086,1810,2896,2,"Private nonprofit, 4-year or above",2,17,16,1347387,1011834,2359221,1347387,1011834,2359221,Basketball
48871,2017,217688,Charleston Southern University,Charleston,SC,29406,2,NCAA Division I-FCS,1064,1729,2793,2,"Private nonprofit, 4-year or above",2,16,15,1388912,1039703,2428615,1388912,1039703,2428615,Basketball
66628,2018,217688,Charleston Southern University,Charleston,SC,29406,2,NCAA Division I-FCS,1012,1714,2726,2,"Private nonprofit, 4-year or above",2,15,13,1243917,817872,2061789,1243917,817872,2061789,Basketball
118357,2019,217688,Charleston Southern University,Charleston,SC,29406,2,NCAA Division I-FCS,931,1624,2555,2,"Private nonprofit, 4-year or above",2,14,15,1390264,1007188,2397452,1390264,1007188,2397452,Basketball
12670,2015,211556,Chatham University,Pittsburgh,PA,15232,7,NCAA Division III without football,80,531,611,2,"Private nonprofit, 4-year or above",2,22,12,106535,129417,235952,101525,115347,216872,Basketball
30125,2016,211556,Chatham University,Pittsburgh,PA,15232,7,NCAA Division III without football,139,567,706,2,"Private nonprofit, 4-year or above",2,25,12,118833,109284,228117,116333,109284,225617,Basketball
47620,2017,211556,Chatham University,Pittsburgh,PA,15232,7,NCAA Division III without football,228,686,914,2,"Private nonprofit, 4-year or above",2,21,10,118005,117732,235737,116331,115472,231803,Basketball
65373,2018,211556,Chatham University,Pittsburgh,PA,15232,7,NCAA Division III without football,288,707,995,2,"Private nonprofit, 4-year or above",2,16,16,120166,118381,238547,119411,117927,237338,Basketball
114757,2019,211556,Chatham University,Pittsburgh,PA,15232,7,NCAA Division III without football,326,776,1102,2,"Private nonprofit, 4-year or above",2,18,22,112903,114905,227808,111158,108896,220054,Basketball
12679,2015,211583,Chestnut Hill College,Philadelphia,PA,191182693,5,NCAA Division II without football,414,723,1137,2,"Private nonprofit, 4-year or above",2,16,12,237625,199226,436851,235887,188179,424066,Basketball
30133,2016,211583,Chestnut Hill College,Philadelphia,PA,19118,5,NCAA Division II without football,414,674,1088,2,"Private nonprofit, 4-year or above",2,15,16,229806,254760,484566,229806,254760,484566,Basketball
47630,2017,211583,Chestnut Hill College,Philadelphia,PA,19118,5,NCAA Division II without football,435,657,1092,2,"Private nonprofit, 4-year or above",2,14,14,250447,262925,513372,249164,261282,510446,Basketball
65383,2018,211583,Chestnut Hill College,Philadelphia,PA,19118,5,NCAA Division II without football,437,575,1012,2,"Private nonprofit, 4-year or above",2,13,15,256961,290924,547885,254552,290924,545476,Basketball
114793,2019,211583,Chestnut Hill College,Philadelphia,PA,19118,5,NCAA Division II without football,433,558,991,2,"Private nonprofit, 4-year or above",2,17,12,208832,256205,465037,210627,256265,466892,Basketball
12689,2015,211608,Cheyney University of Pennsylvania,Cheyney,PA,193190200,4,NCAA Division II with football,308,311,619,1,"Public, 4-year or above",2,16,13,269830,191360,461190,252229,171025,423254,Basketball
30143,2016,211608,Cheyney University of Pennsylvania,Cheyney,PA,19319,4,NCAA Division II with football,342,315,657,1,"Public, 4-year or above",2,15,11,223138,255081,478219,211721,246114,457835,Basketball
47640,2017,211608,Cheyney University of Pennsylvania,Cheyney,PA,19319,4,NCAA Division II with football,345,325,670,1,"Public, 4-year or above",2,18,13,180470,245285,425755,180470,245285,425755,Basketball
3648,2015,144005,Chicago State University,Chicago,IL,606281598,3,NCAA Division I without football,677,1582,2259,1,"Public, 4-year or above",2,16,11,681728,627382,1309110,681728,627382,1309110,Basketball
21018,2016,144005,Chicago State University,Chicago,IL,60628,3,NCAA Division I without football,449,1015,1464,1,"Public, 4-year or above",2,17,9,1180256,704518,1884774,701571,566831,1268402,Basketball
38476,2017,144005,Chicago State University,Chicago,IL,60628,3,NCAA Division I without football,409,888,1297,1,"Public, 4-year or above",2,15,12,1192542,711715,1904257,919075,643354,1562429,Basketball
56129,2018,144005,Chicago State University,Chicago,IL,60628,3,NCAA Division I without football,433,854,1287,1,"Public, 4-year or above",2,14,13,978120,805100,1783220,801305,805100,1606405,Basketball
83410,2019,144005,Chicago State University,Chicago,IL,60628,3,NCAA Division I without football,432,929,1361,1,"Public, 4-year or above",2,16,15,1380882,1194593,2575475,841596,882854,1724450,Basketball
10844,2015,198303,Chowan University,Murfreesboro,NC,27855,4,NCAA Division II with football,680,773,1453,2,"Private nonprofit, 4-year or above",2,13,15,427555,432313,859868,427555,432313,859868,Basketball
28281,2016,198303,Chowan University,Murfreesboro,NC,27855,4,NCAA Division II with football,691,777,1468,2,"Private nonprofit, 4-year or above",2,14,15,492286,446535,938821,492286,446535,938821,Basketball
45778,2017,198303,Chowan University,Murfreesboro,NC,27855,4,NCAA Division II with football,682,758,1440,2,"Private nonprofit, 4-year or above",2,15,13,457080,440669,897749,457080,440669,897749,Basketball
63492,2018,198303,Chowan University,Murfreesboro,NC,27855,4,NCAA Division II with football,668,688,1356,2,"Private nonprofit, 4-year or above",2,30,16,435802,436690,872492,435802,436690,872492,Basketball
107938,2019,198303,Chowan University,Murfreesboro,NC,27855,4,NCAA Division II with football,663,580,1243,2,"Private nonprofit, 4-year or above",2,37,16,489842,410429,900271,489842,410429,900271,Basketball
14323,2015,219833,Christian Brothers University,Memphis,TN,38104,5,NCAA Division II without football,618,682,1300,2,"Private nonprofit, 4-year or above",2,17,14,456145,383973,840118,456034,383852,839886,Basketball
31787,2016,219833,Christian Brothers University,Memphis,TN,38104,5,NCAA Division II without football,645,686,1331,2,"Private nonprofit, 4-year or above",2,14,13,456151,446270,902421,450856,438251,889107,Basketball
49302,2017,219833,Christian Brothers University,Memphis,TN,38104,5,NCAA Division II without football,678,724,1402,2,"Private nonprofit, 4-year or above",2,16,13,463356,440439,903795,463356,440439,903795,Basketball
67072,2018,219833,Christian Brothers University,Memphis,TN,38104,5,NCAA Division II without football,704,732,1436,2,"Private nonprofit, 4-year or above",2,15,12,552094,407811,959905,552094,407811,959905,Basketball
120049,2019,219833,Christian Brothers University,Memphis,TN,38104,5,NCAA Division II without football,669,698,1367,2,"Private nonprofit, 4-year or above",2,15,11,632884,453967,1086851,632884,453967,1086851,Basketball
15609,2015,231712,Christopher Newport University,Newport News,VA,236063072,6,NCAA Division III with football,2138,2823,4961,1,"Public, 4-year or above",2,19,18,284631,224027,508658,284631,224027,508658,Basketball
33079,2016,231712,Christopher Newport University,Newport News,VA,23606,6,NCAA Division III with football,2100,2756,4856,1,"Public, 4-year or above",2,17,19,280627,248764,529391,280627,248764,529391,Basketball
50621,2017,231712,Christopher Newport University,Newport News,VA,23606,6,NCAA Division III with football,2115,2752,4867,1,"Public, 4-year or above",2,17,17,303506,261395,564901,303506,261395,564901,Basketball
68368,2018,231712,Christopher Newport University,Newport News,VA,23606,6,NCAA Division III with football,2120,2669,4789,1,"Public, 4-year or above",2,20,16,360914,260643,621557,360914,260643,621557,Basketball
125357,2019,231712,Christopher Newport University,Newport News,VA,23606,6,NCAA Division III with football,2123,2618,4741,1,"Public, 4-year or above",2,18,19,318131,281102,599233,318131,281102,599233,Basketball
13946,2015,217864,Citadel Military College of South Carolina,Charleston,SC,29409,2,NCAA Division I-FCS,2269,192,2461,1,"Public, 4-year or above",2,15,0,1596044,NA,1596044,1527117,NA,1527117,Basketball
31402,2016,217864,Citadel Military College of South Carolina,Charleston,SC,29409,2,NCAA Division I-FCS,2308,195,2503,1,"Public, 4-year or above",2,15,0,1684099,NA,1684099,1490057,NA,1490057,Basketball
48915,2017,217864,Citadel Military College of South Carolina,Charleston,SC,29409,2,NCAA Division I-FCS,2315,243,2558,1,"Public, 4-year or above",2,14,0,1606299,NA,1606299,1514520,NA,1514520,Basketball
66672,2018,217864,Citadel Military College of South Carolina,Charleston,SC,29409,2,NCAA Division I-FCS,2382,272,2654,1,"Public, 4-year or above",2,14,0,1613769,NA,1613769,1477703,NA,1477703,Basketball
118521,2019,217864,Citadel Military College of South Carolina,Charleston,SC,29409,2,NCAA Division I-FCS,2377,311,2688,1,"Public, 4-year or above",2,16,0,1753516,NA,1753516,1526706,NA,1526706,Basketball
13956,2015,217873,Claflin University,Orangeburg,SC,291154498,5,NCAA Division II without football,642,1165,1807,2,"Private nonprofit, 4-year or above",2,17,15,407474,346160,753634,407474,346160,753634,Basketball
31412,2016,217873,Claflin University,Orangeburg,SC,29115,5,NCAA Division II without football,648,1225,1873,2,"Private nonprofit, 4-year or above",2,23,14,426317,361375,787692,426317,361375,787692,Basketball
48925,2017,217873,Claflin University,Orangeburg,SC,29115,5,NCAA Division II without football,620,1335,1955,2,"Private nonprofit, 4-year or above",2,20,15,443694,404024,847718,443694,404024,847718,Basketball
66682,2018,217873,Claflin University,Orangeburg,SC,29115,5,NCAA Division II without football,618,1366,1984,2,"Private nonprofit, 4-year or above",2,20,16,493194,365490,858684,493194,365490,858684,Basketball
118556,2019,217873,Claflin University,Orangeburg,SC,29115,5,NCAA Division II without football,601,1288,1889,2,"Private nonprofit, 4-year or above",2,23,15,472341,287125,759466,472341,287125,759466,Basketball
1101,2015,112260,Claremont McKenna College,Claremont,CA,917116400,6,NCAA Division III with football,676,648,1324,2,"Private nonprofit, 4-year or above",2,20,15,190445,164906,355351,190445,164906,355351,Basketball
18455,2016,112260,Claremont McKenna College,Claremont,CA,91711,6,NCAA Division III with football,688,655,1343,2,"Private nonprofit, 4-year or above",2,18,18,207497,188684,396181,207497,188684,396181,Basketball
35890,2017,112260,Claremont McKenna College,Claremont,CA,91711,6,NCAA Division III with football,697,637,1334,2,"Private nonprofit, 4-year or above",2,21,15,205072,160543,365615,205072,160543,365615,Basketball
53512,2018,112260,Claremont McKenna College,Claremont,CA,91711,6,NCAA Division III with football,687,629,1316,2,"Private nonprofit, 4-year or above",2,18,17,237998,196169,434167,237998,196169,434167,Basketball
74415,2019,112260,Claremont McKenna College,Claremont,CA,91711,6,NCAA Division III with football,673,660,1333,2,"Private nonprofit, 4-year or above",2,20,15,235522,165061,400583,235522,165061,400583,Basketball
12695,2015,211644,Clarion University of Pennsylvania,Clarion,PA,16214,4,NCAA Division II with football,1439,2258,3697,1,"Public, 4-year or above",2,16,14,332268,308397,640665,339744,309922,649666,Basketball
30148,2016,211644,Clarion University of Pennsylvania,Clarion,PA,16214,4,NCAA Division II with football,1350,2217,3567,1,"Public, 4-year or above",2,12,12,266916,360748,627664,350782,363179,713961,Basketball
47645,2017,211644,Clarion University of Pennsylvania,Clarion,PA,16214,4,NCAA Division II with football,1322,2160,3482,1,"Public, 4-year or above",2,13,12,350591,367514,718105,340712,353425,694137,Basketball
65396,2018,211644,Clarion University of Pennsylvania,Clarion,PA,16214,4,NCAA Division II with football,1116,2010,3126,1,"Public, 4-year or above",2,15,12,367154,401820,768974,365671,396470,762141,Basketball
114868,2019,211644,Clarion University of Pennsylvania,Clarion,PA,16214,4,NCAA Division II with football,1010,1979,2989,1,"Public, 4-year or above",2,17,13,400383,433723,834106,387926,405269,793195,Basketball
3169,2015,138947,Clark Atlanta University,Atlanta,GA,303144391,4,NCAA Division II with football,680,1949,2629,2,"Private nonprofit, 4-year or above",2,17,10,361525,364125,725650,370856,334951,705807,Basketball
20533,2016,138947,Clark Atlanta University,Atlanta,GA,30314,4,NCAA Division II with football,862,2124,2986,2,"Private nonprofit, 4-year or above",2,13,12,488885,402932,891817,490190,330519,820709,Basketball
37992,2017,138947,Clark Atlanta University,Atlanta,GA,30314,4,NCAA Division II with football,865,2322,3187,2,"Private nonprofit, 4-year or above",2,12,12,592804,471508,1064312,565058,471508,1036566,Basketball
55643,2018,138947,Clark Atlanta University,Atlanta,GA,30314,4,NCAA Division II with football,787,2447,3234,2,"Private nonprofit, 4-year or above",2,14,10,759628,694958,1454586,748404,648746,1397150,Basketball
81799,2019,138947,Clark Atlanta University,Atlanta,GA,30314,4,NCAA Division II with football,786,2469,3255,2,"Private nonprofit, 4-year or above",2,16,14,479668,428834,908502,464178,421534,885712,Basketball
6474,2015,165334,Clark University,Worcester,MA,16101477,7,NCAA Division III without football,900,1401,2301,2,"Private nonprofit, 4-year or above",2,17,16,164259,129534,293793,164259,125103,289362,Basketball
23856,2016,165334,Clark University,Worcester,MA,1610,7,NCAA Division III without football,862,1357,2219,2,"Private nonprofit, 4-year or above",2,15,15,213460,160971,374431,213460,153571,367031,Basketball
41364,2017,165334,Clark University,Worcester,MA,1610,7,NCAA Division III without football,844,1343,2187,2,"Private nonprofit, 4-year or above",2,14,15,165973,155377,321350,165973,155377,321350,Basketball
59063,2018,165334,Clark University,Worcester,MA,1610,7,NCAA Division III without football,868,1366,2234,2,"Private nonprofit, 4-year or above",2,18,13,173114,174828,347942,173114,174828,347942,Basketball
93233,2019,165334,Clark University,Worcester,MA,1610,7,NCAA Division III without football,884,1379,2263,2,"Private nonprofit, 4-year or above",2,16,12,179360,154528,333888,179360,154528,333888,Basketball
30013,2016,211024,Clarks Summit University,South Abington Township,PA,18411,7,NCAA Division III without football,178,176,354,2,"Private nonprofit, 4-year or above",2,13,10,37285,20897,58182,37785,20397,58182,Basketball
47509,2017,211024,Clarks Summit University,South Abington Township,PA,18411,7,NCAA Division III without football,179,172,351,2,"Private nonprofit, 4-year or above",2,16,10,40673,28288,68961,40673,28288,68961,Basketball
65260,2018,211024,Clarks Summit University,South Abington Township,PA,18411,7,NCAA Division III without football,151,178,329,2,"Private nonprofit, 4-year or above",2,11,10,24585,27106,51691,24585,27106,51691,Basketball
114323,2019,211024,Clarks Summit University,South Abington Township,PA,18411,7,NCAA Division III without football,165,152,317,2,"Private nonprofit, 4-year or above",2,22,15,57246,37385,94631,57246,37385,94631,Basketball
9462,2015,190044,Clarkson University,Potsdam,NY,13699,7,NCAA Division III without football,2213,934,3147,2,"Private nonprofit, 4-year or above",2,14,11,143818,144296,288114,143817,138965,282782,Basketball
26880,2016,190044,Clarkson University,Potsdam,NY,13699,7,NCAA Division III without football,2229,935,3164,2,"Private nonprofit, 4-year or above",2,17,12,165698,163708,329406,165698,161567,327265,Basketball
44369,2017,190044,Clarkson University,Potsdam,NY,13699,7,NCAA Division III without football,2085,894,2979,2,"Private nonprofit, 4-year or above",2,15,13,159667,144158,303825,156712,142737,299449,Basketball
62095,2018,190044,Clarkson University,Potsdam,NY,13699,7,NCAA Division III without football,2053,920,2973,2,"Private nonprofit, 4-year or above",2,13,12,175008,146987,321995,174415,143022,317437,Basketball
103714,2019,190044,Clarkson University,Potsdam,NY,13699,7,NCAA Division III without football,2059,906,2965,2,"Private nonprofit, 4-year or above",2,15,12,181794,147235,329029,177082,147235,324317,Basketball
3215,2015,139311,Clayton  State University,Morrow,GA,302600285,5,NCAA Division II without football,1118,2375,3493,1,"Public, 4-year or above",2,14,15,483616,507336,990952,441158,452838,893996,Basketball
20582,2016,139311,Clayton  State University,Morrow,GA,30260,5,NCAA Division II without football,1073,2383,3456,1,"Public, 4-year or above",2,16,14,427505,423525,851030,446001,436688,882689,Basketball
38043,2017,139311,Clayton  State University,Morrow,GA,30260,5,NCAA Division II without football,1112,2394,3506,1,"Public, 4-year or above",2,13,15,430357,372101,802458,448290,367970,816260,Basketball
55696,2018,139311,Clayton  State University,Morrow,GA,30260,5,NCAA Division II without football,1052,2509,3561,1,"Public, 4-year or above",2,14,16,463259,472761,936020,458481,432454,890935,Basketball
81935,2019,139311,Clayton  State University,Morrow,GA,30260,5,NCAA Division II without football,1069,2490,3559,1,"Public, 4-year or above",2,13,15,564181,409277,973458,444180,387335,831515,Basketball
13963,2015,217882,Clemson University,Clemson,SC,29634,1,NCAA Division I-FBS,9025,8150,17175,1,"Public, 4-year or above",2,15,15,8967700,912661,9880361,6403541,3299002,9702543,Basketball
31419,2016,217882,Clemson University,Clemson,SC,29634,1,NCAA Division I-FBS,9292,8557,17849,1,"Public, 4-year or above",2,15,14,11103355,1408594,12511949,6329356,3848701,10178057,Basketball
48932,2017,217882,Clemson University,Clemson,SC,29634,1,NCAA Division I-FBS,9521,9074,18595,1,"Public, 4-year or above",2,14,18,11280040,1503539,12783579,7737387,4377678,12115065,Basketball
66689,2018,217882,Clemson University,Clemson,SC,29634,1,NCAA Division I-FBS,9613,9332,18945,1,"Public, 4-year or above",2,15,14,9224524,1429390,10653914,8229736,4459018,12688754,Basketball
118594,2019,217882,Clemson University,Clemson,SC,29634,1,NCAA Division I-FBS,9722,9719,19441,1,"Public, 4-year or above",2,16,16,9308562,1601450,10910012,7937279,4844264,12781543,Basketball
11520,2015,202134,Cleveland State University,Cleveland,OH,441152214,3,NCAA Division I without football,4333,4713,9046,1,"Public, 4-year or above",2,17,13,2172463,1335597,3508060,2172463,1335597,3508060,Basketball
28957,2016,202134,Cleveland State University,Cleveland,OH,44115,3,NCAA Division I without football,4364,4784,9148,1,"Public, 4-year or above",2,17,13,2503813,1130116,3633929,2503813,1130116,3633929,Basketball
46457,2017,202134,Cleveland State University,Cleveland,OH,44115,3,NCAA Division I without football,4332,4849,9181,1,"Public, 4-year or above",2,14,13,2073834,1301961,3375795,2073834,1301961,3375795,Basketball
64180,2018,202134,Cleveland State University,Cleveland,OH,44115,3,NCAA Division I without football,4433,4837,9270,1,"Public, 4-year or above",2,16,13,2122220,1352167,3474387,2140282,1304541,3444823,Basketball
110463,2019,202134,Cleveland State University,Cleveland,OH,44115,3,NCAA Division I without football,4247,4791,9038,1,"Public, 4-year or above",2,16,13,2190896,1358812,3549708,2307169,1394655,3701824,Basketball
14122,2015,218724,Coastal Carolina University,Conway,SC,29526,2,NCAA Division I-FCS,4102,4628,8730,1,"Public, 4-year or above",2,13,22,1882982,1353279,3236261,1882982,1353279,3236261,Basketball
66858,2018,218724,Coastal Carolina University,Conway,SC,29526,1,NCAA Division I-FBS,4121,4793,8914,1,"Public, 4-year or above",2,15,26,2243214,1714312,3957526,2243214,1714312,3957526,Basketball
119288,2019,218724,Coastal Carolina University,Conway,SC,29528,1,NCAA Division I-FBS,3944,4840,8784,1,"Public, 4-year or above",2,15,23,2165693,1841917,4007610,2165693,1841917,4007610,Basketball
4728,2015,153144,Coe College,Cedar Rapids,IA,524025092,6,NCAA Division III with football,549,771,1320,2,"Private nonprofit, 4-year or above",2,21,13,139350,132677,272027,129918,121395,251313,Basketball
22090,2016,153144,Coe College,Cedar Rapids,IA,52402,6,NCAA Division III with football,552,753,1305,2,"Private nonprofit, 4-year or above",2,21,17,196091,165048,361139,190986,166513,357499,Basketball
39563,2017,153144,Coe College,Cedar Rapids,IA,52402,6,NCAA Division III with football,582,761,1343,2,"Private nonprofit, 4-year or above",2,19,19,172041,138383,310424,172041,138383,310424,Basketball
57226,2018,153144,Coe College,Cedar Rapids,IA,52402,6,NCAA Division III with football,598,761,1359,2,"Private nonprofit, 4-year or above",2,26,15,213180,160088,373268,213180,160088,373268,Basketball
87351,2019,153144,Coe College,Cedar Rapids,IA,52402,6,NCAA Division III with football,620,750,1370,2,"Private nonprofit, 4-year or above",2,27,22,180921,144116,325037,180921,144116,325037,Basketball
13974,2015,217907,Coker College,Hartsville,SC,29550,5,NCAA Division II without football,414,543,957,2,"Private nonprofit, 4-year or above",2,27,15,446392,351781,798173,446392,351781,798173,Basketball
31430,2016,217907,Coker College,Hartsville,SC,29550,5,NCAA Division II without football,417,536,953,2,"Private nonprofit, 4-year or above",2,27,16,406770,361543,768313,405399,361543,766942,Basketball
48942,2017,217907,Coker College,Hartsville,SC,29550,5,NCAA Division II without football,381,528,909,2,"Private nonprofit, 4-year or above",2,28,17,439800,421892,861692,439493,419018,858511,Basketball
66699,2018,217907,Coker College,Hartsville,SC,29550,5,NCAA Division II without football,416,532,948,2,"Private nonprofit, 4-year or above",2,26,19,493974,450676,944650,493974,450479,944453,Basketball
118605,2019,217907,Coker University,Hartsville,SC,29550,5,NCAA Division II without football,380,540,920,2,"Private nonprofit, 4-year or above",2,20,18,550984,432988,983972,542224,432198,974422,Basketball
5925,2015,161086,Colby College,Waterville,ME,49018840,6,NCAA Division III with football,887,970,1857,2,"Private nonprofit, 4-year or above",2,19,14,200700,145447,346147,200700,145447,346147,Basketball
23312,2016,161086,Colby College,Waterville,ME,4901,6,NCAA Division III with football,894,985,1879,2,"Private nonprofit, 4-year or above",2,17,13,195106,168623,363729,195106,168623,363729,Basketball
40811,2017,161086,Colby College,Waterville,ME,4901,6,NCAA Division III with football,917,1000,1917,2,"Private nonprofit, 4-year or above",2,16,11,231331,185218,416549,231331,185218,416549,Basketball
58496,2018,161086,Colby College,Waterville,ME,4901,6,NCAA Division III with football,951,1049,2000,2,"Private nonprofit, 4-year or above",2,13,12,255738,213751,469489,255738,213751,469489,Basketball
91409,2019,161086,Colby College,Waterville,ME,4901,6,NCAA Division III with football,928,1075,2003,2,"Private nonprofit, 4-year or above",2,15,10,311347,228612,539959,311347,228612,539959,Basketball
8754,2015,182634,Colby-Sawyer College,New London,NH,32577835,7,NCAA Division III without football,360,796,1156,2,"Private nonprofit, 4-year or above",2,14,16,136073,130393,266466,136073,130393,266466,Basketball
26191,2016,182634,Colby-Sawyer College,New London,NH,3257,7,NCAA Division III without football,308,705,1013,2,"Private nonprofit, 4-year or above",2,14,19,127550,126937,254487,127550,126937,254487,Basketball
43687,2017,182634,Colby-Sawyer College,New London,NH,3257,7,NCAA Division III without football,281,637,918,2,"Private nonprofit, 4-year or above",2,17,16,126243,129760,256003,126243,129760,256003,Basketball
61406,2018,182634,Colby-Sawyer College,New London,NH,3257,7,NCAA Division III without football,257,564,821,2,"Private nonprofit, 4-year or above",2,15,13,119505,114478,233983,119505,114478,233983,Basketball
101278,2019,182634,Colby-Sawyer College,New London,NH,3257,7,NCAA Division III without football,234,569,803,2,"Private nonprofit, 4-year or above",2,16,16,120402,93958,214360,120402,93958,214360,Basketball
9476,2015,190099,Colgate University,Hamilton,NY,133461398,2,NCAA Division I-FCS,1263,1571,2834,2,"Private nonprofit, 4-year or above",2,15,13,1821178,1545680,3366858,1821178,1545680,3366858,Basketball
26894,2016,190099,Colgate University,Hamilton,NY,13346,2,NCAA Division I-FCS,1285,1579,2864,2,"Private nonprofit, 4-year or above",2,18,14,1852481,1658607,3511088,1852481,1658607,3511088,Basketball
44382,2017,190099,Colgate University,Hamilton,NY,13346,2,NCAA Division I-FCS,1289,1561,2850,2,"Private nonprofit, 4-year or above",2,16,13,1912443,1665628,3578071,1912443,1665628,3578071,Basketball
62108,2018,190099,Colgate University,Hamilton,NY,13346,2,NCAA Division I-FCS,1311,1620,2931,2,"Private nonprofit, 4-year or above",2,14,14,2126456,1706951,3833407,2126456,1706951,3833407,Basketball
103789,2019,190099,Colgate University,Hamilton,NY,13346,2,NCAA Division I-FCS,1322,1638,2960,2,"Private nonprofit, 4-year or above",2,15,15,2345181,1813900,4159081,2345181,1813900,4159081,Basketball
13934,2015,217819,College of Charleston,Charleston,SC,294240001,3,NCAA Division I without football,3412,6082,9494,1,"Public, 4-year or above",2,15,21,2180876,1560534,3741410,2180876,1560534,3741410,Basketball
31390,2016,217819,College of Charleston,Charleston,SC,29424,3,NCAA Division I without football,3383,6087,9470,1,"Public, 4-year or above",2,15,14,2422777,1592601,4015378,2422777,1592601,4015378,Basketball
48903,2017,217819,College of Charleston,Charleston,SC,29424,3,NCAA Division I without football,3226,5797,9023,1,"Public, 4-year or above",2,16,14,3079689,1642894,4722583,3079689,1642894,4722583,Basketball
66660,2018,217819,College of Charleston,Charleston,SC,29424,3,NCAA Division I without football,3131,5915,9046,1,"Public, 4-year or above",2,16,15,3289426,1666105,4955531,3289426,1666105,4955531,Basketball
118483,2019,217819,College of Charleston,Charleston,SC,29424,3,NCAA Division I without football,2988,5725,8713,1,"Public, 4-year or above",2,15,17,3054858,1783626,4838484,3054858,1783626,4838484,Basketball
10044,2015,193399,College of Mount Saint Vincent,Bronx,NY,104711093,7,NCAA Division III without football,472,1033,1505,2,"Private nonprofit, 4-year or above",2,18,17,70003,44589,114592,55818,45448,101266,Basketball
27463,2016,193399,College of Mount Saint Vincent,Bronx,NY,10471,7,NCAA Division III without football,482,1101,1583,2,"Private nonprofit, 4-year or above",2,19,17,84258,47213,131471,70182,43101,113283,Basketball
44951,2017,193399,College of Mount Saint Vincent,Bronx,NY,10471,7,NCAA Division III without football,505,1106,1611,2,"Private nonprofit, 4-year or above",2,19,12,58395,52045,110440,55056,51498,106554,Basketball
62664,2018,193399,College of Mount Saint Vincent,Bronx,NY,10471,7,NCAA Division III without football,461,1101,1562,2,"Private nonprofit, 4-year or above",2,21,12,71538,44697,116235,70915,43350,114265,Basketball
105435,2019,193399,College of Mount Saint Vincent,Bronx,NY,10471,7,NCAA Division III without football,501,1283,1784,2,"Private nonprofit, 4-year or above",2,21,12,81465,53062,134527,97794,77635,175429,Basketball
6776,2015,167394,College of Our Lady of the Elms,Chicopee,MA,1013,7,NCAA Division III without football,247,719,966,2,"Private nonprofit, 4-year or above",2,12,13,52342,81709,134051,52046,58461,110507,Basketball
24165,2016,167394,College of Our Lady of the Elms,Chicopee,MA,1013,7,NCAA Division III without football,246,707,953,2,"Private nonprofit, 4-year or above",2,15,14,49307,56585,105892,49307,56585,105892,Basketball
41666,2017,167394,College of Our Lady of the Elms,Chicopee,MA,1013,7,NCAA Division III without football,256,715,971,2,"Private nonprofit, 4-year or above",2,18,14,49237,44601,93838,49237,44601,93838,Basketball
59356,2018,167394,College of Our Lady of the Elms,Chicopee,MA,1013,7,NCAA Division III without football,247,753,1000,2,"Private nonprofit, 4-year or above",2,18,18,64140,50917,115057,64140,50917,115057,Basketball
94142,2019,167394,College of Our Lady of the Elms,Chicopee,MA,1013,7,NCAA Division III without football,242,754,996,2,"Private nonprofit, 4-year or above",2,18,18,54896,59162,114058,54896,59162,114058,Basketball
9218,2015,186618,College of Saint Elizabeth,Morristown,NJ,79606989,7,NCAA Division III without football,13,518,531,2,"Private nonprofit, 4-year or above",2,0,12,NA,119081,119081,NA,119081,119081,Basketball
26640,2016,186618,College of Saint Elizabeth,Morristown,NJ,7960,7,NCAA Division III without football,92,478,570,2,"Private nonprofit, 4-year or above",2,16,12,92713,83441,176154,92713,83441,176154,Basketball
44135,2017,186618,College of Saint Elizabeth,Morristown,NJ,7960,7,NCAA Division III without football,137,449,586,2,"Private nonprofit, 4-year or above",2,22,10,111389,92824,204213,111389,92824,204213,Basketball
61855,2018,186618,College of Saint Elizabeth,Morristown,NJ,7960,7,NCAA Division III without football,155,449,604,2,"Private nonprofit, 4-year or above",2,18,11,58258,57141,115399,58258,57141,115399,Basketball
102722,2019,186618,College of Saint Elizabeth,Morristown,NJ,7960,7,NCAA Division III without football,218,409,627,2,"Private nonprofit, 4-year or above",2,18,14,63908,57552,121460,63908,57552,121460,Basketball
9573,2015,190558,College of Staten Island CUNY,Staten Island,NY,10314,7,NCAA Division III without football,4326,5360,9686,1,"Public, 4-year or above",2,16,12,68766,72580,141346,68766,72580,141346,Basketball
26989,2016,190558,College of Staten Island CUNY,Staten Island,NY,10314,7,NCAA Division III without football,4282,5286,9568,1,"Public, 4-year or above",2,15,11,80635,63751,144386,80635,63751,144386,Basketball
44477,2017,190558,College of Staten Island CUNY,Staten Island,NY,10314,7,NCAA Division III without football,4491,5205,9696,1,"Public, 4-year or above",2,12,15,70920,61736,132656,70920,61736,132656,Basketball
62205,2018,190558,College of Staten Island CUNY,Staten Island,NY,10314,7,NCAA Division III without football,4477,5067,9544,1,"Public, 4-year or above",2,13,14,114915,94084,208999,114915,94084,208999,Basketball
104076,2019,190558,College of Staten Island CUNY,Staten island,NY,10314,5,NCAA Division II without football,4226,4885,9111,1,"Public, 4-year or above",2,13,12,145739,114369,260108,135739,112869,248608,Basketball
6598,2015,166124,College of the Holy Cross,Worcester,MA,16102395,2,NCAA Division I-FCS,1362,1336,2698,2,"Private nonprofit, 4-year or above",2,17,12,2403572,1616025,4019597,2403572,1616025,4019597,Basketball
23985,2016,166124,College of the Holy Cross,Worcester,MA,1610,2,NCAA Division I-FCS,1321,1368,2689,2,"Private nonprofit, 4-year or above",2,16,14,2117804,1724617,3842421,2117804,1724617,3842421,Basketball
41497,2017,166124,College of the Holy Cross,Worcester,MA,1610,2,NCAA Division I-FCS,1385,1442,2827,2,"Private nonprofit, 4-year or above",2,14,15,2170470,1765123,3935593,2170470,1765123,3935593,Basketball
59196,2018,166124,College of the Holy Cross,Worcester,MA,1610,2,NCAA Division I-FCS,1415,1498,2913,2,"Private nonprofit, 4-year or above",2,16,14,2282921,1922115,4205036,2282921,1922115,4205036,Basketball
93703,2019,166124,College of the Holy Cross,Worcester,MA,1610,2,NCAA Division I-FCS,1403,1528,2931,2,"Private nonprofit, 4-year or above",2,15,13,2333917,1807207,4141124,2333917,1807207,4141124,Basketball
15597,2015,231624,College of William and Mary,Williamsburg,VA,231878795,2,NCAA Division I-FCS,2697,3517,6214,1,"Public, 4-year or above",2,13,15,1939344,1498624,3437968,1939344,1498624,3437968,Basketball
33066,2016,231624,College of William and Mary,Williamsburg,VA,23187,2,NCAA Division I-FCS,2630,3576,6206,1,"Public, 4-year or above",2,14,14,2071156,1537529,3608685,2071156,1537529,3608685,Basketball
50604,2017,231624,College of William and Mary,Williamsburg,VA,23187,2,NCAA Division I-FCS,2615,3577,6192,1,"Public, 4-year or above",2,13,15,2079439,1671691,3751130,2079439,1671691,3751130,Basketball
68349,2018,231624,College of William and Mary,Williamsburg,VA,23187,2,NCAA Division I-FCS,2662,3635,6297,1,"Public, 4-year or above",2,16,14,3970949,1816962,5787911,3970949,1816962,5787911,Basketball
2174,2015,126669,Colorado Christian University,Lakewood,CO,80226,5,NCAA Division II without football,594,991,1585,2,"Private nonprofit, 4-year or above",2,17,17,372004,423331,795335,372004,423331,795335,Basketball
19544,2016,126669,Colorado Christian University,Lakewood,CO,80226,5,NCAA Division II without football,640,1094,1734,2,"Private nonprofit, 4-year or above",2,14,12,400417,392991,793408,400417,392991,793408,Basketball
36982,2017,126669,Colorado Christian University,Lakewood,CO,80226,5,NCAA Division II without football,648,1083,1731,2,"Private nonprofit, 4-year or above",2,14,19,378169,397160,775329,378169,397160,775329,Basketball
54619,2018,126669,Colorado Christian University,Lakewood,CO,80226,5,NCAA Division II without football,626,1084,1710,2,"Private nonprofit, 4-year or above",2,14,14,488450,446541,934991,488450,446541,934991,Basketball
78196,2019,126669,Colorado Christian University,Lakewood,CO,80226,5,NCAA Division II without football,602,1029,1631,2,"Private nonprofit, 4-year or above",2,14,14,472583,449423,922006,472583,449423,922006,Basketball
2182,2015,126678,Colorado College,Colorado Springs,CO,80903,7,NCAA Division III without football,974,1122,2096,2,"Private nonprofit, 4-year or above",2,17,16,172861,228058,400919,167772,228058,395830,Basketball
19551,2016,126678,Colorado College,Colorado Springs,CO,80903,7,NCAA Division III without football,957,1127,2084,2,"Private nonprofit, 4-year or above",2,14,17,172620,213113,385733,163357,222593,385950,Basketball
36989,2017,126678,Colorado College,Colorado Springs,CO,80903,7,NCAA Division III without football,971,1120,2091,2,"Private nonprofit, 4-year or above",2,12,13,190345,218082,408427,190345,218082,408427,Basketball
54625,2018,126678,Colorado College,Colorado Springs,CO,80903,7,NCAA Division III without football,935,1163,2098,2,"Private nonprofit, 4-year or above",2,17,14,169241,228122,397363,165945,228122,394067,Basketball
78233,2019,126678,Colorado College,Colorado Springs,CO,80903,7,NCAA Division III without football,949,1140,2089,2,"Private nonprofit, 4-year or above",2,17,15,174979,219934,394913,168829,219934,388763,Basketball
2245,2015,127556,Colorado Mesa University,Grand Junction,CO,815013122,4,NCAA Division II with football,3503,3679,7182,1,"Public, 4-year or above",2,17,16,455581,443438,899019,455581,443438,899019,Basketball
19614,2016,127556,Colorado Mesa University,Grand Junction,CO,81501,4,NCAA Division II with football,3447,3805,7252,1,"Public, 4-year or above",2,14,20,436608,420927,857535,436517,420927,857444,Basketball
37052,2017,127556,Colorado Mesa University,Grand Junction,CO,81501,4,NCAA Division II with football,3397,3724,7121,1,"Public, 4-year or above",2,17,17,501623,493407,995030,500892,491944,992836,Basketball
54688,2018,127556,Colorado Mesa University,Grand Junction,CO,81501,4,NCAA Division II with football,3325,3713,7038,1,"Public, 4-year or above",2,18,17,459574,492204,951778,459574,490152,949726,Basketball
78535,2019,127556,Colorado Mesa University,Grand Junction,CO,81501,4,NCAA Division II with football,3205,3727,6932,1,"Public, 4-year or above",2,21,15,498312,530894,1029206,498312,530894,1029206,Basketball
2200,2015,126775,Colorado School of Mines,Golden,CO,80401,4,NCAA Division II with football,3112,1223,4335,1,"Public, 4-year or above",2,18,15,717978,385051,1103029,717978,385051,1103029,Basketball
19569,2016,126775,Colorado School of Mines,Golden,CO,80401,4,NCAA Division II with football,3117,1242,4359,1,"Public, 4-year or above",2,20,15,759723,491274,1250997,759723,491274,1250997,Basketball
37007,2017,126775,Colorado School of Mines,Golden,CO,80401,4,NCAA Division II with football,3203,1351,4554,1,"Public, 4-year or above",2,18,19,757416,552000,1309416,757416,552000,1309416,Basketball
54643,2018,126775,Colorado School of Mines,Golden,CO,80401,4,NCAA Division II with football,3257,1413,4670,1,"Public, 4-year or above",2,18,16,766037,559048,1325085,766037,559048,1325085,Basketball
78347,2019,126775,Colorado School of Mines,Golden,CO,80401,4,NCAA Division II with football,3351,1533,4884,1,"Public, 4-year or above",2,18,13,891405,576815,1468220,798842,572717,1371559,Basketball
2209,2015,126818,Colorado State University-Fort Collins,Fort Collins,CO,805230100,1,NCAA Division I-FBS,9859,10597,20456,1,"Public, 4-year or above",2,13,15,4264867,2472939,6737806,4264867,2472939,6737806,Basketball
19578,2016,126818,Colorado State University-Fort Collins,Fort Collins,CO,80523,1,NCAA Division I-FBS,10260,10951,21211,1,"Public, 4-year or above",2,17,14,4512525,2585240,7097765,4512525,2585240,7097765,Basketball
37016,2017,126818,Colorado State University-Fort Collins,Fort Collins,CO,80523,1,NCAA Division I-FBS,10253,11149,21402,1,"Public, 4-year or above",2,14,15,6334144,2654710,8988854,6334144,2654710,8988854,Basketball
54654,2018,126818,Colorado State University-Fort Collins,Fort Collins,CO,80523,1,NCAA Division I-FBS,10540,11281,21821,1,"Public, 4-year or above",2,15,15,4415218,2714026,7129244,4415218,2714026,7129244,Basketball
78385,2019,126818,Colorado State University-Fort Collins,Fort Collins,CO,80523,1,NCAA Division I-FBS,10315,11615,21930,1,"Public, 4-year or above",2,14,16,4328160,2892012,7220172,4328160,2892012,7220172,Basketball
2299,2015,128106,Colorado State University-Pueblo,Pueblo,CO,810014901,4,NCAA Division II with football,1660,1702,3362,1,"Public, 4-year or above",2,17,17,463828,468447,932275,463828,468447,932275,Basketball
19670,2016,128106,Colorado State University-Pueblo,Pueblo,CO,81001,4,NCAA Division II with football,1660,1731,3391,1,"Public, 4-year or above",2,15,16,395275,405264,800539,409287,468254,877541,Basketball
37109,2017,128106,Colorado State University-Pueblo,Pueblo,CO,81001,4,NCAA Division II with football,1605,1640,3245,1,"Public, 4-year or above",2,18,14,410031,475273,885304,410031,475273,885304,Basketball
54745,2018,128106,Colorado State University-Pueblo,Pueblo,CO,81001,4,NCAA Division II with football,1502,1578,3080,1,"Public, 4-year or above",2,18,14,447132,476957,924089,447132,476957,924089,Basketball
78709,2019,128106,Colorado State University-Pueblo,Pueblo,CO,81001,4,NCAA Division II with football,1394,1515,2909,1,"Public, 4-year or above",2,13,14,511111,452852,963963,575219,490621,1065840,Basketball
9490,2015,190150,Columbia University in the City of New York,New York,NY,10027,2,NCAA Division I-FCS,3990,3533,7523,2,"Private nonprofit, 4-year or above",2,18,17,1494045,1156090,2650135,1494045,1156090,2650135,Basketball
26908,2016,190150,Columbia University in the City of New York,New York,NY,10027,2,NCAA Division I-FCS,4044,3508,7552,2,"Private nonprofit, 4-year or above",2,18,16,1642204,895832,2538036,1642204,895832,2538036,Basketball
44396,2017,190150,Columbia University in the City of New York,New York,NY,10027,2,NCAA Division I-FCS,4093,3499,7592,2,"Private nonprofit, 4-year or above",2,18,13,1405538,934966,2340504,1405538,934966,2340504,Basketball
62122,2018,190150,Columbia University in the City of New York,New York,NY,10027,2,NCAA Division I-FCS,4085,3581,7666,2,"Private nonprofit, 4-year or above",2,16,15,1445658,977713,2423371,1445658,977713,2423371,Basketball
103803,2019,190150,Columbia University in the City of New York,New York,NY,10027,2,NCAA Division I-FCS,4015,3686,7701,2,"Private nonprofit, 4-year or above",2,16,14,1450965,1059756,2510721,1450965,1059756,2510721,Basketball
103841,2019,190169,Columbia-Greene Community College,Hudson,NY,12534,7,NCAA Division III without football,235,292,527,4,"Public, 2-year",2,14,0,33403,NA,33403,33403,NA,33403,Basketball
3221,2015,139366,Columbus State University,Columbus,GA,319075645,5,NCAA Division II without football,1906,2968,4874,1,"Public, 4-year or above",2,18,14,420911,349187,770098,420911,349187,770098,Basketball
20588,2016,139366,Columbus State University,Columbus,GA,31907,5,NCAA Division II without football,1893,2860,4753,1,"Public, 4-year or above",2,20,25,406942,375847,782789,406942,375847,782789,Basketball
38048,2017,139366,Columbus State University,Columbus,GA,31907,5,NCAA Division II without football,1859,2747,4606,1,"Public, 4-year or above",2,23,19,344338,373147,717485,344338,373147,717485,Basketball
55701,2018,139366,Columbus State University,Columbus,GA,31907,5,NCAA Division II without football,1822,2712,4534,1,"Public, 4-year or above",2,24,19,396554,326756,723310,396554,326756,723310,Basketball
81970,2019,139366,Columbus State University,Columbus,GA,31907,5,NCAA Division II without football,1737,2699,4436,1,"Public, 4-year or above",2,23,19,445928,361881,807809,445928,361881,807809,Basketball
16283,2015,237330,Concord University,Athens,WV,24712,4,NCAA Division II with football,852,1091,1943,1,"Public, 4-year or above",2,18,17,339149,343112,682261,339149,343112,682261,Basketball
33756,2016,237330,Concord University,Athens,WV,247121000,4,NCAA Division II with football,780,1088,1868,1,"Public, 4-year or above",2,17,18,351548,399149,750697,351548,399149,750697,Basketball
51307,2017,237330,Concord University,Athens,WV,24712,4,NCAA Division II with football,708,984,1692,1,"Public, 4-year or above",2,19,19,317664,348509,666173,317664,348509,666173,Basketball
69057,2018,237330,Concord University,Athens,WV,24712,4,NCAA Division II with football,648,927,1575,1,"Public, 4-year or above",2,16,15,363899,371253,735152,363899,371253,735152,Basketball
128030,2019,237330,Concord University,Athens,WV,24712,4,NCAA Division II with football,594,824,1418,1,"Public, 4-year or above",2,18,17,354356,391278,745634,354353,394173,748526,Basketball
7537,2015,173300,Concordia College at Moorhead,Moorhead,MN,56562,6,NCAA Division III with football,854,1238,2092,2,"Private nonprofit, 4-year or above",2,26,19,241973,170336,412309,241973,170336,412309,Basketball
24949,2016,173300,Concordia College at Moorhead,Moorhead,MN,56562,6,NCAA Division III with football,852,1169,2021,2,"Private nonprofit, 4-year or above",2,26,16,192548,141940,334488,192548,141940,334488,Basketball
42446,2017,173300,Concordia College at Moorhead,Moorhead,MN,56562,6,NCAA Division III with football,834,1138,1972,2,"Private nonprofit, 4-year or above",2,25,23,134496,141220,275716,134496,141220,275716,Basketball
60150,2018,173300,Concordia College at Moorhead,Moorhead,MN,56562,6,NCAA Division III with football,845,1156,2001,2,"Private nonprofit, 4-year or above",2,22,24,139633,141114,280747,139633,141114,280747,Basketball
96607,2019,173300,Concordia College at Moorhead,Moorhead,MN,56562,6,NCAA Division III with football,827,1096,1923,2,"Private nonprofit, 4-year or above",2,27,20,147934,129044,276978,147934,129044,276978,Basketball
9515,2015,190248,Concordia College-New York,Bronxville,NY,107081998,5,NCAA Division II without football,293,516,809,2,"Private nonprofit, 4-year or above",2,18,16,269077,194177,463254,269077,194177,463254,Basketball
26932,2016,190248,Concordia College-New York,Bronxville,NY,10708,5,NCAA Division II without football,284,529,813,2,"Private nonprofit, 4-year or above",2,14,14,274421,239551,513972,274421,239551,513972,Basketball
44418,2017,190248,Concordia College-New York,Bronxville,NY,10708,5,NCAA Division II without football,264,755,1019,2,"Private nonprofit, 4-year or above",2,20,15,266512,230618,497130,266512,230618,497130,Basketball
62145,2018,190248,Concordia College-New York,Bronxville,NY,10708,5,NCAA Division II without football,248,861,1109,2,"Private nonprofit, 4-year or above",2,16,13,231066,180152,411218,231066,180152,411218,Basketball
103879,2019,190248,Concordia College-New York,Bronxville,NY,10708,5,NCAA Division II without football,234,888,1122,2,"Private nonprofit, 4-year or above",2,17,16,208516,227691,436207,208516,227691,436207,Basketball
49692,2017,224004,Concordia University Texas,Austin,TX,78726,7,NCAA Division III without football,527,803,1330,2,"Private nonprofit, 4-year or above",2,29,18,228977,139385,368362,228977,139385,368362,Basketball
67464,2018,224004,Concordia University Texas,Austin,TX,78726,7,NCAA Division III without football,489,840,1329,2,"Private nonprofit, 4-year or above",2,34,19,229167,149002,378169,229167,149002,378169,Basketball
121601,2019,224004,Concordia University Texas,Austin,TX,78726,7,NCAA Division III without football,488,948,1436,2,"Private nonprofit, 4-year or above",2,32,18,268162,195480,463642,268162,195480,463642,Basketball
3678,2015,144351,Concordia University-Chicago,River Forest,IL,603051499,6,NCAA Division III with football,557,791,1348,2,"Private nonprofit, 4-year or above",2,20,21,143932,130379,274311,134779,124724,259503,Basketball
21048,2016,144351,Concordia University-Chicago,River Forest,IL,60305,6,NCAA Division III with football,580,775,1355,2,"Private nonprofit, 4-year or above",2,26,22,151927,124182,276109,139565,123381,262946,Basketball
38508,2017,144351,Concordia University-Chicago,River Forest,IL,60305,6,NCAA Division III with football,537,762,1299,2,"Private nonprofit, 4-year or above",2,29,22,157397,133069,290466,146708,132737,279445,Basketball
56164,2018,144351,Concordia University-Chicago,River Forest,IL,60305,6,NCAA Division III with football,568,792,1360,2,"Private nonprofit, 4-year or above",2,24,20,171526,128516,300042,164941,119964,284905,Basketball
83685,2019,144351,Concordia University-Chicago,River Forest,IL,60305,6,NCAA Division III with football,582,789,1371,2,"Private nonprofit, 4-year or above",2,23,23,146943,130171,277114,144844,128588,273432,Basketball
18416,2016,112075,Concordia University-Irvine,Irvine,CA,92612,5,NCAA Division II without football,651,1121,1772,2,"Private nonprofit, 4-year or above",2,15,17,773213,562900,1336113,773213,562900,1336113,Basketball
35850,2017,112075,Concordia University-Irvine,Irvine,CA,92612,5,NCAA Division II without football,622,1019,1641,2,"Private nonprofit, 4-year or above",2,15,17,735507,689823,1425330,735507,689823,1425330,Basketball
53473,2018,112075,Concordia University-Irvine,Irvine,CA,92612,5,NCAA Division II without football,622,1037,1659,2,"Private nonprofit, 4-year or above",2,17,13,798189,561056,1359245,798189,561056,1359245,Basketball
74321,2019,112075,Concordia University-Irvine,Irvine,CA,92612,5,NCAA Division II without football,633,957,1590,2,"Private nonprofit, 4-year or above",2,15,16,759366,589286,1348652,759366,589286,1348652,Basketball
12296,2015,208488,Concordia University-Portland,Portland,OR,972116099,5,NCAA Division II without football,357,656,1013,2,"Private nonprofit, 4-year or above",2,23,19,409878,458039,867917,409878,458039,867917,Basketball
29740,2016,208488,Concordia University-Portland,Portland,OR,97211,5,NCAA Division II without football,340,677,1017,2,"Private nonprofit, 4-year or above",2,16,13,476190,514415,990605,476190,514415,990605,Basketball
47236,2017,208488,Concordia University-Portland,Portland,OR,97211,5,NCAA Division II without football,348,774,1122,2,"Private nonprofit, 4-year or above",2,15,14,551207,580792,1131999,516333,548926,1065259,Basketball
64980,2018,208488,Concordia University-Portland,Portland,OR,97211,5,NCAA Division II without football,353,875,1228,2,"Private nonprofit, 4-year or above",2,17,15,584338,592441,1176779,583676,574096,1157772,Basketball
7551,2015,173328,Concordia University-Saint Paul,Saint Paul,MN,551045494,4,NCAA Division II with football,620,699,1319,2,"Private nonprofit, 4-year or above",2,13,14,417179,495675,912854,417179,495675,912854,Basketball
24963,2016,173328,Concordia University-Saint Paul,Saint Paul,MN,55104,4,NCAA Division II with football,607,727,1334,2,"Private nonprofit, 4-year or above",2,14,14,492865,564447,1057312,492865,564447,1057312,Basketball
42460,2017,173328,Concordia University-Saint Paul,Saint Paul,MN,55104,4,NCAA Division II with football,617,727,1344,2,"Private nonprofit, 4-year or above",2,11,13,482042,478441,960483,482042,478441,960483,Basketball
60164,2018,173328,Concordia University-Saint Paul,Saint Paul,MN,55104,4,NCAA Division II with football,703,865,1568,2,"Private nonprofit, 4-year or above",2,14,16,508996,511481,1020477,508996,511481,1020477,Basketball
96622,2019,173328,Concordia University-Saint Paul,Saint Paul,MN,55104,4,NCAA Division II with football,677,965,1642,2,"Private nonprofit, 4-year or above",2,15,13,472116,498618,970734,472116,498618,970734,Basketball
14701,2015,224004,Concordia University-Texas,Austin,TX,78726,7,NCAA Division III without football,484,746,1230,2,"Private nonprofit, 4-year or above",2,33,19,194981,106650,301631,194981,106650,301631,Basketball
32171,2016,224004,Concordia University-Texas,Austin,TX,78726,7,NCAA Division III without football,530,761,1291,2,"Private nonprofit, 4-year or above",2,36,14,186323,120635,306958,186323,120635,306958,Basketball
16479,2015,238616,Concordia University-Wisconsin,Mequon,WI,530972402,6,NCAA Division III with football,1133,1871,3004,2,"Private nonprofit, 4-year or above",2,25,22,163269,159860,323129,152465,151637,304102,Basketball
33954,2016,238616,Concordia University-Wisconsin,Mequon,WI,53097,6,NCAA Division III with football,975,1716,2691,2,"Private nonprofit, 4-year or above",2,19,17,182039,179677,361716,172168,170755,342923,Basketball
51510,2017,238616,Concordia University-Wisconsin,Mequon,WI,53097,6,NCAA Division III with football,970,1642,2612,2,"Private nonprofit, 4-year or above",2,20,19,187373,184393,371766,177502,175471,352973,Basketball
69255,2018,238616,Concordia University-Wisconsin,Mequon,WI,53097,6,NCAA Division III with football,909,1484,2393,2,"Private nonprofit, 4-year or above",2,22,12,166364,164418,330782,161326,160973,322299,Basketball
128644,2019,238616,Concordia University-Wisconsin,Mequon,WI,53097,6,NCAA Division III with football,903,1407,2310,2,"Private nonprofit, 4-year or above",2,25,13,167501,166369,333870,164955,163402,328357,Basketball
2349,2015,128902,Connecticut College,New London,CT,63204196,7,NCAA Division III without football,694,1158,1852,2,"Private nonprofit, 4-year or above",2,16,12,170324,117090,287414,170324,117090,287414,Basketball
19721,2016,128902,Connecticut College,New London,CT,6320,7,NCAA Division III without football,673,1145,1818,2,"Private nonprofit, 4-year or above",2,15,15,166536,109138,275674,166536,109138,275674,Basketball
37160,2017,128902,Connecticut College,New London,CT,6320,7,NCAA Division III without football,654,1110,1764,2,"Private nonprofit, 4-year or above",2,17,13,161598,106096,267694,161598,106096,267694,Basketball
54796,2018,128902,Connecticut College,New London,CT,6320,7,NCAA Division III without football,686,1110,1796,2,"Private nonprofit, 4-year or above",2,18,15,145437,140271,285708,145437,140271,285708,Basketball
78858,2019,128902,Connecticut College,New London,CT,6320,7,NCAA Division III without football,689,1128,1817,2,"Private nonprofit, 4-year or above",2,16,15,186947,162398,349345,186947,162398,349345,Basketball
6085,2015,162283,Coppin State University,Baltimore,MD,212163698,3,NCAA Division I without football,551,1452,2003,1,"Public, 4-year or above",2,15,12,738712,716344,1455056,738712,716344,1455056,Basketball
23471,2016,162283,Coppin State University,Baltimore,MD,21216,3,NCAA Division I without football,488,1399,1887,1,"Public, 4-year or above",2,13,12,827058,641171,1468229,827058,641171,1468229,Basketball
40974,2017,162283,Coppin State University,Baltimore,MD,21216,3,NCAA Division I without football,473,1381,1854,1,"Public, 4-year or above",2,15,15,755952,660856,1416808,755952,660856,1416808,Basketball
58665,2018,162283,Coppin State University,Baltimore,MD,21216,3,NCAA Division I without football,421,1344,1765,1,"Public, 4-year or above",2,13,11,785999,675364,1461363,785999,675364,1461363,Basketball
92019,2019,162283,Coppin State University,Baltimore,MD,21216,3,NCAA Division I without football,432,1371,1803,1,"Public, 4-year or above",2,14,11,1186777,699021,1885798,1186777,699021,1885798,Basketball
4741,2015,153162,Cornell College,Mount Vernon,IA,523141098,6,NCAA Division III with football,505,526,1031,2,"Private nonprofit, 4-year or above",2,15,14,176090,224963,401053,176090,224963,401053,Basketball
22103,2016,153162,Cornell College,Mount Vernon,IA,52314,6,NCAA Division III with football,489,484,973,2,"Private nonprofit, 4-year or above",2,20,16,160232,250471,410703,160232,250471,410703,Basketball
39576,2017,153162,Cornell College,Mount Vernon,IA,52314,6,NCAA Division III with football,507,491,998,2,"Private nonprofit, 4-year or above",2,22,21,136701,249973,386674,136701,249973,386674,Basketball
57239,2018,153162,Cornell College,Mount Vernon,IA,52314,6,NCAA Division III with football,527,487,1014,2,"Private nonprofit, 4-year or above",2,20,24,144366,259879,404245,144366,259879,404245,Basketball
87389,2019,153162,Cornell College,Mount Vernon,IA,52314,6,NCAA Division III with football,535,479,1014,2,"Private nonprofit, 4-year or above",2,20,26,146920,270829,417749,146920,270829,417749,Basketball
9523,2015,190415,Cornell University,Ithaca,NY,14853,2,NCAA Division I-FCS,6893,7321,14214,2,"Private nonprofit, 4-year or above",2,19,16,792795,653315,1446110,792795,653315,1446110,Basketball
26939,2016,190415,Cornell University,Ithaca,NY,14853,2,NCAA Division I-FCS,6949,7512,14461,2,"Private nonprofit, 4-year or above",2,19,19,974135,654802,1628937,974135,654802,1628937,Basketball
44426,2017,190415,Cornell University,Ithaca,NY,14853,2,NCAA Division I-FCS,7044,7762,14806,2,"Private nonprofit, 4-year or above",2,16,20,1089065,943984,2033049,1089065,943984,2033049,Basketball
62153,2018,190415,Cornell University,Ithaca,NY,14853,2,NCAA Division I-FCS,7108,7990,15098,2,"Private nonprofit, 4-year or above",2,17,18,1143930,988599,2132529,1143930,988599,2132529,Basketball
103917,2019,190415,Cornell University,Ithaca,NY,14853,2,NCAA Division I-FCS,6910,8061,14971,2,"Private nonprofit, 4-year or above",2,17,21,1100729,987570,2088299,1100729,987570,2088299,Basketball
3232,2015,139393,Covenant College,Lookout Mountain,GA,307504164,7,NCAA Division III without football,423,576,999,2,"Private nonprofit, 4-year or above",2,15,15,135856,124103,259959,129556,124103,253659,Basketball
20598,2016,139393,Covenant College,Lookout Mountain,GA,30750,7,NCAA Division III without football,444,529,973,2,"Private nonprofit, 4-year or above",2,16,16,120609,126520,247129,120609,126520,247129,Basketball
38058,2017,139393,Covenant College,Lookout Mountain,GA,30750,7,NCAA Division III without football,457,525,982,2,"Private nonprofit, 4-year or above",2,17,15,154256,123655,277911,147431,123155,270586,Basketball
55708,2018,139393,Covenant College,Lookout Mountain,GA,30750,7,NCAA Division III without football,468,501,969,2,"Private nonprofit, 4-year or above",2,16,14,151413,117459,268872,146602,116959,263561,Basketball
82008,2019,139393,Covenant College,Lookout Mountain,GA,30750,7,NCAA Division III without football,416,471,887,2,"Private nonprofit, 4-year or above",2,15,11,169792,127254,297046,167292,126254,293546,Basketball
8574,2015,181002,Creighton University,Omaha,NE,68178,3,NCAA Division I without football,1680,2221,3901,2,"Private nonprofit, 4-year or above",2,17,15,7264599,1589143,8853742,7264599,1589143,8853742,Basketball
26008,2016,181002,Creighton University,Omaha,NE,68178,3,NCAA Division I without football,1715,2255,3970,2,"Private nonprofit, 4-year or above",2,16,15,7665992,1788900,9454892,7665992,1788900,9454892,Basketball
43498,2017,181002,Creighton University,Omaha,NE,68178,3,NCAA Division I without football,1767,2238,4005,2,"Private nonprofit, 4-year or above",2,14,14,9017209,1768679,10785888,9017209,1768679,10785888,Basketball
61217,2018,181002,Creighton University,Omaha,NE,68178,3,NCAA Division I without football,1828,2453,4281,2,"Private nonprofit, 4-year or above",2,14,13,8590055,1806785,10396840,8590055,1806785,10396840,Basketball
100617,2019,181002,Creighton University,Omaha,NE,68178,3,NCAA Division I without football,1800,2507,4307,2,"Private nonprofit, 4-year or above",2,15,12,9415829,1778289,11194118,9355753,1778289,11134042,Basketball
7789,2015,174862,Crown College,Saint Bonifacius,MN,553759001,6,NCAA Division III with football,341,371,712,2,"Private nonprofit, 4-year or above",2,28,22,88231,80741,168972,88821,82779,171600,Basketball
25203,2016,174862,Crown College,Saint Bonifacius,MN,55375,6,NCAA Division III with football,340,360,700,2,"Private nonprofit, 4-year or above",2,28,22,101882,126408,228290,85628,114540,200168,Basketball
42701,2017,174862,Crown College,Saint Bonifacius,MN,55375,6,NCAA Division III with football,322,330,652,2,"Private nonprofit, 4-year or above",2,29,19,83656,87122,170778,80624,81741,162365,Basketball
60407,2018,174862,Crown College,Saint Bonifacius,MN,55375,6,NCAA Division III with football,330,343,673,2,"Private nonprofit, 4-year or above",2,29,19,84123,108256,192379,79548,102337,181885,Basketball
97414,2019,174862,Crown College,Saint Bonifacius,MN,55375,6,NCAA Division III with football,259,269,528,2,"Private nonprofit, 4-year or above",2,22,12,90225,81333,171558,81725,81033,162758,Basketball
9550,2015,190512,CUNY Bernard M Baruch College,New York,NY,10010,7,NCAA Division III without football,5761,5414,11175,1,"Public, 4-year or above",2,15,10,103299,40616,143915,103299,40616,143915,Basketball
26966,2016,190512,CUNY Bernard M Baruch College,New York,NY,10010,7,NCAA Division III without football,5787,5451,11238,1,"Public, 4-year or above",2,15,8,89432,39722,129154,89432,39722,129154,Basketball
44453,2017,190512,CUNY Bernard M Baruch College,New York,NY,10010,7,NCAA Division III without football,5997,5544,11541,1,"Public, 4-year or above",2,15,9,95374,45264,140638,95374,45264,140638,Basketball
62181,2018,190512,CUNY Bernard M Baruch College,New York,NY,10010,7,NCAA Division III without football,6007,5435,11442,1,"Public, 4-year or above",2,16,10,102925,43906,146831,102925,43906,146831,Basketball
103993,2019,190512,CUNY Bernard M Baruch College,New York,NY,10010,7,NCAA Division III without football,6463,5569,12032,1,"Public, 4-year or above",2,15,9,103160,50439,153599,103160,50439,153599,Basketball
9565,2015,190549,CUNY Brooklyn College,Brooklyn,NY,11210,7,NCAA Division III without football,4251,5829,10080,1,"Public, 4-year or above",2,16,15,53106,52363,105469,53106,52363,105469,Basketball
26981,2016,190549,CUNY Brooklyn College,Brooklyn,NY,11210,7,NCAA Division III without football,4268,5850,10118,1,"Public, 4-year or above",2,15,15,50990,55248,106238,50990,55248,106238,Basketball
44469,2017,190549,CUNY Brooklyn College,Brooklyn,NY,11210,7,NCAA Division III without football,4626,6042,10668,1,"Public, 4-year or above",2,16,15,43286,55279,98565,43286,55279,98565,Basketball
62197,2018,190549,CUNY Brooklyn College,Brooklyn,NY,11210,7,NCAA Division III without football,4824,6202,11026,1,"Public, 4-year or above",2,15,15,52552,54406,106958,52552,54406,106958,Basketball
104038,2019,190549,CUNY Brooklyn College,Brooklyn,NY,11210,7,NCAA Division III without football,4828,6225,11053,1,"Public, 4-year or above",2,15,14,54387,52417,106804,54387,52417,106804,Basketball
9581,2015,190567,CUNY City College,New York,NY,10031,7,NCAA Division III without football,4767,4869,9636,1,"Public, 4-year or above",2,16,16,90272,88924,179196,88275,89310,177585,Basketball
26997,2016,190567,CUNY City College,New York,NY,10031,7,NCAA Division III without football,4897,5068,9965,1,"Public, 4-year or above",2,17,11,115478,28897,144375,113021,29022,142043,Basketball
44485,2017,190567,CUNY City College,New York,NY,10031,7,NCAA Division III without football,4908,5191,10099,1,"Public, 4-year or above",2,16,10,41525,41325,82850,41637,42736,84373,Basketball
62213,2018,190567,CUNY City College,New York,NY,10031,7,NCAA Division III without football,4792,5341,10133,1,"Public, 4-year or above",2,18,17,42605,47023,89628,42720,48629,91349,Basketball
104087,2019,190567,CUNY City College,New York,NY,10031,7,NCAA Division III without football,4749,5345,10094,1,"Public, 4-year or above",2,13,10,38814,41474,80288,38814,41474,80288,Basketball
9592,2015,190594,CUNY Hunter College,New York,NY,10065,7,NCAA Division III without football,4211,7731,11942,1,"Public, 4-year or above",2,14,14,47225,52947,100172,47225,52947,100172,Basketball
27006,2016,190594,CUNY Hunter College,New York,NY,10065,7,NCAA Division III without football,4341,7823,12164,1,"Public, 4-year or above",2,17,16,55846,65971,121817,55846,65971,121817,Basketball
44493,2017,190594,CUNY Hunter College,New York,NY,10065,7,NCAA Division III without football,4393,8174,12567,1,"Public, 4-year or above",2,16,14,49536,54442,103978,49536,54442,103978,Basketball
62222,2018,190594,CUNY Hunter College,New York,NY,10065,7,NCAA Division III without football,4596,8471,13067,1,"Public, 4-year or above",2,15,12,53018,63219,116237,53018,63219,116237,Basketball
104132,2019,190594,CUNY Hunter College,New York,NY,10065,7,NCAA Division III without football,4603,8345,12948,1,"Public, 4-year or above",2,16,15,60488,69545,130033,60488,69545,130033,Basketball
9602,2015,190600,CUNY John Jay College of Criminal Justice,New York,NY,10019,7,NCAA Division III without football,4352,5774,10126,1,"Public, 4-year or above",2,17,13,60165,36169,96334,60165,36169,96334,Basketball
27016,2016,190600,CUNY John Jay College of Criminal Justice,New York,NY,10019,7,NCAA Division III without football,4138,5690,9828,1,"Public, 4-year or above",2,15,9,60644,36197,96841,60644,36197,96841,Basketball
44503,2017,190600,CUNY John Jay College of Criminal Justice,New York,NY,10019,7,NCAA Division III without football,4331,5941,10272,1,"Public, 4-year or above",2,14,11,67521,35593,103114,67521,35593,103114,Basketball
62232,2018,190600,CUNY John Jay College of Criminal Justice,New York,NY,10019,7,NCAA Division III without football,4275,6461,10736,1,"Public, 4-year or above",2,15,13,70844,38840,109684,70844,38840,109684,Basketball
104143,2019,190600,CUNY John Jay College of Criminal Justice,New York,NY,10019,7,NCAA Division III without football,4491,6702,11193,1,"Public, 4-year or above",2,17,13,59109,42357,101466,59108,42357,101465,Basketball
9620,2015,190637,CUNY Lehman College,Bronx,NY,10468,7,NCAA Division III without football,2070,4156,6226,1,"Public, 4-year or above",2,16,13,54945,66408,121353,54945,66408,121353,Basketball
27034,2016,190637,CUNY Lehman College,Bronx,NY,10468,7,NCAA Division III without football,2203,4372,6575,1,"Public, 4-year or above",2,17,15,66505,78646,145151,66498,78633,145131,Basketball
44521,2017,190637,CUNY Lehman College,Bronx,NY,10468,7,NCAA Division III without football,2416,4771,7187,1,"Public, 4-year or above",2,16,12,66765,77199,143964,66765,77199,143964,Basketball
62250,2018,190637,CUNY Lehman College,Bronx,NY,10468,7,NCAA Division III without football,2598,5182,7780,1,"Public, 4-year or above",2,18,11,64231,76092,140323,64231,76092,140323,Basketball
104218,2019,190637,CUNY Lehman College,Bronx,NY,10468,7,NCAA Division III without football,2694,5355,8049,1,"Public, 4-year or above",2,15,11,64597,73335,137932,64597,73335,137932,Basketball
9627,2015,190646,CUNY Medgar Evers College,Brooklyn,NY,11225,7,NCAA Division III without football,1249,3117,4366,1,"Public, 4-year or above",2,19,11,48757,35132,83889,48757,35132,83889,Basketball
27041,2016,190646,CUNY Medgar Evers College,Brooklyn,NY,11225,7,NCAA Division III without football,1374,3290,4664,1,"Public, 4-year or above",2,16,10,54760,42592,97352,54760,42592,97352,Basketball
44528,2017,190646,CUNY Medgar Evers College,Brooklyn,NY,11225,7,NCAA Division III without football,1389,3352,4741,1,"Public, 4-year or above",2,19,14,53739,46035,99774,53739,46035,99774,Basketball
62257,2018,190646,CUNY Medgar Evers College,Brooklyn,NY,11225,7,NCAA Division III without football,1395,3221,4616,1,"Public, 4-year or above",2,21,12,59930,45071,105001,59930,45071,105001,Basketball
104255,2019,190646,CUNY Medgar Evers College,Brooklyn,NY,11225,7,NCAA Division III without football,1160,2864,4024,1,"Public, 4-year or above",2,18,15,56141,48681,104822,56141,48681,104822,Basketball
9632,2015,190664,CUNY Queens College,Queens,NY,11367,5,NCAA Division II without football,5100,6409,11509,1,"Public, 4-year or above",2,16,14,276197,275815,552012,272657,271015,543672,Basketball
27046,2016,190664,CUNY Queens College,Queens,NY,11367,5,NCAA Division II without football,5249,6405,11654,1,"Public, 4-year or above",2,13,13,260977,268836,529813,230079,266566,496645,Basketball
44533,2017,190664,CUNY Queens College,Queens,NY,11367,5,NCAA Division II without football,5548,6548,12096,1,"Public, 4-year or above",2,15,12,302194,247648,549842,272594,244268,516862,Basketball
62262,2018,190664,CUNY Queens College,Queens,NY,11367,5,NCAA Division II without football,5603,6538,12141,1,"Public, 4-year or above",2,15,12,254550,244868,499418,254550,235944,490494,Basketball
104262,2019,190664,CUNY Queens College,Queens,NY,11367,5,NCAA Division II without football,5787,6702,12489,1,"Public, 4-year or above",2,14,16,251492,260984,512476,240724,259317,500041,Basketball
9652,2015,190691,CUNY York College,Jamaica,NY,11451,7,NCAA Division III without football,1726,3424,5150,1,"Public, 4-year or above",2,13,11,56539,35514,92053,56539,35514,92053,Basketball
27066,2016,190691,CUNY York College,Jamaica,NY,11451,7,NCAA Division III without football,1647,3350,4997,1,"Public, 4-year or above",2,15,14,44488,29497,73985,42698,29497,72195,Basketball
44553,2017,190691,CUNY York College,Jamaica,NY,11451,7,NCAA Division III without football,1700,3276,4976,1,"Public, 4-year or above",2,15,15,47045,40678,87723,46545,40150,86695,Basketball
62280,2018,190691,CUNY York College,Jamaica,NY,11451,7,NCAA Division III without football,1741,3262,5003,1,"Public, 4-year or above",2,13,14,47115,40357,87472,47115,39821,86936,Basketball
104307,2019,190691,CUNY York College,Jamaica,NY,11451,7,NCAA Division III without football,1695,3339,5034,1,"Public, 4-year or above",2,12,15,46605,44752,91357,46605,43327,89932,Basketball
6485,2015,165529,Curry College,Milton,MA,21862395,6,NCAA Division III with football,907,1103,2010,2,"Private nonprofit, 4-year or above",2,16,13,53749,57204,110953,53749,57204,110953,Basketball
23867,2016,165529,Curry College,Milton,MA,2186,6,NCAA Division III with football,979,1130,2109,2,"Private nonprofit, 4-year or above",2,20,13,60893,64559,125452,60893,64559,125452,Basketball
41375,2017,165529,Curry College,Milton,MA,2186,6,NCAA Division III with football,925,1133,2058,2,"Private nonprofit, 4-year or above",2,15,15,52203,55076,107279,52203,55076,107279,Basketball
59074,2018,165529,Curry College,Milton,MA,2186,6,NCAA Division III with football,906,1083,1989,2,"Private nonprofit, 4-year or above",2,18,17,68656,68171,136827,68656,68171,136827,Basketball
93271,2019,165529,Curry College,Milton,MA,2186,6,NCAA Division III with football,857,1098,1955,2,"Private nonprofit, 4-year or above",2,17,14,76065,61660,137725,76065,61660,137725,Basketball
9662,2015,190716,D'Youville College,Buffalo,NY,142011084,7,NCAA Division III without football,377,1040,1417,2,"Private nonprofit, 4-year or above",2,15,13,53249,57202,110451,53249,57202,110451,Basketball
27076,2016,190716,D'Youville College,Buffalo,NY,14201,7,NCAA Division III without football,354,979,1333,2,"Private nonprofit, 4-year or above",2,15,13,53716,54661,108377,53716,54661,108377,Basketball
44563,2017,190716,D'Youville College,Buffalo,NY,14201,7,NCAA Division III without football,348,947,1295,2,"Private nonprofit, 4-year or above",2,18,17,48713,50846,99559,48713,50846,99559,Basketball
62290,2018,190716,D'Youville College,Buffalo,NY,14201,7,NCAA Division III without football,355,907,1262,2,"Private nonprofit, 4-year or above",2,16,13,88748,83448,172196,88748,83448,172196,Basketball
104316,2019,190716,D'Youville College,Buffalo,NY,14201,7,NCAA Division III without football,317,859,1176,2,"Private nonprofit, 4-year or above",2,17,15,85263,94455,179718,85263,94455,179718,Basketball
9671,2015,190725,Daemen College,Amherst,NY,142263592,5,NCAA Division II without football,496,1180,1676,2,"Private nonprofit, 4-year or above",2,21,16,527670,347533,875203,527670,347533,875203,Basketball
27085,2016,190725,Daemen College,Amherst,NY,14226,5,NCAA Division II without football,515,1106,1621,2,"Private nonprofit, 4-year or above",2,25,16,622480,392060,1014540,461325,356374,817699,Basketball
44572,2017,190725,Daemen College,Amherst,NY,14226,5,NCAA Division II without football,470,1090,1560,2,"Private nonprofit, 4-year or above",2,28,14,494120,423303,917423,494120,423303,917423,Basketball
62300,2018,190725,Daemen College,Amherst,NY,14226,5,NCAA Division II without football,476,1019,1495,2,"Private nonprofit, 4-year or above",2,24,17,517048,481451,998499,496084,478063,974147,Basketball
104353,2019,190725,Daemen College,Amherst,NY,14226,5,NCAA Division II without football,458,1021,1479,2,"Private nonprofit, 4-year or above",2,30,19,530417,465227,995644,508717,442430,951147,Basketball
14723,2015,224226,Dallas Baptist University,Dallas,TX,752119299,5,NCAA Division II without football,995,1401,2396,2,"Private nonprofit, 4-year or above",2,13,0,795739,NA,795739,804975,NA,804975,Basketball
32193,2016,224226,Dallas Baptist University,Dallas,TX,75211,5,NCAA Division II without football,1019,1355,2374,2,"Private nonprofit, 4-year or above",2,16,0,821799,NA,821799,821737,NA,821737,Basketball
49715,2017,224226,Dallas Baptist University,Dallas,TX,75211,5,NCAA Division II without football,999,1385,2384,2,"Private nonprofit, 4-year or above",2,15,0,843119,NA,843119,840396,NA,840396,Basketball
67488,2018,224226,Dallas Baptist University,Dallas,TX,75211,5,NCAA Division II without football,994,1337,2331,2,"Private nonprofit, 4-year or above",2,13,0,889793,NA,889793,888594,NA,888594,Basketball
121682,2019,224226,Dallas Baptist University,Dallas,TX,75211,5,NCAA Division II without football,960,1337,2297,2,"Private nonprofit, 4-year or above",2,15,0,927503,NA,927503,927503,NA,927503,Basketball
8768,2015,182661,Daniel Webster College,Nashua,NH,30631300,7,NCAA Division III without football,505,99,604,3,"Private for-profit, 4-year or above",2,24,13,88088,84074,172162,88088,84074,172162,Basketball
8779,2015,182670,Dartmouth College,Hanover,NH,37553529,2,NCAA Division I-FCS,2132,2082,4214,2,"Private nonprofit, 4-year or above",2,18,13,1386651,1100498,2487149,1386651,1100498,2487149,Basketball
26204,2016,182670,Dartmouth College,Hanover,NH,3755,2,NCAA Division I-FCS,2117,2113,4230,2,"Private nonprofit, 4-year or above",2,16,16,1325872,845876,2171748,1325873,848548,2174421,Basketball
43699,2017,182670,Dartmouth College,Hanover,NH,3755,2,NCAA Division I-FCS,2194,2120,4314,2,"Private nonprofit, 4-year or above",2,13,13,1106827,872759,1979586,1106827,879777,1986604,Basketball
61417,2018,182670,Dartmouth College,Hanover,NH,3755,2,NCAA Division I-FCS,2193,2118,4311,2,"Private nonprofit, 4-year or above",2,15,14,1131199,963310,2094509,1131199,963310,2094509,Basketball
101316,2019,182670,Dartmouth College,Hanover,NH,3755,2,NCAA Division I-FCS,2216,2147,4363,2,"Private nonprofit, 4-year or above",2,18,37,1134595,900610,2035205,1134595,900610,2035205,Basketball
24495,2016,169479,Davenport University,Grand Rapids,MI,49512,4,NCAA Division II with football,1316,1196,2512,2,"Private nonprofit, 4-year or above",2,17,23,503492,447843,951335,503492,447843,951335,Basketball
41998,2017,169479,Davenport University,Grand Rapids,MI,49512,4,NCAA Division II with football,1392,1214,2606,2,"Private nonprofit, 4-year or above",2,17,15,572900,456442,1029342,572900,456442,1029342,Basketball
59697,2018,169479,Davenport University,Grand Rapids,MI,49512,4,NCAA Division II with football,1336,1198,2534,2,"Private nonprofit, 4-year or above",2,17,11,526118,454780,980898,526118,454780,980898,Basketball
94958,2019,169479,Davenport University,Grand Rapids,MI,49512,4,NCAA Division II with football,1304,1130,2434,2,"Private nonprofit, 4-year or above",2,15,13,1046697,831447,1878144,1046697,831447,1878144,Basketball
10857,2015,198385,Davidson College,Davidson,NC,28035,2,NCAA Division I-FCS,881,898,1779,2,"Private nonprofit, 4-year or above",2,17,13,2659875,1606088,4265963,2799370,1593373,4392743,Basketball
28295,2016,198385,Davidson College,Davidson,NC,28035,2,NCAA Division I-FCS,910,881,1791,2,"Private nonprofit, 4-year or above",2,17,11,2594894,1506518,4101412,2638281,1462802,4101083,Basketball
45792,2017,198385,Davidson College,Davidson,NC,28035,2,NCAA Division I-FCS,912,888,1800,2,"Private nonprofit, 4-year or above",2,16,13,3822426,1784851,5607277,3357239,1903208,5260447,Basketball
63507,2018,198385,Davidson College,Davidson,NC,28035,2,NCAA Division I-FCS,954,885,1839,2,"Private nonprofit, 4-year or above",2,15,13,3476469,1880382,5356851,3297453,1832674,5130127,Basketball
108051,2019,198385,Davidson College,Davidson,NC,28035,2,NCAA Division I-FCS,927,906,1833,2,"Private nonprofit, 4-year or above",2,17,14,3950768,2653070,6603838,3488697,2044498,5533195,Basketball
16292,2015,237358,Davis & Elkins College,Elkins,WV,262413996,5,NCAA Division II without football,343,433,776,2,"Private nonprofit, 4-year or above",2,21,19,354152,285030,639182,353175,278969,632144,Basketball
33765,2016,237358,Davis & Elkins College,Elkins,WV,26241,5,NCAA Division II without football,321,450,771,2,"Private nonprofit, 4-year or above",2,16,17,290999,319937,610936,267481,315926,583407,Basketball
51316,2017,237358,Davis & Elkins College,Elkins,WV,26241,5,NCAA Division II without football,320,465,785,2,"Private nonprofit, 4-year or above",2,19,17,363878,324897,688775,365755,323298,689053,Basketball
69066,2018,237358,Davis & Elkins College,Elkins,WV,26241,5,NCAA Division II without football,303,440,743,2,"Private nonprofit, 4-year or above",2,19,17,325144,306328,631472,324700,300856,625556,Basketball
128040,2019,237358,Davis & Elkins College,Elkins,WV,26241,5,NCAA Division II without football,312,439,751,2,"Private nonprofit, 4-year or above",2,18,17,355069,352237,707306,354684,319214,673898,Basketball
23877,2016,165574,Dean College,Franklin,MA,2038,6,NCAA Division III with football,563,569,1132,2,"Private nonprofit, 4-year or above",2,18,18,52338,56072,108410,50195,54617,104812,Basketball
41385,2017,165574,Dean College,Franklin,MA,2038,6,NCAA Division III with football,522,579,1101,2,"Private nonprofit, 4-year or above",2,15,16,56984,63419,120403,56984,63419,120403,Basketball
59084,2018,165574,Dean College,Franklin,MA,2038,6,NCAA Division III with football,566,586,1152,2,"Private nonprofit, 4-year or above",2,24,15,39990,45734,85724,39990,45734,85724,Basketball
93309,2019,165574,Dean College,Franklin,MA,2038,6,NCAA Division III with football,582,602,1184,2,"Private nonprofit, 4-year or above",2,21,16,47828,55446,103274,47036,53360,100396,Basketball
11552,2015,202514,Defiance College,Defiance,OH,43512,6,NCAA Division III with football,317,252,569,2,"Private nonprofit, 4-year or above",2,16,15,115368,105544,220912,108695,101245,209940,Basketball
28990,2016,202514,Defiance College,Defiance,OH,43512,6,NCAA Division III with football,287,220,507,2,"Private nonprofit, 4-year or above",2,18,14,149733,128785,278518,135148,123320,258468,Basketball
46490,2017,202514,Defiance College,Defiance,OH,43512,6,NCAA Division III with football,300,225,525,2,"Private nonprofit, 4-year or above",2,27,14,162895,118834,281729,153494,112581,266075,Basketball
64213,2018,202514,Defiance College,Defiance,OH,43512,6,NCAA Division III with football,266,208,474,2,"Private nonprofit, 4-year or above",2,15,17,171185,157953,329138,161760,147243,309003,Basketball
110615,2019,202514,Defiance College,Defiance,OH,43512,6,NCAA Division III with football,270,191,461,2,"Private nonprofit, 4-year or above",2,18,21,165136,157917,323053,155498,151527,307025,Basketball
2558,2015,130934,Delaware State University,Dover,DE,19901,2,NCAA Division I-FCS,1265,2224,3489,1,"Public, 4-year or above",2,19,14,1521971,1145795,2667766,1521971,1145795,2667766,Basketball
19928,2016,130934,Delaware State University,Dover,DE,19901,2,NCAA Division I-FCS,1256,2230,3486,1,"Public, 4-year or above",2,20,16,1366710,1109412,2476122,1366710,1109412,2476122,Basketball
37367,2017,130934,Delaware State University,Dover,DE,19901,2,NCAA Division I-FCS,1194,2260,3454,1,"Public, 4-year or above",2,18,18,1225094,1019232,2244326,1225094,1019232,2244326,Basketball
55006,2018,130934,Delaware State University,Dover,DE,19901,2,NCAA Division I-FCS,1196,2386,3582,1,"Public, 4-year or above",2,17,14,910671,1329666,2240337,910671,1329666,2240337,Basketball
79304,2019,130934,Delaware State University,Dover,DE,19901,2,NCAA Division I-FCS,1267,2452,3719,1,"Public, 4-year or above",2,15,14,912153,1247667,2159820,912153,1247667,2159820,Basketball
12711,2015,211981,Delaware Valley University,Doylestown,PA,189012697,6,NCAA Division III with football,684,1077,1761,2,"Private nonprofit, 4-year or above",2,15,12,132444,123009,255453,132444,123009,255453,Basketball
30165,2016,211981,Delaware Valley University,Doylestown,PA,18901,6,NCAA Division III with football,723,1043,1766,2,"Private nonprofit, 4-year or above",2,15,9,104364,131384,235748,104364,131384,235748,Basketball
47661,2017,211981,Delaware Valley University,Doylestown,PA,18901,6,NCAA Division III with football,710,1040,1750,2,"Private nonprofit, 4-year or above",2,15,12,114527,123618,238145,114527,123618,238145,Basketball
65412,2018,211981,Delaware Valley University,Doylestown,PA,18901,6,NCAA Division III with football,707,1036,1743,2,"Private nonprofit, 4-year or above",2,14,14,106312,126542,232854,106312,126542,232854,Basketball
114911,2019,211981,Delaware Valley University,Doylestown,PA,18901,6,NCAA Division III with football,665,980,1645,2,"Private nonprofit, 4-year or above",2,14,16,106335,139741,246076,106335,139741,246076,Basketball
7904,2015,175616,Delta State University,Cleveland,MS,38733,4,NCAA Division II with football,922,1319,2241,1,"Public, 4-year or above",2,13,11,434084,399304,833388,434084,399304,833388,Basketball
25319,2016,175616,Delta State University,Cleveland,MS,38733,4,NCAA Division II with football,923,1326,2249,1,"Public, 4-year or above",2,13,12,449891,407003,856894,449891,407003,856894,Basketball
42819,2017,175616,Delta State University,Cleveland,MS,38733,4,NCAA Division II with football,931,1256,2187,1,"Public, 4-year or above",2,16,13,429925,409872,839797,429925,409872,839797,Basketball
60526,2018,175616,Delta State University,Cleveland,MS,38733,4,NCAA Division II with football,871,1111,1982,1,"Public, 4-year or above",2,14,12,294784,251498,546282,457020,410971,867991,Basketball
97833,2019,175616,Delta State University,Cleveland,MS,38733,4,NCAA Division II with football,879,1092,1971,1,"Public, 4-year or above",2,15,13,259991,275480,535471,405026,413153,818179,Basketball
11564,2015,202523,Denison University,Granville,OH,430230713,6,NCAA Division III with football,973,1279,2252,2,"Private nonprofit, 4-year or above",2,19,19,197196,224681,421877,197196,224681,421877,Basketball
29001,2016,202523,Denison University,Granville,OH,43023,6,NCAA Division III with football,1011,1248,2259,2,"Private nonprofit, 4-year or above",2,23,20,197755,227786,425541,197755,227786,425541,Basketball
46501,2017,202523,Denison University,Granville,OH,43023,6,NCAA Division III with football,1032,1287,2319,2,"Private nonprofit, 4-year or above",2,21,20,225598,230603,456201,225598,230603,456201,Basketball
64226,2018,202523,Denison University,Granville,OH,43023,6,NCAA Division III with football,1075,1290,2365,2,"Private nonprofit, 4-year or above",2,22,20,240013,267180,507193,240013,267180,507193,Basketball
110627,2019,202523,Denison University,Granville,OH,43023,6,NCAA Division III with football,1069,1190,2259,2,"Private nonprofit, 4-year or above",2,15,23,243947,276622,520569,243947,276622,520569,Basketball
3692,2015,144740,DePaul University,Chicago,IL,60604,3,NCAA Division I without football,6441,7153,13594,2,"Private nonprofit, 4-year or above",2,17,14,5569062,2993381,8562443,5569062,2993381,8562443,Basketball
21062,2016,144740,DePaul University,Chicago,IL,60604,3,NCAA Division I without football,6250,6876,13126,2,"Private nonprofit, 4-year or above",2,16,14,5533811,3057956,8591767,5533811,3057956,8591767,Basketball
38522,2017,144740,DePaul University,Chicago,IL,60604,3,NCAA Division I without football,6108,6753,12861,2,"Private nonprofit, 4-year or above",2,19,14,7080194,3262772,10342966,7080194,3262772,10342966,Basketball
56178,2018,144740,DePaul University,Chicago,IL,60604,3,NCAA Division I without football,5933,6828,12761,2,"Private nonprofit, 4-year or above",2,17,13,6793520,3462918,10256438,6793520,3462918,10256438,Basketball
83701,2019,144740,DePaul University,Chicago,IL,60604,3,NCAA Division I without football,5901,6845,12746,2,"Private nonprofit, 4-year or above",2,18,14,6622986,3186989,9809975,6622986,3186989,9809975,Basketball
4363,2015,150400,DePauw University,Greencastle,IN,461351772,6,NCAA Division III with football,1020,1200,2220,2,"Private nonprofit, 4-year or above",2,21,16,259308,245431,504739,259308,245431,504739,Basketball
21733,2016,150400,DePauw University,Greencastle,IN,46135,6,NCAA Division III with football,1026,1152,2178,2,"Private nonprofit, 4-year or above",2,18,16,279070,323953,603023,279070,323953,603023,Basketball
39200,2017,150400,DePauw University,Greencastle,IN,46135,6,NCAA Division III with football,1031,1101,2132,2,"Private nonprofit, 4-year or above",2,22,14,296488,326393,622881,296488,326393,622881,Basketball
56861,2018,150400,DePauw University,Greencastle,IN,46135,6,NCAA Division III with football,1010,1124,2134,2,"Private nonprofit, 4-year or above",2,19,18,301840,336758,638598,301840,336758,638598,Basketball
86088,2019,150400,DePauw University,Greencastle,IN,46135,6,NCAA Division III with football,927,1012,1939,2,"Private nonprofit, 4-year or above",2,17,18,261105,340312,601417,261105,340312,601417,Basketball
12543,2015,210739,DeSales University,Center Valley,PA,180349568,7,NCAA Division III without football,729,1009,1738,2,"Private nonprofit, 4-year or above",2,17,16,148073,142012,290085,140663,138552,279215,Basketball
29992,2016,210739,DeSales University,Center Valley,PA,18034,7,NCAA Division III without football,781,1073,1854,2,"Private nonprofit, 4-year or above",2,18,16,176740,150399,327139,165925,146704,312629,Basketball
47488,2017,210739,DeSales University,Center Valley,PA,18034,7,NCAA Division III without football,748,1059,1807,2,"Private nonprofit, 4-year or above",2,15,14,160899,151772,312671,151019,148707,299726,Basketball
65237,2018,210739,DeSales University,Center Valley,PA,18034,7,NCAA Division III without football,751,1202,1953,2,"Private nonprofit, 4-year or above",2,16,16,167242,166737,333979,155071,161637,316708,Basketball
114247,2019,210739,DeSales University,Center Valley,PA,18034,7,NCAA Division III without football,754,1206,1960,2,"Private nonprofit, 4-year or above",2,14,16,162711,170031,332742,153211,166531,319742,Basketball
12725,2015,212009,Dickinson College,Carlisle,PA,170132896,6,NCAA Division III with football,1000,1370,2370,2,"Private nonprofit, 4-year or above",2,17,17,133197,107052,240249,119181,103396,222577,Basketball
30179,2016,212009,Dickinson College,Carlisle,PA,17013,6,NCAA Division III with football,981,1375,2356,2,"Private nonprofit, 4-year or above",2,16,17,190270,125228,315498,132441,111676,244117,Basketball
47676,2017,212009,Dickinson College,Carlisle,PA,17013,6,NCAA Division III with football,970,1355,2325,2,"Private nonprofit, 4-year or above",2,15,15,131434,109757,241191,126586,124811,251397,Basketball
65428,2018,212009,Dickinson College,Carlisle,PA,17013,6,NCAA Division III with football,987,1358,2345,2,"Private nonprofit, 4-year or above",2,18,16,137733,101749,239482,121447,100165,221612,Basketball
114949,2019,212009,Dickinson College,Carlisle,PA,17013,6,NCAA Division III with football,898,1193,2091,2,"Private nonprofit, 4-year or above",2,17,17,128998,99016,228014,119645,95196,214841,Basketball
15385,2015,230171,Dixie State University,Saint George,UT,847703876,4,NCAA Division II with football,2450,2776,5226,1,"Public, 4-year or above",2,18,15,712940,550693,1263633,712940,550693,1263633,Basketball
32845,2016,230171,Dixie State University,Saint George,UT,84770,4,NCAA Division II with football,2488,3041,5529,1,"Public, 4-year or above",2,17,13,797411,537882,1335293,797411,537882,1335293,Basketball
50377,2017,230171,Dixie State University,Saint George,UT,84770,4,NCAA Division II with football,2544,3348,5892,1,"Public, 4-year or above",2,18,14,890080,563347,1453427,890080,563347,1453427,Basketball
68153,2018,230171,Dixie State University,Saint George,UT,84770,4,NCAA Division II with football,2503,3384,5887,1,"Public, 4-year or above",2,18,13,837366,599976,1437342,837366,599976,1437342,Basketball
124712,2019,230171,Dixie State University,Saint George,UT,84770,4,NCAA Division II with football,2654,3652,6306,1,"Public, 4-year or above",2,16,14,761490,614638,1376128,761490,614638,1376128,Basketball
9680,2015,190761,Dominican College of Blauvelt,Orangeburg,NY,109621210,5,NCAA Division II without football,479,877,1356,2,"Private nonprofit, 4-year or above",2,16,14,372599,343611,716210,372599,343611,716210,Basketball
27094,2016,190761,Dominican College of Blauvelt,Orangeburg,NY,10962,5,NCAA Division II without football,458,872,1330,2,"Private nonprofit, 4-year or above",2,15,16,453617,399937,853554,453617,399937,853554,Basketball
44581,2017,190761,Dominican College of Blauvelt,Orangeburg,NY,10962,5,NCAA Division II without football,444,827,1271,2,"Private nonprofit, 4-year or above",2,20,16,423814,405611,829425,423814,405611,829425,Basketball
62309,2018,190761,Dominican College of Blauvelt,Orangeburg,NY,10962,5,NCAA Division II without football,452,852,1304,2,"Private nonprofit, 4-year or above",2,21,18,511077,390080,901157,511077,390080,901157,Basketball
104364,2019,190761,Dominican College of Blauvelt,Orangeburg,NY,10962,5,NCAA Division II without football,442,826,1268,2,"Private nonprofit, 4-year or above",2,22,19,500178,405027,905205,500178,405027,905205,Basketball
4172,2015,148496,Dominican University,River Forest,IL,60305,7,NCAA Division III without football,710,1361,2071,2,"Private nonprofit, 4-year or above",2,21,15,140968,149920,290888,140968,149920,290888,Basketball
21545,2016,148496,Dominican University,River Forest,IL,60305,7,NCAA Division III without football,713,1388,2101,2,"Private nonprofit, 4-year or above",2,23,17,131588,127946,259534,131588,127946,259534,Basketball
39008,2017,148496,Dominican University,River Forest,IL,60305,7,NCAA Division III without football,687,1324,2011,2,"Private nonprofit, 4-year or above",2,19,13,139480,134426,273906,139480,134426,273906,Basketball
56667,2018,148496,Dominican University,River Forest,IL,60305,7,NCAA Division III without football,629,1343,1972,2,"Private nonprofit, 4-year or above",2,22,13,139749,139927,279676,139749,139927,279676,Basketball
85347,2019,148496,Dominican University,River Forest,IL,60305,7,NCAA Division III without football,617,1394,2011,2,"Private nonprofit, 4-year or above",2,18,17,99092,109634,208726,99092,109634,208726,Basketball
1193,2015,113698,Dominican University of California,San Rafael,CA,949012298,5,NCAA Division II without football,325,848,1173,2,"Private nonprofit, 4-year or above",2,16,13,575696,445799,1021495,575696,445799,1021495,Basketball
18548,2016,113698,Dominican University of California,San Rafael,CA,94901,5,NCAA Division II without football,332,893,1225,2,"Private nonprofit, 4-year or above",2,15,12,465471,404891,870362,465471,404891,870362,Basketball
35986,2017,113698,Dominican University of California,San Rafael,CA,94901,5,NCAA Division II without football,301,834,1135,2,"Private nonprofit, 4-year or above",2,14,13,428536,372763,801299,538470,468254,1006724,Basketball
53603,2018,113698,Dominican University of California,San Rafael,CA,94901,5,NCAA Division II without football,281,854,1135,2,"Private nonprofit, 4-year or above",2,14,13,492747,428617,921364,617267,527088,1144355,Basketball
74754,2019,113698,Dominican University of California,San Rafael,CA,94901,5,NCAA Division II without football,370,867,1237,2,"Private nonprofit, 4-year or above",2,15,12,602679,499511,1102190,602678,499511,1102189,Basketball
4765,2015,153269,Drake University,Des Moines,IA,503114505,2,NCAA Division I-FCS,1358,1800,3158,2,"Private nonprofit, 4-year or above",2,15,22,2286284,1121457,3407741,2472212,1382221,3854433,Basketball
22130,2016,153269,Drake University,Des Moines,IA,50311,2,NCAA Division I-FCS,1313,1778,3091,2,"Private nonprofit, 4-year or above",2,15,22,2696721,1540021,4236742,2933596,1792640,4726236,Basketball
39601,2017,153269,Drake University,Des Moines,IA,50311,2,NCAA Division I-FCS,1249,1697,2946,2,"Private nonprofit, 4-year or above",2,13,28,2488067,1759129,4247196,2696222,1862162,4558384,Basketball
57264,2018,153269,Drake University,Des Moines,IA,50311,2,NCAA Division I-FCS,1168,1660,2828,2,"Private nonprofit, 4-year or above",2,16,31,2557916,3190374,5748290,2649047,2024296,4673343,Basketball
87477,2019,153269,Drake University,Des Moines,IA,50311,2,NCAA Division I-FCS,1151,1674,2825,2,"Private nonprofit, 4-year or above",2,17,23,1673180,3005385,4678565,2998669,2406319,5404988,Basketball
8974,2015,184348,Drew University,Madison,NJ,7940,7,NCAA Division III without football,501,829,1330,2,"Private nonprofit, 4-year or above",2,19,12,131288,100552,231840,131288,100552,231840,Basketball
26399,2016,184348,Drew University,Madison,NJ,7940,7,NCAA Division III without football,537,845,1382,2,"Private nonprofit, 4-year or above",2,19,13,146607,120078,266685,146607,120078,266685,Basketball
43894,2017,184348,Drew University,Madison,NJ,7940,7,NCAA Division III without football,569,820,1389,2,"Private nonprofit, 4-year or above",2,18,10,144239,146697,290936,144239,146697,290936,Basketball
61613,2018,184348,Drew University,Madison,NJ,7940,7,NCAA Division III without football,611,905,1516,2,"Private nonprofit, 4-year or above",2,20,13,164104,165823,329927,164104,165823,329927,Basketball
102015,2019,184348,Drew University,Madison,NJ,7940,7,NCAA Division III without football,625,944,1569,2,"Private nonprofit, 4-year or above",2,22,18,137856,152768,290624,137856,152768,290624,Basketball
12739,2015,212054,Drexel University,Philadelphia,PA,19104,3,NCAA Division I without football,7951,6109,14060,2,"Private nonprofit, 4-year or above",2,15,13,2926278,2191647,5117925,2618412,2009938,4628350,Basketball
30193,2016,212054,Drexel University,Philadelphia,PA,19104,3,NCAA Division I without football,7455,5803,13258,2,"Private nonprofit, 4-year or above",2,18,14,2861372,2153980,5015352,2861372,2153980,5015352,Basketball
47690,2017,212054,Drexel University,Philadelphia,PA,19104,3,NCAA Division I without football,7419,6134,13553,2,"Private nonprofit, 4-year or above",2,17,16,2956999,2295396,5252395,2956999,2295396,5252395,Basketball
65442,2018,212054,Drexel University,Philadelphia,PA,19104,3,NCAA Division I without football,7516,6411,13927,2,"Private nonprofit, 4-year or above",2,16,13,2760011,2024657,4784668,2760011,2024657,4784668,Basketball
114963,2019,212054,Drexel University,Philadelphia,PA,19104,3,NCAA Division I without football,7501,6367,13868,2,"Private nonprofit, 4-year or above",2,13,14,2632430,2274181,4906611,2632430,2274182,4906612,Basketball
8138,2015,177214,Drury University,Springfield,MO,658023791,5,NCAA Division II without football,1130,1205,2335,2,"Private nonprofit, 4-year or above",2,12,11,893902,610465,1504367,893902,610465,1504367,Basketball
25558,2016,177214,Drury University,Springfield,MO,65802,5,NCAA Division II without football,1020,1329,2349,2,"Private nonprofit, 4-year or above",2,16,14,798376,702860,1501236,798376,702860,1501236,Basketball
43054,2017,177214,Drury University,Springfield,MO,65802,5,NCAA Division II without football,917,1373,2290,2,"Private nonprofit, 4-year or above",2,16,11,901473,703367,1604840,901473,703367,1604840,Basketball
60768,2018,177214,Drury University,Springfield,MO,65802,5,NCAA Division II without football,619,839,1458,2,"Private nonprofit, 4-year or above",2,16,13,884035,730316,1614351,884035,730316,1614351,Basketball
98854,2019,177214,Drury University,Springfield,MO,65802,5,NCAA Division II without football,609,834,1443,2,"Private nonprofit, 4-year or above",2,14,16,913784,1009524,1923308,913784,1009524,1923308,Basketball
10869,2015,198419,Duke University,Durham,NC,27708,1,NCAA Division I-FBS,3319,3166,6485,2,"Private nonprofit, 4-year or above",2,13,15,31033555,3142791,34176346,17890632,5771447,23662079,Basketball
28307,2016,198419,Duke University,Durham,NC,27708,1,NCAA Division I-FBS,3259,3190,6449,2,"Private nonprofit, 4-year or above",2,16,13,34398285,3605428,38003713,19507686,6355483,25863169,Basketball
45804,2017,198419,Duke University,Durham,NC,27708,1,NCAA Division I-FBS,3261,3275,6536,2,"Private nonprofit, 4-year or above",2,15,15,36412223,3810612,40222835,20826848,6940064,27766912,Basketball
63519,2018,198419,Duke University,Durham,NC,27708,1,NCAA Division I-FBS,3278,3300,6578,2,"Private nonprofit, 4-year or above",2,15,14,35489891,3821554,39311445,22178473,6669372,28847845,Basketball
108089,2019,198419,Duke University,Durham,NC,27708,1,NCAA Division I-FBS,3232,3294,6526,2,"Private nonprofit, 4-year or above",2,15,14,33382946,3861246,37244192,19949246,6668801,26618047,Basketball
12750,2015,212106,Duquesne University,Pittsburgh,PA,15282,2,NCAA Division I-FCS,2153,3567,5720,2,"Private nonprofit, 4-year or above",2,17,15,4229922,2146360,6376282,4229922,2146360,6376282,Basketball
30204,2016,212106,Duquesne University,Pittsburgh,PA,15282,2,NCAA Division I-FCS,2165,3686,5851,2,"Private nonprofit, 4-year or above",2,16,15,4445910,2236658,6682568,4445910,2236658,6682568,Basketball
47701,2017,212106,Duquesne University,Pittsburgh,PA,15282,2,NCAA Division I-FCS,2116,3708,5824,2,"Private nonprofit, 4-year or above",2,19,16,5191315,2370525,7561840,5191315,2370525,7561840,Basketball
65453,2018,212106,Duquesne University,Pittsburgh,PA,15282,2,NCAA Division I-FCS,2138,3758,5896,2,"Private nonprofit, 4-year or above",2,17,16,5612982,2356452,7969434,5612982,2356452,7969434,Basketball
115001,2019,212106,Duquesne University,Pittsburgh,PA,15282,2,NCAA Division I-FCS,2069,3663,5732,2,"Private nonprofit, 4-year or above",2,15,15,5859182,2377437,8236619,5859182,2377437,8236619,Basketball
4375,2015,150455,Earlham College,Richmond,IN,473744095,6,NCAA Division III with football,402,528,930,2,"Private nonprofit, 4-year or above",2,16,15,165158,141509,306667,165158,141509,306667,Basketball
21745,2016,150455,Earlham College,Richmond,IN,47374,6,NCAA Division III with football,444,547,991,2,"Private nonprofit, 4-year or above",2,19,19,211610,141859,353469,211610,141859,353469,Basketball
39212,2017,150455,Earlham College,Richmond,IN,47374,6,NCAA Division III with football,463,557,1020,2,"Private nonprofit, 4-year or above",2,19,16,184489,152871,337360,184489,148053,332542,Basketball
56874,2018,150455,Earlham College,Richmond,IN,47374,6,NCAA Division III with football,466,555,1021,2,"Private nonprofit, 4-year or above",2,17,15,191075,142242,333317,189079,142513,331592,Basketball
86126,2019,150455,Earlham College,Richmond,IN,47374,7,NCAA Division III without football,395,516,911,2,"Private nonprofit, 4-year or above",2,17,17,192915,154404,347319,192915,154404,347319,Basketball
10883,2015,198464,East Carolina University,Greenville,NC,278584353,1,NCAA Division I-FBS,8092,11153,19245,1,"Public, 4-year or above",2,17,22,3369399,2690316,6059715,3187963,2403050,5591013,Basketball
28321,2016,198464,East Carolina University,Greenville,NC,27858,1,NCAA Division I-FBS,8393,11305,19698,1,"Public, 4-year or above",2,15,22,3489508,2613663,6103171,3376742,2134998,5511740,Basketball
45819,2017,198464,East Carolina University,Greenville,NC,27858,1,NCAA Division I-FBS,8643,11315,19958,1,"Public, 4-year or above",2,17,31,3236772,2498262,5735034,3172882,2165627,5338509,Basketball
63534,2018,198464,East Carolina University,Greenville,NC,27858,1,NCAA Division I-FBS,8478,11045,19523,1,"Public, 4-year or above",2,16,17,3945332,2209997,6155329,3942406,2175944,6118350,Basketball
108127,2019,198464,East Carolina University,Greenville,NC,27858,1,NCAA Division I-FBS,8347,10823,19170,1,"Public, 4-year or above",2,16,22,3990276,2217086,6207362,3990276,2217034,6207310,Basketball
12079,2015,207041,East Central University,Ada,OK,748206999,4,NCAA Division II with football,1339,1729,3068,1,"Public, 4-year or above",2,15,12,296892,243124,540016,272686,227171,499857,Basketball
29522,2016,207041,East Central University,Ada,OK,74820,4,NCAA Division II with football,1222,1607,2829,1,"Public, 4-year or above",2,12,11,367657,320844,688501,334260,280809,615069,Basketball
47027,2017,207041,East Central University,Ada,OK,74820,4,NCAA Division II with football,1038,1452,2490,1,"Public, 4-year or above",2,14,11,437851,368326,806177,384755,314162,698917,Basketball
64769,2018,207041,East Central University,Ada,OK,74820,4,NCAA Division II with football,996,1399,2395,1,"Public, 4-year or above",2,16,12,371852,322752,694604,356405,310577,666982,Basketball
112364,2019,207041,East Central University,Ada,OK,74820,4,NCAA Division II with football,1007,1377,2384,1,"Public, 4-year or above",2,13,18,339170,277921,617091,333490,274757,608247,Basketball
12760,2015,212115,East Stroudsburg University of Pennsylvania,East Stroudsburg,PA,183012999,4,NCAA Division II with football,2489,3136,5625,1,"Public, 4-year or above",2,16,15,525903,349508,875411,486920,349508,836428,Basketball
30215,2016,212115,East Stroudsburg University of Pennsylvania,East Stroudsburg,PA,18301,4,NCAA Division II with football,2435,3181,5616,1,"Public, 4-year or above",2,16,15,546933,369996,916929,510682,376924,887606,Basketball
47712,2017,212115,East Stroudsburg University of Pennsylvania,East Stroudsburg,PA,18301,4,NCAA Division II with football,2403,3122,5525,1,"Public, 4-year or above",2,14,14,478261,380150,858411,469648,378488,848136,Basketball
65464,2018,212115,East Stroudsburg University of Pennsylvania,East Stroudsburg,PA,18301,4,NCAA Division II with football,2298,2917,5215,1,"Public, 4-year or above",2,16,13,564105,382295,946400,555390,373683,929073,Basketball
115039,2019,212115,East Stroudsburg University of Pennsylvania,East Stroudsburg,PA,18301,4,NCAA Division II with football,2155,2768,4923,1,"Public, 4-year or above",2,15,12,594570,381563,976133,613905,383960,997865,Basketball
14358,2015,220075,East Tennessee State University,Johnson City,TN,37614,2,NCAA Division I-FCS,4163,5247,9410,1,"Public, 4-year or above",2,16,13,1818542,1061469,2880011,1818542,1061469,2880011,Basketball
31822,2016,220075,East Tennessee State University,Johnson City,TN,37614,2,NCAA Division I-FCS,4083,5250,9333,1,"Public, 4-year or above",2,13,12,1565348,1182993,2748341,1565348,1182993,2748341,Basketball
49340,2017,220075,East Tennessee State University,Johnson City,TN,37614,2,NCAA Division I-FCS,4211,5396,9607,1,"Public, 4-year or above",2,17,12,1815749,1094241,2909990,1815749,1094241,2909990,Basketball
67113,2018,220075,East Tennessee State University,Johnson City,TN,37614,2,NCAA Division I-FCS,4062,5446,9508,1,"Public, 4-year or above",2,15,15,1878553,1334271,3212824,1878553,1334271,3212824,Basketball
120276,2019,220075,East Tennessee State University,Johnson City,TN,37614,2,NCAA Division I-FCS,3789,5405,9194,1,"Public, 4-year or above",2,15,15,2160240,1303885,3464125,2160240,1303885,3464125,Basketball
14743,2015,224527,East Texas Baptist University,Marshall,TX,756701498,6,NCAA Division III with football,512,582,1094,2,"Private nonprofit, 4-year or above",2,17,18,198954,145339,344293,198954,145339,344293,Basketball
32213,2016,224527,East Texas Baptist University,Marshall,TX,75670,6,NCAA Division III with football,582,595,1177,2,"Private nonprofit, 4-year or above",2,32,19,256958,180106,437064,256958,180106,437064,Basketball
49735,2017,224527,East Texas Baptist University,Marshall,TX,75670,6,NCAA Division III with football,592,624,1216,2,"Private nonprofit, 4-year or above",2,29,32,280425,249935,530360,280425,249935,530360,Basketball
67508,2018,224527,East Texas Baptist University,Marshall,TX,75670,6,NCAA Division III with football,607,687,1294,2,"Private nonprofit, 4-year or above",2,29,36,291564,299058,590622,291564,299058,590622,Basketball
121732,2019,224527,East Texas Baptist University,Marshall,TX,75670,6,NCAA Division III with football,555,675,1230,2,"Private nonprofit, 4-year or above",2,32,35,289238,272164,561402,289238,272164,561402,Basketball
2379,2015,129215,Eastern Connecticut State University,Willimantic,CT,6226,7,NCAA Division III without football,1966,2301,4267,1,"Public, 4-year or above",2,16,14,185854,244731,430585,185854,244731,430585,Basketball
19751,2016,129215,Eastern Connecticut State University,Willimantic,CT,6226,7,NCAA Division III without football,1902,2389,4291,1,"Public, 4-year or above",2,16,15,176199,216231,392430,176199,216231,392430,Basketball
37190,2017,129215,Eastern Connecticut State University,Willimantic,CT,6226,7,NCAA Division III without football,1817,2393,4210,1,"Public, 4-year or above",2,16,13,229963,273416,503379,229963,273416,503379,Basketball
54826,2018,129215,Eastern Connecticut State University,Willimantic,CT,6226,7,NCAA Division III without football,1778,2466,4244,1,"Public, 4-year or above",2,14,16,254757,286103,540860,254757,286103,540860,Basketball
78934,2019,129215,Eastern Connecticut State University,Willimantic,CT,6226,7,NCAA Division III without football,1734,2323,4057,1,"Public, 4-year or above",2,15,16,274582,296875,571457,274582,296875,571457,Basketball
3710,2015,144892,Eastern Illinois University,Charleston,IL,61920,2,NCAA Division I-FCS,2541,3708,6249,1,"Public, 4-year or above",2,15,20,1040415,772877,1813292,1040415,772877,1813292,Basketball
21081,2016,144892,Eastern Illinois University,Charleston,IL,61920,2,NCAA Division I-FCS,2041,3076,5117,1,"Public, 4-year or above",2,14,19,1032512,790076,1822588,1032512,790076,1822588,Basketball
38539,2017,144892,Eastern Illinois University,Charleston,IL,61920,2,NCAA Division I-FCS,1750,2563,4313,1,"Public, 4-year or above",2,15,17,1175351,888384,2063735,1175351,888384,2063735,Basketball
56197,2018,144892,Eastern Illinois University,Charleston,IL,61920,2,NCAA Division I-FCS,1680,2408,4088,1,"Public, 4-year or above",2,16,16,1146676,893089,2039765,1146676,893089,2039765,Basketball
83776,2019,144892,Eastern Illinois University,Charleston,IL,61920,2,NCAA Division I-FCS,1649,2341,3990,1,"Public, 4-year or above",2,15,14,1119522,856638,1976160,1119522,856638,1976160,Basketball
5535,2015,156620,Eastern Kentucky University,Richmond,KY,404753102,2,NCAA Division I-FCS,4905,6412,11317,1,"Public, 4-year or above",2,18,18,1898072,1060403,2958475,1898072,1060403,2958475,Basketball
22909,2016,156620,Eastern Kentucky University,Richmond,KY,40475,2,NCAA Division I-FCS,4819,6183,11002,1,"Public, 4-year or above",2,17,18,1588554,1189223,2777777,1588554,1189223,2777777,Basketball
40401,2017,156620,Eastern Kentucky University,Richmond,KY,40475,2,NCAA Division I-FCS,4625,6109,10734,1,"Public, 4-year or above",2,15,15,1589230,1066253,2655483,1589230,1066253,2655483,Basketball
58078,2018,156620,Eastern Kentucky University,Richmond,KY,40475,2,NCAA Division I-FCS,4457,5991,10448,1,"Public, 4-year or above",2,15,15,1576265,975215,2551480,1576265,975215,2551480,Basketball
89980,2019,156620,Eastern Kentucky University,Richmond,KY,40475,2,NCAA Division I-FCS,4172,5732,9904,1,"Public, 4-year or above",2,16,15,1434809,1002811,2437620,1434809,1002811,2437620,Basketball
15636,2015,232043,Eastern Mennonite University,Harrisonburg,VA,228022462,7,NCAA Division III without football,388,699,1087,2,"Private nonprofit, 4-year or above",2,15,16,122608,104590,227198,122609,104590,227199,Basketball
33108,2016,232043,Eastern Mennonite University,Harrisonburg,VA,22802,7,NCAA Division III without football,391,690,1081,2,"Private nonprofit, 4-year or above",2,17,14,131877,98491,230368,131877,98491,230368,Basketball
50650,2017,232043,Eastern Mennonite University,Harrisonburg,VA,22802,7,NCAA Division III without football,365,577,942,2,"Private nonprofit, 4-year or above",2,23,20,148468,109082,257550,148468,109082,257550,Basketball
68400,2018,232043,Eastern Mennonite University,Harrisonburg,VA,22802,7,NCAA Division III without football,342,506,848,2,"Private nonprofit, 4-year or above",2,19,16,148905,110862,259767,148905,110862,259767,Basketball
125506,2019,232043,Eastern Mennonite University,Harrisonburg,VA,22802,7,NCAA Division III without football,326,502,828,2,"Private nonprofit, 4-year or above",2,17,14,115687,116185,231872,115687,116185,231872,Basketball
7125,2015,169798,Eastern Michigan University,Ypsilanti,MI,48197,1,NCAA Division I-FBS,5212,7682,12894,1,"Public, 4-year or above",2,15,19,2031760,1369167,3400927,2031759,1334166,3365925,Basketball
24519,2016,169798,Eastern Michigan University,Ypsilanti,MI,48197,1,NCAA Division I-FBS,5119,7595,12714,1,"Public, 4-year or above",2,16,16,1876260,1414297,3290557,1876259,1414298,3290557,Basketball
42022,2017,169798,Eastern Michigan University,Ypsilanti,MI,48197,1,NCAA Division I-FBS,4984,7291,12275,1,"Public, 4-year or above",2,16,14,1986042,1617668,3603710,1986042,1617668,3603710,Basketball
59722,2018,169798,Eastern Michigan University,Ypsilanti,MI,48197,1,NCAA Division I-FBS,4516,6782,11298,1,"Public, 4-year or above",2,16,14,2170870,1543861,3714731,2170870,1543861,3714731,Basketball
95072,2019,169798,Eastern Michigan University,Ypsilanti,MI,48197,1,NCAA Division I-FBS,4174,6257,10431,1,"Public, 4-year or above",2,16,18,2048248,1445511,3493759,2048248,1445511,3493759,Basketball
6502,2015,165644,Eastern Nazarene College,Quincy,MA,21702999,7,NCAA Division III without football,331,572,903,2,"Private nonprofit, 4-year or above",2,16,14,90035,82148,172183,90035,82148,172183,Basketball
23886,2016,165644,Eastern Nazarene College,Quincy,MA,2170,7,NCAA Division III without football,286,370,656,2,"Private nonprofit, 4-year or above",2,16,14,93152,83130,176282,93152,83130,176282,Basketball
41394,2017,165644,Eastern Nazarene College,Quincy,MA,2170,7,NCAA Division III without football,259,312,571,2,"Private nonprofit, 4-year or above",2,18,18,96554,87685,184239,96554,87685,184239,Basketball
59094,2018,165644,Eastern Nazarene College,Quincy,MA,2170,7,NCAA Division III without football,284,294,578,2,"Private nonprofit, 4-year or above",2,17,15,105533,97679,203212,105533,97679,203212,Basketball
93347,2019,165644,Eastern Nazarene College,Quincy,MA,2170,7,NCAA Division III without football,269,281,550,2,"Private nonprofit, 4-year or above",2,15,15,95651,87460,183111,95651,87460,183111,Basketball
9288,2015,187648,Eastern New Mexico University-Main Campus,Portales,NM,88130,4,NCAA Division II with football,1177,1482,2659,1,"Public, 4-year or above",2,15,18,320066,372449,692515,378017,367977,745994,Basketball
26709,2016,187648,Eastern New Mexico University-Main Campus,Portales,NM,88130,4,NCAA Division II with football,1101,1468,2569,1,"Public, 4-year or above",2,19,16,375025,408343,783368,411764,388522,800286,Basketball
44204,2017,187648,Eastern New Mexico University-Main Campus,Portales,NM,88130,4,NCAA Division II with football,1080,1503,2583,1,"Public, 4-year or above",2,14,14,352867,397534,750401,401442,419531,820973,Basketball
61926,2018,187648,Eastern New Mexico University-Main Campus,Portales,NM,88130,4,NCAA Division II with football,1050,1422,2472,1,"Public, 4-year or above",2,14,16,412651,431064,843715,412651,431064,843715,Basketball
102944,2019,187648,Eastern New Mexico University-Main Campus,Portales,NM,88130,4,NCAA Division II with football,942,1453,2395,1,"Public, 4-year or above",2,17,18,437250,455304,892554,437250,455304,892554,Basketball
12773,2015,212133,Eastern University,Saint Davids,PA,190873696,7,NCAA Division III without football,579,1272,1851,2,"Private nonprofit, 4-year or above",2,25,11,127210,66541,193751,117846,63368,181214,Basketball
30228,2016,212133,Eastern University,Saint Davids,PA,19087,7,NCAA Division III without football,554,1204,1758,2,"Private nonprofit, 4-year or above",2,23,14,204413,80089,284502,201049,74614,275663,Basketball
47725,2017,212133,Eastern University,Saint Davids,PA,19087,7,NCAA Division III without football,498,964,1462,2,"Private nonprofit, 4-year or above",2,24,13,249380,84803,334183,249380,77166,326546,Basketball
65477,2018,212133,Eastern University,Saint Davids,PA,19087,7,NCAA Division III without football,511,952,1463,2,"Private nonprofit, 4-year or above",2,15,13,225389,109690,335079,212648,108867,321515,Basketball
115077,2019,212133,Eastern University,Saint Davids,PA,19087,7,NCAA Division III without football,467,861,1328,2,"Private nonprofit, 4-year or above",2,19,11,276113,103170,379283,223883,93936,317819,Basketball
16009,2015,235097,Eastern Washington University,Cheney,WA,990042496,2,NCAA Division I-FCS,4534,5210,9744,1,"Public, 4-year or above",2,17,19,1564917,1076193,2641110,1564917,1076193,2641110,Basketball
33483,2016,235097,Eastern Washington University,Cheney,WA,99004,2,NCAA Division I-FCS,4478,5029,9507,1,"Public, 4-year or above",2,15,16,1784218,1300850,3085068,1784218,1300850,3085068,Basketball
51036,2017,235097,Eastern Washington University,Cheney,WA,99004,2,NCAA Division I-FCS,4465,5037,9502,1,"Public, 4-year or above",2,18,16,1635085,1239112,2874197,1635085,1239112,2874197,Basketball
68787,2018,235097,Eastern Washington University,Cheney,WA,99004,2,NCAA Division I-FCS,4355,4986,9341,1,"Public, 4-year or above",2,18,20,1630809,1441384,3072193,1630808,1441384,3072192,Basketball
126804,2019,235097,Eastern Washington University,Cheney,WA,99004,2,NCAA Division I-FCS,4052,4854,8906,1,"Public, 4-year or above",2,18,16,1489002,1000263,2489265,1653951,1333084,2987035,Basketball
2756,2015,133492,Eckerd College,Saint Petersburg,FL,337114700,5,NCAA Division II without football,697,1148,1845,2,"Private nonprofit, 4-year or above",2,16,12,788163,621026,1409189,788163,621026,1409189,Basketball
20132,2016,133492,Eckerd College,Saint Petersburg,FL,33711,5,NCAA Division II without football,670,1220,1890,2,"Private nonprofit, 4-year or above",2,15,12,798528,690313,1488841,798528,690313,1488841,Basketball
37571,2017,133492,Eckerd College,Saint Petersburg,FL,33711,5,NCAA Division II without football,645,1255,1900,2,"Private nonprofit, 4-year or above",2,15,11,854547,700696,1555243,854547,700696,1555243,Basketball
55216,2018,133492,Eckerd College,Saint Petersburg,FL,33711,5,NCAA Division II without football,644,1281,1925,2,"Private nonprofit, 4-year or above",2,16,11,627187,672336,1299523,627187,672336,1299523,Basketball
79960,2019,133492,Eckerd College,Saint Petersburg,FL,33711,5,NCAA Division II without football,631,1313,1944,2,"Private nonprofit, 4-year or above",2,14,9,746584,592400,1338984,746585,592401,1338986,Basketball
16494,2015,238661,Edgewood College,Madison,WI,537111997,7,NCAA Division III without football,437,1102,1539,2,"Private nonprofit, 4-year or above",2,18,15,139397,148104,287501,121114,120850,241964,Basketball
33970,2016,238661,Edgewood College,Madison,WI,53711,7,NCAA Division III without football,392,1054,1446,2,"Private nonprofit, 4-year or above",2,16,12,206250,156759,363009,150984,141196,292180,Basketball
51526,2017,238661,Edgewood College,Madison,WI,53711,7,NCAA Division III without football,364,989,1353,2,"Private nonprofit, 4-year or above",2,22,16,151921,137009,288930,119157,117346,236503,Basketball
69271,2018,238661,Edgewood College,Madison,WI,53711,7,NCAA Division III without football,332,939,1271,2,"Private nonprofit, 4-year or above",2,22,18,162155,147147,309302,162155,147147,309302,Basketball
128682,2019,238661,Edgewood College,Madison,WI,53711,7,NCAA Division III without football,307,870,1177,2,"Private nonprofit, 4-year or above",2,19,17,137622,146464,284086,120749,128002,248751,Basketball
12782,2015,212160,Edinboro University of Pennsylvania,Edinboro,PA,164440001,4,NCAA Division II with football,1979,2744,4723,1,"Public, 4-year or above",2,14,15,358839,463651,822490,358839,463651,822490,Basketball
30237,2016,212160,Edinboro University of Pennsylvania,Edinboro,PA,16444,4,NCAA Division II with football,1824,2522,4346,1,"Public, 4-year or above",2,13,14,370750,508010,878760,370750,508010,878760,Basketball
47734,2017,212160,Edinboro University of Pennsylvania,Edinboro,PA,16444,4,NCAA Division II with football,1635,2248,3883,1,"Public, 4-year or above",2,13,12,358448,545385,903833,358448,545385,903833,Basketball
65486,2018,212160,Edinboro University of Pennsylvania,Edinboro,PA,16444,4,NCAA Division II with football,1350,1846,3196,1,"Public, 4-year or above",2,12,14,323660,413637,737297,323660,413637,737297,Basketball
115114,2019,212160,Edinboro University of Pennsylvania,Edinboro,PA,16444,4,NCAA Division II with football,1246,1747,2993,1,"Public, 4-year or above",2,12,12,305244,365568,670812,305244,365568,670812,Basketball
10892,2015,198507,Elizabeth City State University,Elizabeth City,NC,27909,4,NCAA Division II with football,613,787,1400,1,"Public, 4-year or above",2,15,12,297802,203743,501545,178145,131404,309549,Basketball
28330,2016,198507,Elizabeth City State University,Elizabeth City,NC,27909,4,NCAA Division II with football,533,657,1190,1,"Public, 4-year or above",2,15,15,187084,199915,386999,187084,199915,386999,Basketball
45829,2017,198507,Elizabeth City State University,Elizabeth City,NC,27909,4,NCAA Division II with football,526,647,1173,1,"Public, 4-year or above",2,13,14,205151,221903,427054,205151,221903,427054,Basketball
63544,2018,198507,Elizabeth City State University,Elizabeth City,NC,27909,4,NCAA Division II with football,618,802,1420,1,"Public, 4-year or above",2,17,14,316578,356447,673025,316578,356447,673025,Basketball
108138,2019,198507,Elizabeth City State University,Elizabeth City,NC,27909,4,NCAA Division II with football,650,866,1516,1,"Public, 4-year or above",2,17,14,350406,379964,730370,350406,379965,730371,Basketball
12793,2015,212197,Elizabethtown College,Elizabethtown,PA,170222298,7,NCAA Division III without football,660,1091,1751,2,"Private nonprofit, 4-year or above",2,25,14,153127,104748,257875,153127,104748,257875,Basketball
30248,2016,212197,Elizabethtown College,Elizabethtown,PA,17022,7,NCAA Division III without football,652,1050,1702,2,"Private nonprofit, 4-year or above",2,24,14,154640,109229,263869,154640,109229,263869,Basketball
47745,2017,212197,Elizabethtown College,Elizabethtown,PA,17022,7,NCAA Division III without football,612,1018,1630,2,"Private nonprofit, 4-year or above",2,16,16,111825,132832,244657,111825,132832,244657,Basketball
65497,2018,212197,Elizabethtown College,Elizabethtown,PA,17022,7,NCAA Division III without football,606,980,1586,2,"Private nonprofit, 4-year or above",2,15,14,120600,125146,245746,120600,125146,245746,Basketball
115128,2019,212197,Elizabethtown College,Elizabethtown,PA,17022,7,NCAA Division III without football,585,912,1497,2,"Private nonprofit, 4-year or above",2,18,17,116889,156465,273354,116889,156465,273354,Basketball
3728,2015,144962,Elmhurst College,Elmhurst,IL,601263096,6,NCAA Division III with football,1071,1575,2646,2,"Private nonprofit, 4-year or above",2,20,19,175708,169553,345261,172708,164553,337261,Basketball
21097,2016,144962,Elmhurst College,Elmhurst,IL,60126,6,NCAA Division III with football,1107,1575,2682,2,"Private nonprofit, 4-year or above",2,28,17,180979,184494,365473,177889,177648,355537,Basketball
38554,2017,144962,Elmhurst College,Elmhurst,IL,60126,6,NCAA Division III with football,1062,1629,2691,2,"Private nonprofit, 4-year or above",2,27,20,223207,221069,444276,223207,221069,444276,Basketball
56214,2018,144962,Elmhurst College,Elmhurst,IL,60126,6,NCAA Division III with football,1064,1640,2704,2,"Private nonprofit, 4-year or above",2,18,27,252240,183690,435930,252240,183690,435930,Basketball
83851,2019,144962,Elmhurst College,Elmhurst,IL,60126,6,NCAA Division III with football,1038,1674,2712,2,"Private nonprofit, 4-year or above",2,22,23,228468,195038,423506,228468,195038,423506,Basketball
9695,2015,190983,Elmira College,Elmira,NY,14901,7,NCAA Division III without football,349,774,1123,2,"Private nonprofit, 4-year or above",2,19,17,107378,121958,229336,107378,121958,229336,Basketball
27109,2016,190983,Elmira College,Elmira,NY,14901,7,NCAA Division III without football,305,669,974,2,"Private nonprofit, 4-year or above",2,19,13,93540,104139,197679,93540,104139,197679,Basketball
44595,2017,190983,Elmira College,Elmira,NY,14901,7,NCAA Division III without football,252,581,833,2,"Private nonprofit, 4-year or above",2,18,11,93531,95357,188888,93531,95357,188888,Basketball
62323,2018,190983,Elmira College,Elmira,NY,14901,7,NCAA Division III without football,242,504,746,2,"Private nonprofit, 4-year or above",2,22,13,106974,92450,199424,106974,92450,199424,Basketball
104412,2019,190983,Elmira College,Elmira,NY,14901,7,NCAA Division III without football,259,474,733,2,"Private nonprofit, 4-year or above",2,23,15,87427,95904,183331,87427,95904,183331,Basketball
10901,2015,198516,Elon University,Elon,NC,272442010,1,NCAA Division I-FBS,2356,3379,5735,2,"Private nonprofit, 4-year or above",2,18,27,2099972,1689947,3789919,2099972,1689947,3789919,Basketball
28339,2016,198516,Elon University,Elon,NC,27244,2,NCAA Division I-FCS,2398,3456,5854,2,"Private nonprofit, 4-year or above",2,16,12,1879115,1707578,3586693,1879115,1707575,3586690,Basketball
45838,2017,198516,Elon University,Elon,NC,27244,2,NCAA Division I-FCS,2371,3514,5885,2,"Private nonprofit, 4-year or above",2,16,20,1997371,1740896,3738267,1997371,1740896,3738267,Basketball
63553,2018,198516,Elon University,Elon,NC,27244,2,NCAA Division I-FCS,2419,3610,6029,2,"Private nonprofit, 4-year or above",2,16,26,3221829,1781585,5003414,3221829,1781585,5003414,Basketball
108176,2019,198516,Elon University,Elon,NC,27244,2,NCAA Division I-FCS,2394,3685,6079,2,"Private nonprofit, 4-year or above",2,15,21,2451864,1938804,4390668,2451864,1938804,4390668,Basketball
2773,2015,133553,Embry-Riddle Aeronautical University-Daytona Beach,Daytona Beach,FL,321143900,5,NCAA Division II without football,3945,929,4874,2,"Private nonprofit, 4-year or above",2,14,15,1376725,650344,2027069,1376725,650344,2027069,Basketball
20150,2016,133553,Embry-Riddle Aeronautical University-Daytona Beach,Daytona Beach,FL,32114,5,NCAA Division II without football,3994,1009,5003,2,"Private nonprofit, 4-year or above",2,14,14,1309708,682668,1992376,1296577,674076,1970653,Basketball
37588,2017,133553,Embry-Riddle Aeronautical University-Daytona Beach,Daytona Beach,FL,32114,5,NCAA Division II without football,4198,1172,5370,2,"Private nonprofit, 4-year or above",2,13,15,1481850,743236,2225086,1481771,749127,2230898,Basketball
55234,2018,133553,Embry-Riddle Aeronautical University-Daytona Beach,Daytona Beach,FL,32114,5,NCAA Division II without football,4324,1264,5588,2,"Private nonprofit, 4-year or above",2,18,13,1467655,691440,2159095,1446890,686041,2132931,Basketball
80046,2019,133553,Embry-Riddle Aeronautical University-Daytona Beach,Daytona Beach,FL,32114,5,NCAA Division II without football,4649,1354,6003,2,"Private nonprofit, 4-year or above",2,19,14,1290901,689448,1980349,1290901,689448,1980349,Basketball
6510,2015,165662,Emerson College,Boston,MA,21164624,7,NCAA Division III without football,1496,2236,3732,2,"Private nonprofit, 4-year or above",2,19,13,148550,135392,283942,143715,132347,276062,Basketball
23895,2016,165662,Emerson College,Boston,MA,2116,7,NCAA Division III without football,1501,2232,3733,2,"Private nonprofit, 4-year or above",2,16,11,173935,150782,324717,171021,150782,321803,Basketball
41403,2017,165662,Emerson College,Boston,MA,2116,7,NCAA Division III without football,1522,2226,3748,2,"Private nonprofit, 4-year or above",2,16,12,155361,145639,301000,150549,145479,296028,Basketball
59103,2018,165662,Emerson College,Boston,MA,2116,7,NCAA Division III without football,1509,2268,3777,2,"Private nonprofit, 4-year or above",2,16,10,181559,154725,336284,181559,154725,336284,Basketball
93385,2019,165662,Emerson College,Boston,MA,2116,7,NCAA Division III without football,1478,2349,3827,2,"Private nonprofit, 4-year or above",2,17,12,174955,164640,339595,174955,164640,339595,Basketball
3249,2015,139630,Emmanuel College,Franklin Springs,GA,30639,5,NCAA Division II without football,409,328,737,2,"Private nonprofit, 4-year or above",2,38,19,484447,430758,915205,484447,430758,915205,Basketball
6517,2015,165671,Emmanuel College,Boston,MA,2115,7,NCAA Division III without football,478,1295,1773,2,"Private nonprofit, 4-year or above",2,18,16,89927,141401,231328,89927,105613,195540,Basketball
20616,2016,139630,Emmanuel College,Franklin Springs,GA,30639,5,NCAA Division II without football,387,356,743,2,"Private nonprofit, 4-year or above",2,33,17,462859,389532,852391,462859,389532,852391,Basketball
23902,2016,165671,Emmanuel College,Boston,MA,2115,7,NCAA Division III without football,483,1350,1833,2,"Private nonprofit, 4-year or above",2,14,16,86018,127688,213706,85111,101916,187027,Basketball
38075,2017,139630,Emmanuel College,Franklin Springs,GA,30639,5,NCAA Division II without football,421,354,775,2,"Private nonprofit, 4-year or above",2,40,19,487429,438631,926060,484249,438131,922380,Basketball
41410,2017,165671,Emmanuel College,Boston,MA,2115,7,NCAA Division III without football,498,1305,1803,2,"Private nonprofit, 4-year or above",2,18,12,82505,136388,218893,84733,105442,190175,Basketball
55725,2018,139630,Emmanuel College,Franklin Springs,GA,30639,5,NCAA Division II without football,412,360,772,2,"Private nonprofit, 4-year or above",2,38,22,524052,447688,971740,524052,443444,967496,Basketball
59110,2018,165671,Emmanuel College,Boston,MA,2115,7,NCAA Division III without football,490,1444,1934,2,"Private nonprofit, 4-year or above",2,16,13,87676,128521,216197,87073,97860,184933,Basketball
82093,2019,139630,Emmanuel College,Franklin Springs,GA,30639,5,NCAA Division II without football,437,368,805,2,"Private nonprofit, 4-year or above",2,45,22,473840,467797,941637,441446,463240,904686,Basketball
93423,2019,165671,Emmanuel College,Boston,MA,2115,7,NCAA Division III without football,490,1463,1953,2,"Private nonprofit, 4-year or above",2,16,12,100390,157397,257787,91366,103217,194583,Basketball
15626,2015,232025,Emory & Henry College,Emory,VA,243270947,6,NCAA Division III with football,521,482,1003,2,"Private nonprofit, 4-year or above",2,16,19,158388,206009,364397,158388,206009,364397,Basketball
33097,2016,232025,Emory & Henry College,Emory,VA,24327,6,NCAA Division III with football,492,503,995,2,"Private nonprofit, 4-year or above",2,16,17,189414,214131,403545,189414,214131,403545,Basketball
50639,2017,232025,Emory & Henry College,Emory,VA,24327,6,NCAA Division III with football,470,491,961,2,"Private nonprofit, 4-year or above",2,15,13,230808,260300,491108,230808,260300,491108,Basketball
68388,2018,232025,Emory & Henry College,Emory,VA,24327,6,NCAA Division III with football,453,500,953,2,"Private nonprofit, 4-year or above",2,14,18,204283,262109,466392,204283,262109,466392,Basketball
125468,2019,232025,Emory & Henry College,Emory,VA,24327,6,NCAA Division III with football,481,504,985,2,"Private nonprofit, 4-year or above",2,13,14,183607,195714,379321,183607,195714,379321,Basketball
3263,2015,139658,Emory University,Atlanta,GA,30322,7,NCAA Division III without football,2789,3899,6688,2,"Private nonprofit, 4-year or above",2,17,14,314778,269202,583980,345375,263423,608798,Basketball
20630,2016,139658,Emory University,Atlanta,GA,30322,7,NCAA Division III without football,2716,3923,6639,2,"Private nonprofit, 4-year or above",2,15,13,384897,275373,660270,244147,249280,493427,Basketball
38089,2017,139658,Emory University,Atlanta,GA,30322,7,NCAA Division III without football,2722,3992,6714,2,"Private nonprofit, 4-year or above",2,17,14,325050,262361,587411,313254,277789,591043,Basketball
55741,2018,139658,Emory University,Atlanta,GA,30322,7,NCAA Division III without football,2759,4147,6906,2,"Private nonprofit, 4-year or above",2,14,17,412671,272037,684708,320925,239786,560711,Basketball
82131,2019,139658,Emory University,Atlanta,GA,30322,7,NCAA Division III without football,2799,4140,6939,2,"Private nonprofit, 4-year or above",2,14,13,575648,462896,1038544,348584,232783,581367,Basketball
5205,2015,155025,Emporia State University,Emporia,KS,668015415,4,NCAA Division II with football,1380,2129,3509,1,"Public, 4-year or above",2,16,15,521947,561567,1083514,521947,561567,1083514,Basketball
22565,2016,155025,Emporia State University,Emporia,KS,66801,4,NCAA Division II with football,1288,2082,3370,1,"Public, 4-year or above",2,16,16,523797,532543,1056340,523797,532543,1056340,Basketball
40044,2017,155025,Emporia State University,Emporia,KS,66801,4,NCAA Division II with football,1236,2053,3289,1,"Public, 4-year or above",2,15,14,515585,481791,997376,515585,481791,997376,Basketball
57720,2018,155025,Emporia State University,Emporia,KS,66801,4,NCAA Division II with football,1226,2030,3256,1,"Public, 4-year or above",2,19,15,568563,531854,1100417,568563,531854,1100417,Basketball
88836,2019,155025,Emporia State University,Emporia,KS,66801,4,NCAA Division II with football,1118,1944,3062,1,"Public, 4-year or above",2,17,13,546323,540657,1086980,546323,540657,1086980,Basketball
6525,2015,165699,Endicott College,Beverly,MA,1915,6,NCAA Division III with football,1048,1639,2687,2,"Private nonprofit, 4-year or above",2,15,10,104825,84310,189135,104825,84310,189135,Basketball
23910,2016,165699,Endicott College,Beverly,MA,1915,6,NCAA Division III with football,1090,1693,2783,2,"Private nonprofit, 4-year or above",2,18,14,110226,86720,196946,110226,86720,196946,Basketball
41418,2017,165699,Endicott College,Beverly,MA,1915,6,NCAA Division III with football,1090,1836,2926,2,"Private nonprofit, 4-year or above",2,18,14,143661,79272,222933,143661,79272,222933,Basketball
59118,2018,165699,Endicott College,Beverly,MA,1915,6,NCAA Division III with football,1070,1711,2781,2,"Private nonprofit, 4-year or above",2,18,15,140230,85366,225596,140230,85366,225596,Basketball
93461,2019,165699,Endicott College,Beverly,MA,1915,6,NCAA Division III with football,1038,1760,2798,2,"Private nonprofit, 4-year or above",2,21,20,141636,105366,247002,141636,105366,247002,Basketball
13998,2015,217998,Erskine College,Due West,SC,29639,5,NCAA Division II without football,334,281,615,2,"Private nonprofit, 4-year or above",2,45,21,438797,325348,764145,438797,325348,764145,Basketball
31455,2016,217998,Erskine College,Due West,SC,29639,5,NCAA Division II without football,301,301,602,2,"Private nonprofit, 4-year or above",2,50,29,509937,305579,815516,509937,305579,815516,Basketball
48967,2017,217998,Erskine College,Due West,SC,29639,5,NCAA Division II without football,292,276,568,2,"Private nonprofit, 4-year or above",2,62,23,473662,245022,718684,473662,245022,718684,Basketball
66728,2018,217998,Erskine College,Due West,SC,29639,5,NCAA Division II without football,314,247,561,2,"Private nonprofit, 4-year or above",2,57,28,418918,190512,609430,418918,190512,609430,Basketball
118725,2019,217998,Erskine College,Due West,SC,29639,5,NCAA Division II without football,492,279,771,2,"Private nonprofit, 4-year or above",2,60,23,277781,190949,468730,277781,190949,468730,Basketball
3742,2015,144971,Eureka College,Eureka,IL,61530,6,NCAA Division III with football,302,351,653,2,"Private nonprofit, 4-year or above",2,16,16,80192,47238,127430,80192,47238,127430,Basketball
21111,2016,144971,Eureka College,Eureka,IL,61530,6,NCAA Division III with football,311,333,644,2,"Private nonprofit, 4-year or above",2,21,11,85233,36527,121760,85233,36527,121760,Basketball
38568,2017,144971,Eureka College,Eureka,IL,61530,6,NCAA Division III with football,290,298,588,2,"Private nonprofit, 4-year or above",2,22,11,88073,103507,191580,88073,103507,191580,Basketball
56226,2018,144971,Eureka College,Eureka,IL,61530,6,NCAA Division III with football,286,259,545,2,"Private nonprofit, 4-year or above",2,21,12,109944,63757,173701,109944,63757,173701,Basketball
83862,2019,144971,Eureka College,Eureka,IL,61530,6,NCAA Division III with football,255,223,478,2,"Private nonprofit, 4-year or above",2,18,8,119808,74263,194071,119808,74263,194071,Basketball
2388,2015,129242,Fairfield University,Fairfield,CT,68245195,3,NCAA Division I without football,1473,2229,3702,2,"Private nonprofit, 4-year or above",2,18,15,2590915,1817467,4408382,2590915,1817467,4408382,Basketball
19760,2016,129242,Fairfield University,Fairfield,CT,6824,3,NCAA Division I without football,1494,2308,3802,2,"Private nonprofit, 4-year or above",2,14,12,2582865,1704537,4287402,2582865,1704537,4287402,Basketball
37199,2017,129242,Fairfield University,Fairfield,CT,6824,3,NCAA Division I without football,1541,2338,3879,2,"Private nonprofit, 4-year or above",2,16,15,2843588,1810881,4654469,2843588,1810881,4654469,Basketball
54835,2018,129242,Fairfield University,Fairfield,CT,6824,3,NCAA Division I without football,1581,2407,3988,2,"Private nonprofit, 4-year or above",2,15,15,3280514,1956064,5236578,3280514,1956064,5236578,Basketball
78943,2019,129242,Fairfield University,Fairfield,CT,6824,3,NCAA Division I without football,1679,2480,4159,2,"Private nonprofit, 4-year or above",2,16,15,2633574,1846137,4479711,2633575,1846137,4479712,Basketball
9009,2015,184694,Fairleigh Dickinson University-College at Florham,Madison,NJ,7940,6,NCAA Division III with football,1078,1304,2382,2,"Private nonprofit, 4-year or above",2,13,13,103372,106378,209750,103372,106378,209750,Basketball
26433,2016,184694,Fairleigh Dickinson University-Florham Campus,Madison,NJ,7940,6,NCAA Division III with football,1071,1324,2395,2,"Private nonprofit, 4-year or above",2,17,12,139636,142062,281698,130411,130512,260923,Basketball
43929,2017,184694,Fairleigh Dickinson University-Florham Campus,Madison,NJ,7940,6,NCAA Division III with football,1121,1514,2635,2,"Private nonprofit, 4-year or above",2,17,14,164585,139906,304491,164585,139906,304491,Basketball
61648,2018,184694,Fairleigh Dickinson University-Florham Campus,Madison,NJ,7940,6,NCAA Division III with football,1117,1517,2634,2,"Private nonprofit, 4-year or above",2,15,10,110429,113560,223989,104210,108460,212670,Basketball
102164,2019,184694,Fairleigh Dickinson University-Florham Campus,Madison,NJ,7940,6,NCAA Division III with football,1067,1465,2532,2,"Private nonprofit, 4-year or above",2,16,11,86434,100586,187020,86434,100586,187020,Basketball
8989,2015,184603,Fairleigh Dickinson University-Metropolitan Campus,Teaneck,NJ,7666,3,NCAA Division I without football,1042,1518,2560,2,"Private nonprofit, 4-year or above",2,14,15,1695086,1403658,3098744,1695086,1403658,3098744,Basketball
26413,2016,184603,Fairleigh Dickinson University-Metropolitan Campus,Teaneck,NJ,7666,3,NCAA Division I without football,995,1334,2329,2,"Private nonprofit, 4-year or above",2,14,14,1641556,1378826,3020382,1641556,1378826,3020382,Basketball
43909,2017,184603,Fairleigh Dickinson University-Metropolitan Campus,Teaneck,NJ,7666,3,NCAA Division I without football,972,1393,2365,2,"Private nonprofit, 4-year or above",2,15,15,1682214,1340848,3023062,1682214,1340848,3023062,Basketball
61628,2018,184603,Fairleigh Dickinson University-Metropolitan Campus,Teaneck,NJ,7666,3,NCAA Division I without football,920,1302,2222,2,"Private nonprofit, 4-year or above",2,13,15,1846780,1405249,3252029,1846780,1405249,3252029,Basketball
102088,2019,184603,Fairleigh Dickinson University-Metropolitan Campus,Teaneck,NJ,7666,3,NCAA Division I without football,876,1228,2104,2,"Private nonprofit, 4-year or above",2,13,15,1827543,1335090,3162633,1827543,1335090,3162633,Basketball
16302,2015,237367,Fairmont State University,Fairmont,WV,265542470,4,NCAA Division II with football,1488,1735,3223,1,"Public, 4-year or above",2,16,13,770568,515911,1286479,770568,506374,1276942,Basketball
33775,2016,237367,Fairmont State University,Fairmont,WV,26554,4,NCAA Division II with football,1527,1732,3259,1,"Public, 4-year or above",2,17,12,822156,488947,1311103,822156,488947,1311103,Basketball
51327,2017,237367,Fairmont State University,Fairmont,WV,26554,4,NCAA Division II with football,1424,1663,3087,1,"Public, 4-year or above",2,16,13,796889,505675,1302564,775035,505675,1280710,Basketball
69077,2018,237367,Fairmont State University,Fairmont,WV,26554,4,NCAA Division II with football,1408,1704,3112,1,"Public, 4-year or above",2,17,12,747649,607209,1354858,747649,607209,1354858,Basketball
128078,2019,237367,Fairmont State University,Fairmont,WV,26554,4,NCAA Division II with football,1271,1680,2951,1,"Public, 4-year or above",2,14,13,679514,518347,1197861,594834,417639,1012473,Basketball
10422,2015,196042,Farmingdale State College,Farmingdale,NY,117351021,7,NCAA Division III without football,3742,2504,6246,1,"Public, 4-year or above",2,15,18,79290,80911,160201,79290,80911,160201,Basketball
27847,2016,196042,Farmingdale State College,Farmingdale,NY,11735,7,NCAA Division III without football,4009,2811,6820,1,"Public, 4-year or above",2,17,14,90040,90040,180080,88483,86807,175290,Basketball
45341,2017,196042,Farmingdale State College,Farmingdale,NY,11735,7,NCAA Division III without football,4278,3037,7315,1,"Public, 4-year or above",2,18,14,90458,93458,183916,89915,92260,182175,Basketball
63051,2018,196042,Farmingdale State College,Farmingdale,NY,11735,7,NCAA Division III without football,4451,3124,7575,1,"Public, 4-year or above",2,18,12,92942,94492,187434,92347,91591,183938,Basketball
106527,2019,196042,Farmingdale State College,Farmingdale,NY,11735,7,NCAA Division III without football,4541,3125,7666,1,"Public, 4-year or above",2,25,12,93441,91177,184618,91882,88786,180668,Basketball
10911,2015,198543,Fayetteville State University,Fayetteville,NC,283014298,4,NCAA Division II with football,1297,2583,3880,1,"Public, 4-year or above",2,12,11,227749,239587,467336,227749,239587,467336,Basketball
28351,2016,198543,Fayetteville State University,Fayetteville,NC,28301,4,NCAA Division II with football,1291,2652,3943,1,"Public, 4-year or above",2,13,14,387524,273831,661355,387524,273831,661355,Basketball
45850,2017,198543,Fayetteville State University,Fayetteville,NC,28301,4,NCAA Division II with football,1197,2527,3724,1,"Public, 4-year or above",2,15,15,326756,267759,594515,326756,267759,594515,Basketball
63567,2018,198543,Fayetteville State University,Fayetteville,NC,28301,4,NCAA Division II with football,1219,2624,3843,1,"Public, 4-year or above",2,16,18,471828,351388,823216,471828,351388,823216,Basketball
108219,2019,198543,Fayetteville State University,Fayetteville,NC,28301,4,NCAA Division II with football,1239,2662,3901,1,"Public, 4-year or above",2,13,15,511312,430473,941785,511312,430473,941785,Basketball
8999,2015,184612,Felician University,Rutherford,NJ,7070,5,NCAA Division II without football,402,986,1388,2,"Private nonprofit, 4-year or above",2,16,15,267348,290831,558179,267348,290831,558179,Basketball
26423,2016,184612,Felician University,Rutherford,NJ,7070,5,NCAA Division II without football,404,1028,1432,2,"Private nonprofit, 4-year or above",2,16,18,361094,353876,714970,361094,353876,714970,Basketball
43919,2017,184612,Felician University,Lodi,NJ,7644,5,NCAA Division II without football,437,993,1430,2,"Private nonprofit, 4-year or above",2,15,17,306470,293969,600439,306470,293969,600439,Basketball
61638,2018,184612,Felician University,Lodi,NJ,7644,5,NCAA Division II without football,443,1014,1457,2,"Private nonprofit, 4-year or above",2,15,16,357834,260524,618358,357834,260524,618358,Basketball
102126,2019,184612,Felician University,Lodi,NJ,7644,5,NCAA Division II without football,475,1164,1639,2,"Private nonprofit, 4-year or above",2,17,15,451034,335014,786048,451034,335014,786048,Basketball
7137,2015,169910,Ferris State University,Big Rapids,MI,493072251,4,NCAA Division II with football,4614,4445,9059,1,"Public, 4-year or above",2,16,15,512945,417591,930536,521943,425397,947340,Basketball
15646,2015,232089,Ferrum College,Ferrum,VA,240889000,6,NCAA Division III with football,726,585,1311,2,"Private nonprofit, 4-year or above",2,18,13,109307,114767,224074,109307,114767,224074,Basketball
33118,2016,232089,Ferrum College,Ferrum,VA,24088,6,NCAA Division III with football,705,566,1271,2,"Private nonprofit, 4-year or above",2,16,9,118779,117220,235999,118779,117220,235999,Basketball
50660,2017,232089,Ferrum College,Ferrum,VA,24088,6,NCAA Division III with football,636,474,1110,2,"Private nonprofit, 4-year or above",2,17,15,148294,119116,267410,148294,119116,267410,Basketball
68410,2018,232089,Ferrum College,Ferrum,VA,24088,6,NCAA Division III with football,624,477,1101,2,"Private nonprofit, 4-year or above",2,19,13,168851,157371,326222,168851,157371,326222,Basketball
125544,2019,232089,Ferrum College,Ferrum,VA,24088,6,NCAA Division III with football,593,437,1030,2,"Private nonprofit, 4-year or above",2,28,12,137577,134942,272519,137577,134942,272519,Basketball
7431,2015,172440,Finlandia University,Hancock,MI,499301832,6,NCAA Division III with football,241,227,468,2,"Private nonprofit, 4-year or above",2,16,13,97368,98547,195915,95202,97736,192938,Basketball
24842,2016,172440,Finlandia University,Hancock,MI,49930,6,NCAA Division III with football,228,212,440,2,"Private nonprofit, 4-year or above",2,13,17,104393,83071,187464,104393,83071,187464,Basketball
42342,2017,172440,Finlandia University,Hancock,MI,49930,6,NCAA Division III with football,180,155,335,2,"Private nonprofit, 4-year or above",2,18,13,117964,113781,231745,117964,113781,231745,Basketball
60046,2018,172440,Finlandia University,Hancock,MI,49930,6,NCAA Division III with football,196,174,370,2,"Private nonprofit, 4-year or above",2,13,13,105350,159944,265294,105350,159944,265294,Basketball
96212,2019,172440,Finlandia University,Hancock,MI,49930,6,NCAA Division III with football,192,175,367,2,"Private nonprofit, 4-year or above",2,11,12,177398,248734,426132,177398,248734,426132,Basketball
6542,2015,165820,Fitchburg State University,Fitchburg,MA,14202697,6,NCAA Division III with football,1610,1833,3443,1,"Public, 4-year or above",2,14,12,59092,48531,107623,58793,46998,105791,Basketball
23927,2016,165820,Fitchburg State University,Fitchburg,MA,1420,6,NCAA Division III with football,1621,1801,3422,1,"Public, 4-year or above",2,15,16,50755,50414,101169,50605,49524,100129,Basketball
41438,2017,165820,Fitchburg State University,Fitchburg,MA,1420,6,NCAA Division III with football,1596,1770,3366,1,"Public, 4-year or above",2,17,15,60667,57684,118351,60667,57388,118055,Basketball
59136,2018,165820,Fitchburg State University,Fitchburg,MA,1420,6,NCAA Division III with football,1581,1727,3308,1,"Public, 4-year or above",2,20,14,53991,46536,100527,53991,46536,100527,Basketball
93505,2019,165820,Fitchburg State University,Fitchburg,MA,1420,6,NCAA Division III with football,1509,1636,3145,1,"Public, 4-year or above",2,19,12,55213,33614,88827,55213,33557,88770,Basketball
2807,2015,133711,Flagler College-St Augustine,Saint Augustine,FL,32084,5,NCAA Division II without football,1017,1585,2602,2,"Private nonprofit, 4-year or above",2,13,13,548501,471745,1020246,510859,413915,924774,Basketball
20184,2016,133711,Flagler College-St Augustine,Saint Augustine,FL,32084,5,NCAA Division II without football,943,1596,2539,2,"Private nonprofit, 4-year or above",2,13,12,584004,433069,1017073,523489,383332,906821,Basketball
37624,2017,133711,Flagler College-St Augustine,Saint Augustine,FL,32084,5,NCAA Division II without football,888,1702,2590,2,"Private nonprofit, 4-year or above",2,12,14,514526,484491,999017,513130,478919,992049,Basketball
55270,2018,133711,Flagler College-St Augustine,Saint Augustine,FL,32084,5,NCAA Division II without football,842,1702,2544,2,"Private nonprofit, 4-year or above",2,15,13,518965,483365,1002330,518965,483365,1002330,Basketball
80198,2019,133711,Flagler College-St Augustine,Saint Augustine,FL,32084,5,NCAA Division II without football,909,1896,2805,2,"Private nonprofit, 4-year or above",2,14,15,569862,500843,1070705,589417,514841,1104258,Basketball
2781,2015,133650,Florida Agricultural and Mechanical University,Tallahassee,FL,32307,2,NCAA Division I-FCS,2480,4463,6943,1,"Public, 4-year or above",2,16,14,1068173,1248723,2316896,1068173,1248723,2316896,Basketball
20158,2016,133650,Florida Agricultural and Mechanical University,Tallahassee,FL,32307,2,NCAA Division I-FCS,2297,4307,6604,1,"Public, 4-year or above",2,14,16,892829,832772,1725601,892829,832772,1725601,Basketball
37598,2017,133650,Florida Agricultural and Mechanical University,Tallahassee,FL,32307,2,NCAA Division I-FCS,2361,4491,6852,1,"Public, 4-year or above",2,16,14,733402,672459,1405861,733402,672459,1405861,Basketball
55244,2018,133650,Florida Agricultural and Mechanical University,Tallahassee,FL,32307,2,NCAA Division I-FCS,2389,4535,6924,1,"Public, 4-year or above",2,16,14,1033463,916733,1950196,1033463,916733,1950196,Basketball
80084,2019,133650,Florida Agricultural and Mechanical University,Tallahassee,FL,32307,2,NCAA Division I-FCS,2277,4511,6788,1,"Public, 4-year or above",2,15,13,999869,678062,1677931,999869,678062,1677931,Basketball
2790,2015,133669,Florida Atlantic University,Boca Raton,FL,334310991,1,NCAA Division I-FBS,6938,8732,15670,1,"Public, 4-year or above",2,16,15,1077865,430344,1508209,2598852,1310803,3909655,Basketball
20167,2016,133669,Florida Atlantic University,Boca Raton,FL,33431,1,NCAA Division I-FBS,6964,8751,15715,1,"Public, 4-year or above",2,15,15,2063811,1255556,3319367,2063811,1255556,3319367,Basketball
37607,2017,133669,Florida Atlantic University,Boca Raton,FL,33431,1,NCAA Division I-FBS,7020,8887,15907,1,"Public, 4-year or above",2,15,14,2358998,1838206,4197204,2358998,1838206,4197204,Basketball
55253,2018,133669,Florida Atlantic University,Boca Raton,FL,33431,1,NCAA Division I-FBS,7004,8996,16000,1,"Public, 4-year or above",2,15,14,2352069,1657636,4009705,2352069,1657636,4009705,Basketball
80122,2019,133669,Florida Atlantic University,Boca Raton,FL,33431,1,NCAA Division I-FBS,7112,9109,16221,1,"Public, 4-year or above",2,15,18,2337677,1838805,4176482,2337677,1838805,4176482,Basketball
17176,2015,433660,Florida Gulf Coast University,Fort Myers,FL,339656565,3,NCAA Division I without football,4699,6091,10790,1,"Public, 4-year or above",2,17,17,1723011,1636375,3359386,1723011,1636375,3359386,Basketball
34582,2016,433660,Florida Gulf Coast University,Fort Myers,FL,33965,3,NCAA Division I without football,4743,6066,10809,1,"Public, 4-year or above",2,18,15,1725354,1430374,3155728,1725354,1430374,3155728,Basketball
52187,2017,433660,Florida Gulf Coast University,Fort Myers,FL,33965,3,NCAA Division I without football,4740,6081,10821,1,"Public, 4-year or above",2,19,16,1828996,1706720,3535716,1828996,1706720,3535716,Basketball
69944,2018,433660,Florida Gulf Coast University,Fort Myers,FL,33965,3,NCAA Division I without football,4850,6184,11034,1,"Public, 4-year or above",2,18,19,1589474,1611245,3200719,1589474,1611245,3200719,Basketball
131196,2019,433660,Florida Gulf Coast University,Fort Myers,FL,33965,3,NCAA Division I without football,4796,6232,11028,1,"Public, 4-year or above",2,17,16,1713690,1732471,3446161,1713690,1732471,3446161,Basketball
2820,2015,133881,Florida Institute of Technology,Melbourne,FL,329016975,4,NCAA Division II with football,2261,927,3188,2,"Private nonprofit, 4-year or above",2,17,15,833080,619010,1452090,812972,606066,1419038,Basketball
20197,2016,133881,Florida Institute of Technology,Melbourne,FL,32901,4,NCAA Division II with football,2303,978,3281,2,"Private nonprofit, 4-year or above",2,14,15,838953,648777,1487730,838953,648777,1487730,Basketball
37637,2017,133881,Florida Institute of Technology,Melbourne,FL,32901,4,NCAA Division II with football,2324,938,3262,2,"Private nonprofit, 4-year or above",2,17,17,845207,724739,1569946,825258,712656,1537914,Basketball
55284,2018,133881,Florida Institute of Technology,Melbourne,FL,32901,4,NCAA Division II with football,2325,936,3261,2,"Private nonprofit, 4-year or above",2,18,13,838004,699920,1537924,766139,689334,1455473,Basketball
80274,2019,133881,Florida Institute of Technology,Melbourne,FL,32901,4,NCAA Division II with football,2257,909,3166,2,"Private nonprofit, 4-year or above",2,16,11,852671,624281,1476952,760139,607689,1367828,Basketball
2833,2015,133951,Florida International University,Miami,FL,33199,1,NCAA Division I-FBS,11204,14176,25380,1,"Public, 4-year or above",2,13,13,1760531,1194862,2955393,1773317,1382194,3155511,Basketball
20211,2016,133951,Florida International University,Miami,FL,33199,1,NCAA Division I-FBS,11312,14608,25920,1,"Public, 4-year or above",2,14,14,1570138,1097887,2668025,1814629,1421856,3236485,Basketball
37651,2017,133951,Florida International University,Miami,FL,33199,1,NCAA Division I-FBS,11403,14807,26210,1,"Public, 4-year or above",2,15,11,1849772,1231560,3081332,1846565,1230513,3077078,Basketball
55297,2018,133951,Florida International University,Miami,FL,33199,1,NCAA Division I-FBS,11715,15468,27183,1,"Public, 4-year or above",2,15,11,2004600,1411785,3416385,1951680,1390085,3341765,Basketball
80311,2019,133951,Florida International University,Miami,FL,33199,1,NCAA Division I-FBS,11828,15824,27652,1,"Public, 4-year or above",2,15,14,1958855,184845,2143700,1958855,1958855,3917710,Basketball
2850,2015,134079,Florida Southern College,Lakeland,FL,338015698,5,NCAA Division II without football,841,1433,2274,2,"Private nonprofit, 4-year or above",2,15,12,912265,567677,1479942,911682,567677,1479359,Basketball
20222,2016,134079,Florida Southern College,Lakeland,FL,33801,5,NCAA Division II without football,848,1475,2323,2,"Private nonprofit, 4-year or above",2,15,12,863530,635462,1498992,824321,615651,1439972,Basketball
37668,2017,134079,Florida Southern College,Lakeland,FL,33801,5,NCAA Division II without football,840,1515,2355,2,"Private nonprofit, 4-year or above",2,14,13,947176,627657,1574833,947176,622277,1569453,Basketball
55314,2018,134079,Florida Southern College,Lakeland,FL,33801,5,NCAA Division II without football,901,1616,2517,2,"Private nonprofit, 4-year or above",2,14,14,1021863,680912,1702775,1021863,680912,1702775,Basketball
80358,2019,134079,Florida Southern College,Lakeland,FL,33801,5,NCAA Division II without football,945,1591,2536,2,"Private nonprofit, 4-year or above",2,14,15,937581,685691,1623272,937581,685691,1623272,Basketball
2860,2015,134097,Florida State University,Tallahassee,FL,323061037,1,NCAA Division I-FBS,12699,16232,28931,1,"Public, 4-year or above",2,15,26,12263221,6714989,18978210,11730040,6714989,18445029,Basketball
20232,2016,134097,Florida State University,Tallahassee,FL,32316,1,NCAA Division I-FBS,12689,16362,29051,1,"Public, 4-year or above",2,18,15,13252028,6981167,20233195,11029101,6981167,18010268,Basketball
37679,2017,134097,Florida State University,Tallahassee,FL,32306,1,NCAA Division I-FBS,12663,16524,29187,1,"Public, 4-year or above",2,18,19,17304819,6245942,23550761,11422894,6245942,17668836,Basketball
55325,2018,134097,Florida State University,Tallahassee,FL,32306,1,NCAA Division I-FBS,12263,16635,28898,1,"Public, 4-year or above",2,18,11,16773013,7680432,24453445,16773013,7680432,24453445,Basketball
80371,2019,134097,Florida State University,Tallahassee,FL,32306,1,NCAA Division I-FBS,12557,17211,29768,1,"Public, 4-year or above",2,19,15,13061863,6035984,19097847,10502886,6035984,16538870,Basketball
8159,2015,177418,Fontbonne University,Saint Louis,MO,631053098,7,NCAA Division III without football,302,590,892,2,"Private nonprofit, 4-year or above",2,25,16,78355,100093,178448,67054,85597,152651,Basketball
25583,2016,177418,Fontbonne University,Saint Louis,MO,63105,7,NCAA Division III without football,291,528,819,2,"Private nonprofit, 4-year or above",2,22,15,113429,121223,234652,113500,106863,220363,Basketball
43076,2017,177418,Fontbonne University,Saint Louis,MO,63105,7,NCAA Division III without football,310,447,757,2,"Private nonprofit, 4-year or above",2,24,14,83317,90548,173865,75030,85034,160064,Basketball
60792,2018,177418,Fontbonne University,Saint Louis,MO,63105,7,NCAA Division III without football,318,460,778,2,"Private nonprofit, 4-year or above",2,30,11,115547,113206,228753,103091,106434,209525,Basketball
98942,2019,177418,Fontbonne University,Saint Louis,MO,63105,7,NCAA Division III without football,304,464,768,2,"Private nonprofit, 4-year or above",2,21,15,98854,115214,214068,91370,112714,204084,Basketball
9732,2015,191241,Fordham University,Bronx,NY,10458,2,NCAA Division I-FCS,3622,4664,8286,2,"Private nonprofit, 4-year or above",2,17,16,4126729,3009430,7136159,4126729,3009430,7136159,Basketball
27149,2016,191241,Fordham University,Bronx,NY,10458,2,NCAA Division I-FCS,3745,4980,8725,2,"Private nonprofit, 4-year or above",2,19,16,4436291,3061386,7497677,4436291,3061386,7497677,Basketball
44634,2017,191241,Fordham University,Bronx,NY,10458,2,NCAA Division I-FCS,3856,5205,9061,2,"Private nonprofit, 4-year or above",2,17,14,4549218,3072658,7621876,4549218,3072658,7621876,Basketball
62361,2018,191241,Fordham University,Bronx,NY,10458,2,NCAA Division I-FCS,3900,5175,9075,2,"Private nonprofit, 4-year or above",2,17,18,5075355,3415724,8491079,5075355,3415724,8491079,Basketball
104533,2019,191241,Fordham University,Bronx,NY,10458,2,NCAA Division I-FCS,3954,5187,9141,2,"Private nonprofit, 4-year or above",2,18,16,4860790,3461149,8321939,4860790,3461149,8321939,Basketball
5213,2015,155061,Fort Hays State University,Hays,KS,676014099,4,NCAA Division II with football,2264,3334,5598,1,"Public, 4-year or above",2,16,15,569577,490199,1059776,512595,485309,997904,Basketball
22573,2016,155061,Fort Hays State University,Hays,KS,67601,4,NCAA Division II with football,2344,3329,5673,1,"Public, 4-year or above",2,14,15,689129,553946,1243075,629915,493905,1123820,Basketball
40052,2017,155061,Fort Hays State University,Hays,KS,67601,4,NCAA Division II with football,2403,3371,5774,1,"Public, 4-year or above",2,13,15,538138,521641,1059779,584307,542590,1126897,Basketball
57728,2018,155061,Fort Hays State University,Hays,KS,67601,4,NCAA Division II with football,2321,3414,5735,1,"Public, 4-year or above",2,14,14,551942,477533,1029475,478626,404216,882842,Basketball
88874,2019,155061,Fort Hays State University,Hays,KS,67601,4,NCAA Division II with football,2273,3349,5622,1,"Public, 4-year or above",2,14,14,584052,536535,1120587,527756,461452,989208,Basketball
2228,2015,127185,Fort Lewis College,Durango,CO,813013999,4,NCAA Division II with football,1630,1708,3338,1,"Public, 4-year or above",2,20,18,566608,484952,1051560,558220,447235,1005455,Basketball
19597,2016,127185,Fort Lewis College,Durango,CO,81301,4,NCAA Division II with football,1559,1578,3137,1,"Public, 4-year or above",2,17,16,516651,424007,940658,493902,398373,892275,Basketball
37035,2017,127185,Fort Lewis College,Durango,CO,81301,4,NCAA Division II with football,1383,1506,2889,1,"Public, 4-year or above",2,16,16,552561,492682,1045243,552561,492682,1045243,Basketball
54673,2018,127185,Fort Lewis College,Durango,CO,81301,4,NCAA Division II with football,1371,1491,2862,1,"Public, 4-year or above",2,17,17,633969,430523,1064492,630324,422272,1052596,Basketball
78461,2019,127185,Fort Lewis College,Durango,CO,81301,4,NCAA Division II with football,1320,1518,2838,1,"Public, 4-year or above",2,16,17,659446,377304,1036750,659446,371378,1030824,Basketball
3274,2015,139719,Fort Valley State University,Fort Valley,GA,310304313,4,NCAA Division II with football,859,1124,1983,1,"Public, 4-year or above",2,17,14,211042,125665,336707,211042,125665,336707,Basketball
20641,2016,139719,Fort Valley State University,Fort Valley,GA,31030,4,NCAA Division II with football,845,1148,1993,1,"Public, 4-year or above",2,20,17,115176,99416,214592,189093,96691,285784,Basketball
38100,2017,139719,Fort Valley State University,Fort Valley,GA,31030,4,NCAA Division II with football,878,1234,2112,1,"Public, 4-year or above",2,16,12,211281,144230,355511,211281,144230,355511,Basketball
55752,2018,139719,Fort Valley State University,Fort Valley,GA,31030,4,NCAA Division II with football,861,1287,2148,1,"Public, 4-year or above",2,23,21,228438,171819,400257,215024,161730,376754,Basketball
82206,2019,139719,Fort Valley State University,Fort Valley,GA,31030,4,NCAA Division II with football,794,1262,2056,1,"Public, 4-year or above",2,20,18,169122,118505,287627,324588,265787,590375,Basketball
6553,2015,165866,Framingham State University,Framingham,MA,17019101,6,NCAA Division III with football,1365,2431,3796,1,"Public, 4-year or above",2,16,14,67489,98474,165963,62781,73428,136209,Basketball
23938,2016,165866,Framingham State University,Framingham,MA,1701,6,NCAA Division III with football,1436,2234,3670,1,"Public, 4-year or above",2,16,12,74918,99401,174319,60727,78681,139408,Basketball
41450,2017,165866,Framingham State University,Framingham,MA,1701,6,NCAA Division III with football,1460,2073,3533,1,"Public, 4-year or above",2,16,15,64814,103143,167957,56046,98210,154256,Basketball
59148,2018,165866,Framingham State University,Framingham,MA,1701,6,NCAA Division III with football,1439,1961,3400,1,"Public, 4-year or above",2,19,16,67302,90641,157943,55874,80061,135935,Basketball
93517,2019,165866,Framingham State University,Framingham,MA,1701,6,NCAA Division III with football,1455,1904,3359,1,"Public, 4-year or above",2,25,16,76100,95743,171843,58402,85743,144145,Basketball
14009,2015,218061,Francis Marion University,Florence,SC,29506,5,NCAA Division II without football,997,2109,3106,1,"Public, 4-year or above",2,15,15,433679,464965,898644,433679,464965,898644,Basketball
31466,2016,218061,Francis Marion University,Florence,SC,29506,5,NCAA Division II without football,969,2109,3078,1,"Public, 4-year or above",2,14,15,406111,482353,888464,409620,494950,904570,Basketball
48978,2017,218061,Francis Marion University,Florence,SC,29506,5,NCAA Division II without football,936,2016,2952,1,"Public, 4-year or above",2,15,17,436494,482132,918626,440411,483414,923825,Basketball
66739,2018,218061,Francis Marion University,Florence,SC,29506,5,NCAA Division II without football,912,1967,2879,1,"Public, 4-year or above",2,30,17,460916,436555,897471,460916,436151,897067,Basketball
118801,2019,218061,Francis Marion University,Florence,SC,29506,5,NCAA Division II without football,923,1958,2881,1,"Public, 4-year or above",2,33,16,516234,469580,985814,516133,471135,987268,Basketball
11887,2015,205957,Franciscan University of Steubenville,Steubenville,OH,439521763,7,NCAA Division III without football,778,1222,2000,2,"Private nonprofit, 4-year or above",2,12,12,65724,58533,124257,65724,58533,124257,Basketball
29329,2016,205957,Franciscan University of Steubenville,Steubenville,OH,43952,7,NCAA Division III without football,777,1209,1986,2,"Private nonprofit, 4-year or above",2,12,9,66515,58498,125013,66515,58498,125013,Basketball
46832,2017,205957,Franciscan University of Steubenville,Steubenville,OH,43952,7,NCAA Division III without football,803,1198,2001,2,"Private nonprofit, 4-year or above",2,24,8,58869,53233,112102,58869,53233,112102,Basketball
64574,2018,205957,Franciscan University of Steubenville,Steubenville,OH,43952,7,NCAA Division III without football,808,1222,2030,2,"Private nonprofit, 4-year or above",2,21,12,65682,48782,114464,65682,48782,114464,Basketball
111697,2019,205957,Franciscan University of Steubenville,Steubenville,OH,43952,7,NCAA Division III without football,841,1209,2050,2,"Private nonprofit, 4-year or above",2,25,12,77545,53441,130986,77545,53441,130986,Basketball
12805,2015,212577,Franklin and Marshall College,Lancaster,PA,176043003,6,NCAA Division III with football,1065,1148,2213,2,"Private nonprofit, 4-year or above",2,15,11,250867,155168,406035,250866,155168,406034,Basketball
30260,2016,212577,Franklin and Marshall College,Lancaster,PA,17604,6,NCAA Division III with football,1044,1178,2222,2,"Private nonprofit, 4-year or above",2,12,14,249176,176495,425671,249176,176495,425671,Basketball
47757,2017,212577,Franklin and Marshall College,Lancaster,PA,17604,6,NCAA Division III with football,1037,1226,2263,2,"Private nonprofit, 4-year or above",2,17,13,286780,176526,463306,286282,176326,462608,Basketball
65509,2018,212577,Franklin and Marshall College,Lancaster,PA,17604,6,NCAA Division III with football,1029,1261,2290,2,"Private nonprofit, 4-year or above",2,15,12,273061,189751,462812,273061,189751,462812,Basketball
115166,2019,212577,Franklin and Marshall College,Lancaster,PA,17604,6,NCAA Division III with football,1041,1265,2306,2,"Private nonprofit, 4-year or above",2,16,11,299590,182383,481973,297912,181883,479795,Basketball
4394,2015,150604,Franklin College,Franklin,IN,461312623,6,NCAA Division III with football,483,529,1012,2,"Private nonprofit, 4-year or above",2,19,14,159084,92035,251119,158145,92092,250237,Basketball
21765,2016,150604,Franklin College,Franklin,IN,46131,6,NCAA Division III with football,467,491,958,2,"Private nonprofit, 4-year or above",2,15,18,157549,90009,247558,156749,90009,246758,Basketball
39235,2017,150604,Franklin College,Franklin,IN,46131,6,NCAA Division III with football,460,501,961,2,"Private nonprofit, 4-year or above",2,17,16,159162,91109,250271,158085,92267,250352,Basketball
56894,2018,150604,Franklin College,Franklin,IN,46131,6,NCAA Division III with football,442,468,910,2,"Private nonprofit, 4-year or above",2,20,18,166676,94478,261154,169204,94378,263582,Basketball
86173,2019,150604,Franklin College,Franklin,IN,46131,6,NCAA Division III with football,416,460,876,2,"Private nonprofit, 4-year or above",2,17,18,146365,103889,250254,134141,110733,244874,Basketball
8798,2015,182795,Franklin Pierce University,Rindge,NH,34610060,5,NCAA Division II without football,704,760,1464,2,"Private nonprofit, 4-year or above",2,17,13,572301,578356,1150657,552271,557841,1110112,Basketball
26223,2016,182795,Franklin Pierce University,Rindge,NH,3461,5,NCAA Division II without football,737,843,1580,2,"Private nonprofit, 4-year or above",2,17,12,607937,550021,1157958,594838,515268,1110106,Basketball
43718,2017,182795,Franklin Pierce University,Rindge,NH,3461,5,NCAA Division II without football,711,851,1562,2,"Private nonprofit, 4-year or above",2,17,12,643034,543079,1186113,636438,534906,1171344,Basketball
61436,2018,182795,Franklin Pierce University,Rindge,NH,3461,5,NCAA Division II without football,686,802,1488,2,"Private nonprofit, 4-year or above",2,15,11,648667,614522,1263189,648667,614522,1263189,Basketball
101336,2019,182795,Franklin Pierce University,Rindge,NH,3461,5,NCAA Division II without football,667,783,1450,2,"Private nonprofit, 4-year or above",2,17,13,667089,584020,1251109,667089,584020,1251109,Basketball
1258,2015,114813,Fresno Pacific University,Fresno,CA,937024709,5,NCAA Division II without football,568,1382,1950,2,"Private nonprofit, 4-year or above",2,17,18,548521,429263,977784,530673,421991,952664,Basketball
18616,2016,114813,Fresno Pacific University,Fresno,CA,93702,5,NCAA Division II without football,604,1470,2074,2,"Private nonprofit, 4-year or above",2,19,16,591378,543213,1134591,570000,536004,1106004,Basketball
36051,2017,114813,Fresno Pacific University,Fresno,CA,93702,5,NCAA Division II without football,685,1657,2342,2,"Private nonprofit, 4-year or above",2,14,15,596959,584301,1181260,588464,566781,1155245,Basketball
53671,2018,114813,Fresno Pacific University,Fresno,CA,93702,5,NCAA Division II without football,663,1782,2445,2,"Private nonprofit, 4-year or above",2,17,16,600729,561651,1162380,581214,552649,1133863,Basketball
74942,2019,114813,Fresno Pacific University,Fresno,CA,93702,5,NCAA Division II without football,622,1811,2433,2,"Private nonprofit, 4-year or above",2,21,13,665347,625714,1291061,659132,614963,1274095,Basketball
6098,2015,162584,Frostburg State University,Frostburg,MD,215321099,6,NCAA Division III with football,2172,1950,4122,1,"Public, 4-year or above",2,20,14,195131,207005,402136,195131,207005,402136,Basketball
23483,2016,162584,Frostburg State University,Frostburg,MD,21532,6,NCAA Division III with football,2122,1965,4087,1,"Public, 4-year or above",2,16,13,166630,125055,291685,166630,125055,291685,Basketball
40987,2017,162584,Frostburg State University,Frostburg,MD,21532,6,NCAA Division III with football,2005,1794,3799,1,"Public, 4-year or above",2,16,13,177039,138238,315277,177039,138238,315277,Basketball
58677,2018,162584,Frostburg State University,Frostburg,MD,21532,6,NCAA Division III with football,1947,1730,3677,1,"Public, 4-year or above",2,21,14,176065,137326,313391,176065,137326,313391,Basketball
92092,2019,162584,Frostburg State University,Frostburg,MD,21532,6,NCAA Division III with football,1799,1615,3414,1,"Public, 4-year or above",2,19,16,184471,135751,320222,184471,135751,320222,Basketball
48986,2017,218070,Furman,Greenville,SC,29613,2,NCAA Division I-FCS,1087,1568,2655,2,"Private nonprofit, 4-year or above",2,16,14,2763225,1834638,4597863,2301306,1703395,4004701,Basketball
66747,2018,218070,Furman,Greenville,SC,29613,2,NCAA Division I-FCS,1069,1579,2648,2,"Private nonprofit, 4-year or above",2,15,16,2576740,1802659,4379399,2293070,1746267,4039337,Basketball
14017,2015,218070,Furman University,Greenville,SC,296136162,2,NCAA Division I-FCS,1129,1487,2616,2,"Private nonprofit, 4-year or above",2,16,14,2126533,1652084,3778617,2179662,1543350,3723012,Basketball
31474,2016,218070,Furman University,Greenville,SC,29613,2,NCAA Division I-FCS,1112,1579,2691,2,"Private nonprofit, 4-year or above",2,15,14,2421923,1726767,4148690,2092284,1463368,3555652,Basketball
118839,2019,218070,Furman University,Greenville,SC,29613,2,NCAA Division I-FCS,1024,1575,2599,2,"Private nonprofit, 4-year or above",2,14,15,2641515,1739321,4380836,2641515,1739321,4380836,Basketball
2634,2015,131450,Gallaudet University,Washington,DC,200023695,6,NCAA Division III with football,458,501,959,2,"Private nonprofit, 4-year or above",2,17,13,161743,105584,267327,153931,99144,253075,Basketball
20007,2016,131450,Gallaudet University,Washington,DC,20002,6,NCAA Division III with football,524,558,1082,2,"Private nonprofit, 4-year or above",2,15,12,141607,109899,251506,134743,107418,242161,Basketball
37446,2017,131450,Gallaudet University,Washington,DC,20002,6,NCAA Division III with football,470,604,1074,2,"Private nonprofit, 4-year or above",2,14,13,146795,136160,282955,137972,127337,265309,Basketball
55090,2018,131450,Gallaudet University,Washington,DC,20002,6,NCAA Division III with football,491,575,1066,2,"Private nonprofit, 4-year or above",2,15,17,141389,133087,274476,140428,133782,274210,Basketball
79532,2019,131450,Gallaudet University,Washington,DC,20002,6,NCAA Division III with football,460,545,1005,2,"Private nonprofit, 4-year or above",2,17,13,141574,134875,276449,131027,129751,260778,Basketball
12822,2015,212601,Gannon University,Erie,PA,165410001,4,NCAA Division II with football,1135,1388,2523,2,"Private nonprofit, 4-year or above",2,18,14,825388,711337,1536725,816430,686285,1502715,Basketball
30277,2016,212601,Gannon University,Erie,PA,16541,4,NCAA Division II with football,1101,1370,2471,2,"Private nonprofit, 4-year or above",2,15,13,776768,643948,1420716,746970,638005,1384975,Basketball
47774,2017,212601,Gannon University,Erie,PA,16541,4,NCAA Division II with football,1094,1416,2510,2,"Private nonprofit, 4-year or above",2,16,14,890562,709221,1599783,803087,665426,1468513,Basketball
65526,2018,212601,Gannon University,Erie,PA,16541,4,NCAA Division II with football,1092,1552,2644,2,"Private nonprofit, 4-year or above",2,19,15,814499,737201,1551700,792823,705932,1498755,Basketball
115182,2019,212601,Gannon University,Erie,PA,16541,4,NCAA Division II with football,1098,1666,2764,2,"Private nonprofit, 4-year or above",2,16,14,776236,780346,1556582,761195,749386,1510581,Basketball
10920,2015,198561,Gardner-Webb University,Boiling Springs,NC,280170997,2,NCAA Division I-FCS,790,1306,2096,2,"Private nonprofit, 4-year or above",2,17,17,1505676,984352,2490028,1505676,984352,2490028,Basketball
28360,2016,198561,Gardner-Webb University,Boiling Springs,NC,28017,2,NCAA Division I-FCS,742,1166,1908,2,"Private nonprofit, 4-year or above",2,14,13,1189273,966915,2156188,1189273,966915,2156188,Basketball
45859,2017,198561,Gardner-Webb University,Boiling Springs,NC,28017,2,NCAA Division I-FCS,662,1119,1781,2,"Private nonprofit, 4-year or above",2,16,17,1192668,943833,2136501,1192668,943833,2136501,Basketball
63578,2018,198561,Gardner-Webb University,Boiling Springs,NC,28017,2,NCAA Division I-FCS,623,1017,1640,2,"Private nonprofit, 4-year or above",2,13,14,1195668,945822,2141490,1195668,950121,2145789,Basketball
108257,2019,198561,Gardner-Webb University,Boiling Springs,NC,28017,2,NCAA Division I-FCS,626,1006,1632,2,"Private nonprofit, 4-year or above",2,17,15,1230646,1045481,2276127,1230646,1045481,2276127,Basketball
12835,2015,212656,Geneva College,Beaver Falls,PA,150103599,6,NCAA Division III with football,685,691,1376,2,"Private nonprofit, 4-year or above",2,19,16,186169,104856,291025,180030,109374,289404,Basketball
30291,2016,212656,Geneva College,Beaver Falls,PA,15010,6,NCAA Division III with football,652,652,1304,2,"Private nonprofit, 4-year or above",2,20,14,146798,117723,264521,146798,117723,264521,Basketball
47788,2017,212656,Geneva College,Beaver Falls,PA,15010,6,NCAA Division III with football,649,595,1244,2,"Private nonprofit, 4-year or above",2,18,15,144825,101793,246618,144825,101793,246618,Basketball
65540,2018,212656,Geneva College,Beaver Falls,PA,15010,6,NCAA Division III with football,641,537,1178,2,"Private nonprofit, 4-year or above",2,18,15,131162,105124,236286,131162,105124,236286,Basketball
115220,2019,212656,Geneva College,Beaver Falls,PA,15010,6,NCAA Division III with football,605,507,1112,2,"Private nonprofit, 4-year or above",2,14,15,176843,118853,295696,174665,108816,283481,Basketball
12313,2015,208822,George Fox University,Newberg,OR,97132,6,NCAA Division III with football,1048,1310,2358,2,"Private nonprofit, 4-year or above",2,14,26,288580,307975,596555,283679,300207,583886,Basketball
29757,2016,208822,George Fox University,Newberg,OR,97132,6,NCAA Division III with football,1102,1372,2474,2,"Private nonprofit, 4-year or above",2,16,30,205529,277375,482904,186337,264628,450965,Basketball
47252,2017,208822,George Fox University,Newberg,OR,97132,6,NCAA Division III with football,1083,1411,2494,2,"Private nonprofit, 4-year or above",2,16,17,211732,271587,483319,203102,266991,470093,Basketball
64996,2018,208822,George Fox University,Newberg,OR,97132,6,NCAA Division III with football,1040,1443,2483,2,"Private nonprofit, 4-year or above",2,11,19,222905,269260,492165,216883,264796,481679,Basketball
113384,2019,208822,George Fox University,Newberg,OR,97132,6,NCAA Division III with football,1019,1409,2428,2,"Private nonprofit, 4-year or above",2,15,17,242320,296144,538464,242320,296144,538464,Basketball
15659,2015,232186,George Mason University,Fairfax,VA,220304444,3,NCAA Division I without football,8760,9469,18229,1,"Public, 4-year or above",2,15,14,3342681,1845391,5188072,3342681,1845391,5188072,Basketball
33131,2016,232186,George Mason University,Fairfax,VA,22030,3,NCAA Division I without football,9209,9815,19024,1,"Public, 4-year or above",2,14,15,3515918,2091400,5607318,3515918,2091400,5607318,Basketball
50674,2017,232186,George Mason University,Fairfax,VA,22030,3,NCAA Division I without football,9773,10250,20023,1,"Public, 4-year or above",2,14,15,4032773,2516158,6548931,4032773,2516158,6548931,Basketball
68424,2018,232186,George Mason University,Fairfax,VA,22030,3,NCAA Division I without football,10429,10546,20975,1,"Public, 4-year or above",2,17,13,4287689,2346424,6634113,4287689,2346424,6634113,Basketball
125581,2019,232186,George Mason University,Fairfax,VA,22030,3,NCAA Division I without football,10714,10719,21433,1,"Public, 4-year or above",2,15,15,4725888,2692178,7418066,4725888,2692178,7418066,Basketball
2643,2015,131469,George Washington University,Washington,DC,20052,3,NCAA Division I without football,4295,5783,10078,2,"Private nonprofit, 4-year or above",2,13,17,2915197,2601610,5516807,2915197,2601610,5516807,Basketball
20016,2016,131469,George Washington University,Washington,DC,20052,3,NCAA Division I without football,4333,6010,10343,2,"Private nonprofit, 4-year or above",2,14,13,2943015,2594860,5537875,2943015,2594860,5537875,Basketball
37455,2017,131469,George Washington University,Washington,DC,20052,3,NCAA Division I without football,4253,6550,10803,2,"Private nonprofit, 4-year or above",2,16,15,3191582,2811586,6003168,3191582,2811586,6003168,Basketball
55099,2018,131469,George Washington University,Washington,DC,20052,3,NCAA Division I without football,4289,6947,11236,2,"Private nonprofit, 4-year or above",2,14,13,3548937,2518181,6067118,3548937,2518181,6067118,Basketball
79570,2019,131469,George Washington University,Washington,DC,20052,3,NCAA Division I without football,4165,6843,11008,2,"Private nonprofit, 4-year or above",2,19,16,4261344,2608108,6869452,4261344,2608108,6869452,Basketball
2660,2015,131496,Georgetown University,Washington,DC,200570001,2,NCAA Division I-FCS,3126,3828,6954,2,"Private nonprofit, 4-year or above",2,13,15,11343826,2863619,14207445,11343826,2863619,14207445,Basketball
20031,2016,131496,Georgetown University,Washington,DC,20057,2,NCAA Division I-FCS,3016,3858,6874,2,"Private nonprofit, 4-year or above",2,14,15,17702377,2761286,20463663,17702377,2761286,20463663,Basketball
37470,2017,131496,Georgetown University,Washington,DC,20057,2,NCAA Division I-FCS,3074,3876,6950,2,"Private nonprofit, 4-year or above",2,14,14,12849462,2739532,15588994,12849462,2739532,15588994,Basketball
55114,2018,131496,Georgetown University,Washington,DC,20057,2,NCAA Division I-FCS,3032,3920,6952,2,"Private nonprofit, 4-year or above",2,15,16,13573946,3083397,16657343,13573946,3083397,16657343,Basketball
79608,2019,131496,Georgetown University,Washington,DC,20057,2,NCAA Division I-FCS,3054,3934,6988,2,"Private nonprofit, 4-year or above",2,16,16,13814000,3178533,16992533,13814000,3178533,16992533,Basketball
38124,2017,139861,Georgia College & State University,Milledgeville,GA,31061,5,NCAA Division II without football,2013,3398,5411,1,"Public, 4-year or above",2,15,16,310900,309000,619900,310898,308973,619871,Basketball
55776,2018,139861,Georgia College & State University,Milledgeville,GA,31061,5,NCAA Division II without football,1972,3406,5378,1,"Public, 4-year or above",2,15,18,334299,327210,661509,334299,327209,661508,Basketball
82289,2019,139861,Georgia College & State University,Milledgeville,GA,31061,5,NCAA Division II without football,1910,3422,5332,1,"Public, 4-year or above",2,15,18,311531,265689,577220,330887,287195,618082,Basketball
3298,2015,139861,Georgia College and State University,Milledgeville,GA,31061,5,NCAA Division II without football,2201,3346,5547,1,"Public, 4-year or above",2,10,13,389181,367120,756301,379018,362560,741578,Basketball
20664,2016,139861,Georgia College and State University,Milledgeville,GA,31061,5,NCAA Division II without football,2110,3409,5519,1,"Public, 4-year or above",2,18,18,455470,514616,970086,486820,525555,1012375,Basketball
3282,2015,139755,Georgia Institute of Technology-Main Campus,Atlanta,GA,303320530,1,NCAA Division I-FBS,8726,4846,13572,1,"Public, 4-year or above",2,14,16,6234500,532520,6767020,6329728,3880740,10210468,Basketball
20648,2016,139755,Georgia Institute of Technology-Main Campus,Atlanta,GA,30332,1,NCAA Division I-FBS,8594,5104,13698,1,"Public, 4-year or above",2,16,14,7284387,587337,7871724,8891673,4592090,13483763,Basketball
38108,2017,139755,Georgia Institute of Technology-Main Campus,Atlanta,GA,30332,1,NCAA Division I-FBS,8510,5343,13853,1,"Public, 4-year or above",2,16,14,7696021,483280,8179301,8627469,4177120,12804589,Basketball
55760,2018,139755,Georgia Institute of Technology-Main Campus,Atlanta,GA,30332,1,NCAA Division I-FBS,8654,5495,14149,1,"Public, 4-year or above",2,18,14,6910271,446523,7356794,7095493,4454899,11550392,Basketball
82213,2019,139755,Georgia Institute of Technology-Main Campus,Atlanta,GA,30332,1,NCAA Division I-FBS,8508,5624,14132,1,"Public, 4-year or above",2,17,12,6063195,763946,6827141,7318594,4571541,11890135,Basketball
3306,2015,139931,Georgia Southern University,Statesboro,GA,30460,1,NCAA Division I-FBS,7909,7881,15790,1,"Public, 4-year or above",2,19,14,688625,288167,976792,1361765,893630,2255395,Basketball
20672,2016,139931,Georgia Southern University,Statesboro,GA,30460,1,NCAA Division I-FBS,7842,8070,15912,1,"Public, 4-year or above",2,18,15,1712860,1112678,2825538,1712860,1112678,2825538,Basketball
38132,2017,139931,Georgia Southern University,Statesboro,GA,30460,1,NCAA Division I-FBS,7763,7919,15682,1,"Public, 4-year or above",2,19,14,1671994,1069672,2741666,1671994,1069672,2741666,Basketball
55784,2018,139931,Georgia Southern University,Statesboro,GA,30460,1,NCAA Division I-FBS,8848,10482,19330,1,"Public, 4-year or above",2,19,14,1505129,1336954,2842083,1505129,1336954,2842083,Basketball
82297,2019,139931,Georgia Southern University,Statesboro,GA,30460,1,NCAA Division I-FBS,8415,10579,18994,1,"Public, 4-year or above",2,17,15,869288,171331,1040619,1622981,1257367,2880348,Basketball
3291,2015,139764,Georgia Southwestern State University,Americus,GA,317094693,5,NCAA Division II without football,606,1032,1638,1,"Public, 4-year or above",2,13,16,244637,214917,459554,244637,214917,459554,Basketball
20657,2016,139764,Georgia Southwestern State University,Americus,GA,31709,5,NCAA Division II without football,669,1090,1759,1,"Public, 4-year or above",2,15,13,238080,245798,483878,238080,245798,483878,Basketball
38117,2017,139764,Georgia Southwestern State University,Americus,GA,31709,5,NCAA Division II without football,668,1091,1759,1,"Public, 4-year or above",2,13,16,243484,257000,500484,243484,257000,500484,Basketball
55769,2018,139764,Georgia Southwestern State University,Americus,GA,31709,5,NCAA Division II without football,605,1051,1656,1,"Public, 4-year or above",2,14,16,273271,278336,551607,273271,278336,551607,Basketball
82251,2019,139764,Georgia Southwestern State University,Americus,GA,31709,5,NCAA Division II without football,599,1024,1623,1,"Public, 4-year or above",2,16,15,295063,318563,613626,295063,318563,613626,Basketball
3317,2015,139940,Georgia State University,Atlanta,GA,303033083,1,NCAA Division I-FBS,7573,11079,18652,1,"Public, 4-year or above",2,15,26,2261334,1580214,3841548,2261334,1580214,3841548,Basketball
20683,2016,139940,Georgia State University,Atlanta,GA,30303,1,NCAA Division I-FBS,7725,11337,19062,1,"Public, 4-year or above",2,15,22,2421793,1635321,4057114,2421793,1635321,4057114,Basketball
38143,2017,139940,Georgia State University,Atlanta,GA,30303,1,NCAA Division I-FBS,7989,11742,19731,1,"Public, 4-year or above",2,16,20,2555552,1658328,4213880,2555552,1658328,4213880,Basketball
55795,2018,139940,Georgia State University,Atlanta,GA,30303,1,NCAA Division I-FBS,8556,12343,20899,1,"Public, 4-year or above",2,15,17,2917278,1727147,4644425,2917278,1727147,4644425,Basketball
82335,2019,139940,Georgia State University,Atlanta,GA,30315,1,NCAA Division I-FBS,8903,12912,21815,1,"Public, 4-year or above",2,15,16,2628401,1839837,4468238,2628401,1839837,4468238,Basketball
9020,2015,184773,Georgian Court University,Lakewood,NJ,87012697,5,NCAA Division II without football,290,959,1249,2,"Private nonprofit, 4-year or above",2,16,12,558325,473773,1032098,553317,459506,1012823,Basketball
26444,2016,184773,Georgian Court University,Lakewood,NJ,8701,5,NCAA Division II without football,337,982,1319,2,"Private nonprofit, 4-year or above",2,17,13,543246,416738,959984,536506,418109,954615,Basketball
43940,2017,184773,Georgian Court University,Lakewood,NJ,8701,5,NCAA Division II without football,358,985,1343,2,"Private nonprofit, 4-year or above",2,15,14,565154,500954,1066108,562265,500954,1063219,Basketball
61659,2018,184773,Georgian Court University,Lakewood,NJ,8701,5,NCAA Division II without football,386,1031,1417,2,"Private nonprofit, 4-year or above",2,15,19,510015,585826,1095841,510694,578061,1088755,Basketball
102176,2019,184773,Georgian Court University,Lakewood,NJ,8701,5,NCAA Division II without football,362,1055,1417,2,"Private nonprofit, 4-year or above",2,19,16,614170,506054,1120224,613045,513013,1126058,Basketball
12843,2015,212674,Gettysburg College,Gettysburg,PA,17325,6,NCAA Division III with football,1150,1281,2431,2,"Private nonprofit, 4-year or above",2,13,14,137832,161126,298958,137832,161126,298958,Basketball
30299,2016,212674,Gettysburg College,Gettysburg,PA,17325,6,NCAA Division III with football,1117,1261,2378,2,"Private nonprofit, 4-year or above",2,16,14,152732,137306,290038,152732,137306,290038,Basketball
47796,2017,212674,Gettysburg College,Gettysburg,PA,17325,6,NCAA Division III with football,1139,1265,2404,2,"Private nonprofit, 4-year or above",2,18,15,158155,139424,297579,158155,139424,297579,Basketball
65548,2018,212674,Gettysburg College,Gettysburg,PA,17325,6,NCAA Division III with football,1161,1272,2433,2,"Private nonprofit, 4-year or above",2,16,16,152631,130389,283020,152631,130389,283020,Basketball
115258,2019,212674,Gettysburg College,Gettysburg,PA,17325,6,NCAA Division III with football,1139,1228,2367,2,"Private nonprofit, 4-year or above",2,20,16,215503,143165,358668,215503,143165,358668,Basketball
16313,2015,237385,Glenville State College,Glenville,WV,263511292,4,NCAA Division II with football,589,452,1041,1,"Public, 4-year or above",2,15,16,387050,265349,652399,386335,264783,651118,Basketball
33786,2016,237385,Glenville State College,Glenville,WV,26351,4,NCAA Division II with football,564,490,1054,1,"Public, 4-year or above",2,14,18,367964,308775,676739,367158,308049,675207,Basketball
51338,2017,237385,Glenville State College,Glenville,WV,26351,4,NCAA Division II with football,577,452,1029,1,"Public, 4-year or above",2,16,17,426524,504723,931247,366869,355260,722129,Basketball
69088,2018,237385,Glenville State College,Glenville,WV,26351,4,NCAA Division II with football,541,463,1004,1,"Public, 4-year or above",2,17,21,587256,486141,1073397,586770,470865,1057635,Basketball
128090,2019,237385,Glenville State College,Glenville,WV,26351,4,NCAA Division II with football,553,434,987,1,"Public, 4-year or above",2,15,17,352654,365480,718134,352624,365344,717968,Basketball
2582,2015,130989,Goldey-Beacom College,Wilmington,DE,19808,5,NCAA Division II without football,218,296,514,2,"Private nonprofit, 4-year or above",2,14,15,263927,184509,448436,220698,173592,394290,Basketball
19953,2016,130989,Goldey-Beacom College,Wilmington,DE,19808,5,NCAA Division II without football,259,316,575,2,"Private nonprofit, 4-year or above",2,16,13,219015,167879,386894,187344,156566,343910,Basketball
37392,2017,130989,Goldey-Beacom College,Wilmington,DE,19808,5,NCAA Division II without football,306,361,667,2,"Private nonprofit, 4-year or above",2,13,12,257164,185475,442639,204553,172140,376693,Basketball
55033,2018,130989,Goldey-Beacom College,Wilmington,DE,19808,5,NCAA Division II without football,297,357,654,2,"Private nonprofit, 4-year or above",2,19,14,255974,199558,455532,243196,193603,436799,Basketball
79358,2019,130989,Goldey-Beacom College,Wilmington,DE,19808,5,NCAA Division II without football,311,355,666,2,"Private nonprofit, 4-year or above",2,18,15,231099,191265,422364,215211,188185,403396,Basketball
16039,2015,235316,Gonzaga University,Spokane,WA,992580001,3,NCAA Division I without football,2293,2619,4912,2,"Private nonprofit, 4-year or above",2,15,19,12063064,3570466,15633530,7261657,3570466,10832123,Basketball
33512,2016,235316,Gonzaga University,Spokane,WA,99258,3,NCAA Division I without football,2400,2629,5029,2,"Private nonprofit, 4-year or above",2,17,18,12131756,3503396,15635152,8874752,3503396,12378148,Basketball
51065,2017,235316,Gonzaga University,Spokane,WA,99258,3,NCAA Division I without football,2427,2632,5059,2,"Private nonprofit, 4-year or above",2,15,19,14723219,3699632,18422851,9846552,3548289,13394841,Basketball
68816,2018,235316,Gonzaga University,Spokane,WA,99258,3,NCAA Division I without football,2466,2718,5184,2,"Private nonprofit, 4-year or above",2,16,20,16147924,3939901,20087825,10496251,3939901,14436152,Basketball
126959,2019,235316,Gonzaga University,Spokane,WA,99258,3,NCAA Division I without football,2384,2681,5065,2,"Private nonprofit, 4-year or above",2,15,19,14153038,4689199,18842237,9888823,4689199,14578022,Basketball
6563,2015,165936,Gordon College,Wenham,MA,1984,7,NCAA Division III without football,611,1016,1627,2,"Private nonprofit, 4-year or above",2,18,16,147266,150752,298018,147266,150752,298018,Basketball
23949,2016,165936,Gordon College,Wenham,MA,1984,7,NCAA Division III without football,577,982,1559,2,"Private nonprofit, 4-year or above",2,14,15,152635,141598,294233,152635,141598,294233,Basketball
41461,2017,165936,Gordon College,Wenham,MA,1984,7,NCAA Division III without football,563,958,1521,2,"Private nonprofit, 4-year or above",2,20,14,149524,147103,296627,149524,147103,296627,Basketball
59160,2018,165936,Gordon College,Wenham,MA,1984,7,NCAA Division III without football,564,979,1543,2,"Private nonprofit, 4-year or above",2,16,11,155017,142214,297231,155017,142214,297231,Basketball
93589,2019,165936,Gordon College,Wenham,MA,1984,7,NCAA Division III without football,546,887,1433,2,"Private nonprofit, 4-year or above",2,15,14,154318,140941,295259,154318,140941,295259,Basketball
6114,2015,162654,Goucher College,Baltimore,MD,212042794,7,NCAA Division III without football,464,986,1450,2,"Private nonprofit, 4-year or above",2,12,13,192581,172101,364682,190140,171202,361342,Basketball
23500,2016,162654,Goucher College,Baltimore,MD,21204,7,NCAA Division III without football,456,980,1436,2,"Private nonprofit, 4-year or above",2,14,9,166422,149593,316015,164097,148343,312440,Basketball
41004,2017,162654,Goucher College,Baltimore,MD,21204,7,NCAA Division III without football,459,980,1439,2,"Private nonprofit, 4-year or above",2,14,10,176019,153056,329075,157310,152104,309414,Basketball
58695,2018,162654,Goucher College,Baltimore,MD,21204,7,NCAA Division III without football,440,972,1412,2,"Private nonprofit, 4-year or above",2,22,7,142279,130206,272485,148011,130419,278430,Basketball
92166,2019,162654,Goucher College,Baltimore,MD,21204,7,NCAA Division III without football,423,897,1320,2,"Private nonprofit, 4-year or above",2,17,8,152488,116986,269474,161825,130758,292583,Basketball
5739,2015,159009,Grambling State University,Grambling,LA,71245,2,NCAA Division I-FCS,1435,1871,3306,1,"Public, 4-year or above",2,15,14,416958,697877,1114835,678446,700453,1378899,Basketball
23117,2016,159009,Grambling State University,Grambling,LA,71245,2,NCAA Division I-FCS,1528,2069,3597,1,"Public, 4-year or above",2,15,14,741120,654707,1395827,741120,654707,1395827,Basketball
40615,2017,159009,Grambling State University,Grambling,LA,71245,2,NCAA Division I-FCS,1559,2169,3728,1,"Public, 4-year or above",2,13,15,829657,714688,1544345,829657,714688,1544345,Basketball
58302,2018,159009,Grambling State University,Grambling,LA,71245,2,NCAA Division I-FCS,1516,2289,3805,1,"Public, 4-year or above",2,13,14,913266,784152,1697418,913266,784152,1697418,Basketball
90656,2019,159009,Grambling State University,Grambling,LA,71245,2,NCAA Division I-FCS,1423,2390,3813,1,"Public, 4-year or above",2,19,18,1027264,796114,1823378,1027264,796114,1823378,Basketball
381,2015,104717,Grand Canyon University,Phoenix,AZ,85017,3,NCAA Division I without football,4627,8546,13173,3,"Private for-profit, 4-year or above",2,19,15,4306041,1572825,5878866,4306041,1572825,5878866,Basketball
17726,2016,104717,Grand Canyon University,Phoenix,AZ,85017,3,NCAA Division I without football,5251,9291,14542,3,"Private for-profit, 4-year or above",2,18,23,4340799,1669745,6010544,4340799,1669745,6010544,Basketball
35142,2017,104717,Grand Canyon University,Phoenix,AZ,85017,3,NCAA Division I without football,5960,10022,15982,3,"Private for-profit, 4-year or above",2,18,15,5337280,1889421,7226701,5337280,1889421,7226701,Basketball
52769,2018,104717,Grand Canyon University,Phoenix,AZ,85017,3,NCAA Division I without football,6617,10696,17313,3,"Private for-profit, 4-year or above",2,16,27,5331006,1444309,6775315,5331006,1444309,6775315,Basketball
71860,2019,104717,Grand Canyon University,Phoenix,AZ,85017,3,NCAA Division I without football,6980,11390,18370,3,"Private for-profit, 4-year or above",2,15,15,5338540,1698563,7037103,5338540,1698563,7037103,Basketball
7173,2015,170082,Grand Valley State University,Allendale,MI,494019403,4,NCAA Division II with football,7847,11525,19372,1,"Public, 4-year or above",2,16,16,731233,805983,1537216,743187,773969,1517156,Basketball
24570,2016,170082,Grand Valley State University,Allendale,MI,49401,4,NCAA Division II with football,8018,11648,19666,1,"Public, 4-year or above",2,17,24,702326,793064,1495390,706474,788703,1495177,Basketball
42071,2017,170082,Grand Valley State University,Allendale,MI,49401,4,NCAA Division II with football,7791,11582,19373,1,"Public, 4-year or above",2,20,14,744441,828968,1573409,753539,764583,1518122,Basketball
59770,2018,170082,Grand Valley State University,Allendale,MI,49401,4,NCAA Division II with football,7622,11610,19232,1,"Public, 4-year or above",2,16,20,747271,840100,1587371,763868,846661,1610529,Basketball
95278,2019,170082,Grand Valley State University,Allendale,MI,49401,4,NCAA Division II with football,7436,11372,18808,1,"Public, 4-year or above",2,18,18,757441,865463,1622904,744777,832649,1577426,Basketball
15473,2015,230898,Green Mountain College,Poultney,VT,57641199,7,NCAA Division III without football,276,289,565,2,"Private nonprofit, 4-year or above",2,19,15,74667,48915,123582,74667,48915,123582,Basketball
32940,2016,230898,Green Mountain College,Poultney,VT,5764,7,NCAA Division III without football,210,262,472,2,"Private nonprofit, 4-year or above",2,12,12,47931,56589,104520,47931,56589,104520,Basketball
50473,2017,230898,Green Mountain College,Poultney,VT,5764,7,NCAA Division III without football,193,253,446,2,"Private nonprofit, 4-year or above",2,17,10,43998,55845,99843,43998,55845,99843,Basketball
10932,2015,198598,Greensboro College,Greensboro,NC,274011875,6,NCAA Division III with football,405,334,739,2,"Private nonprofit, 4-year or above",2,18,22,124491,115275,239766,117796,105900,223696,Basketball
28372,2016,198598,Greensboro College,Greensboro,NC,27401,6,NCAA Division III with football,413,346,759,2,"Private nonprofit, 4-year or above",2,22,18,138774,109183,247957,138774,96678,235452,Basketball
45871,2017,198598,Greensboro College,Greensboro,NC,27401,6,NCAA Division III with football,420,336,756,2,"Private nonprofit, 4-year or above",2,18,27,126697,106382,233079,126697,106382,233079,Basketball
63590,2018,198598,Greensboro College,Greensboro,NC,27401,6,NCAA Division III with football,391,336,727,2,"Private nonprofit, 4-year or above",2,13,13,110141,100242,210383,128631,94067,222698,Basketball
108292,2019,198598,Greensboro College,Greensboro,NC,27401,6,NCAA Division III with football,385,311,696,2,"Private nonprofit, 4-year or above",2,16,20,95750,97507,193257,87009,91172,178181,Basketball
3756,2015,145372,Greenville College,Greenville,IL,62246,6,NCAA Division III with football,502,516,1018,2,"Private nonprofit, 4-year or above",2,31,21,164076,131332,295408,128345,101169,229514,Basketball
21124,2016,145372,Greenville College,Greenville,IL,62246,6,NCAA Division III with football,464,449,913,2,"Private nonprofit, 4-year or above",2,33,20,169744,91808,261552,141438,85648,227086,Basketball
38580,2017,145372,Greenville University,Greenville,IL,62246,6,NCAA Division III with football,458,423,881,2,"Private nonprofit, 4-year or above",2,33,24,186100,95011,281111,124992,88860,213852,Basketball
56237,2018,145372,Greenville University,Greenville,IL,62246,6,NCAA Division III with football,465,395,860,2,"Private nonprofit, 4-year or above",2,29,24,190817,96188,287005,125631,81788,207419,Basketball
83938,2019,145372,Greenville University,Greenville,IL,62246,6,NCAA Division III with football,452,363,815,2,"Private nonprofit, 4-year or above",2,42,26,181910,88987,270897,127504,78408,205912,Basketball
4831,2015,153384,Grinnell College,Grinnell,IA,501121690,6,NCAA Division III with football,744,916,1660,2,"Private nonprofit, 4-year or above",2,24,18,118157,118945,237102,118157,118945,237102,Basketball
22190,2016,153384,Grinnell College,Grinnell,IA,50112,6,NCAA Division III with football,743,910,1653,2,"Private nonprofit, 4-year or above",2,22,14,157008,130850,287858,157008,130850,287858,Basketball
39664,2017,153384,Grinnell College,Grinnell,IA,50112,6,NCAA Division III with football,768,888,1656,2,"Private nonprofit, 4-year or above",2,24,13,164664,151432,316096,164664,151432,316096,Basketball
57327,2018,153384,Grinnell College,Grinnell,IA,50112,6,NCAA Division III with football,763,916,1679,2,"Private nonprofit, 4-year or above",2,26,16,125755,138202,263957,125755,138202,263957,Basketball
87723,2019,153384,Grinnell College,Grinnell,IA,50112,6,NCAA Division III with football,795,899,1694,2,"Private nonprofit, 4-year or above",2,30,15,117672,151888,269560,117672,151888,269560,Basketball
10943,2015,198613,Guilford College,Greensboro,NC,274104108,6,NCAA Division III with football,717,724,1441,2,"Private nonprofit, 4-year or above",2,26,14,266159,158133,424292,254408,154406,408814,Basketball
28384,2016,198613,Guilford College,Greensboro,NC,27410,6,NCAA Division III with football,715,740,1455,2,"Private nonprofit, 4-year or above",2,23,13,260856,186251,447107,260856,164834,425690,Basketball
45882,2017,198613,Guilford College,Greensboro,NC,27410,6,NCAA Division III with football,621,702,1323,2,"Private nonprofit, 4-year or above",2,31,20,161688,178966,340654,172359,176663,349022,Basketball
63601,2018,198613,Guilford College,Greensboro,NC,27410,6,NCAA Division III with football,620,659,1279,2,"Private nonprofit, 4-year or above",2,25,13,327087,199545,526632,285763,187392,473155,Basketball
108304,2019,198613,Guilford College,Greensboro,NC,27410,6,NCAA Division III with football,607,659,1266,2,"Private nonprofit, 4-year or above",2,24,14,194730,177683,372413,185192,171072,356264,Basketball
7587,2015,173647,Gustavus Adolphus College,Saint Peter,MN,560821498,6,NCAA Division III with football,1090,1252,2342,2,"Private nonprofit, 4-year or above",2,29,20,185123,194048,379171,185123,194048,379171,Basketball
25001,2016,173647,Gustavus Adolphus College,Saint Peter,MN,56082,6,NCAA Division III with football,1032,1187,2219,2,"Private nonprofit, 4-year or above",2,28,16,177694,166305,343999,177694,166305,343999,Basketball
42498,2017,173647,Gustavus Adolphus College,Saint Peter,MN,56082,6,NCAA Division III with football,941,1209,2150,2,"Private nonprofit, 4-year or above",2,30,18,185012,181115,366127,185012,181115,366127,Basketball
60205,2018,173647,Gustavus Adolphus College,Saint Peter,MN,56082,6,NCAA Division III with football,920,1292,2212,2,"Private nonprofit, 4-year or above",2,22,22,178296,170225,348521,178296,170225,348521,Basketball
96721,2019,173647,Gustavus Adolphus College,Saint Peter,MN,56082,6,NCAA Division III with football,895,1317,2212,2,"Private nonprofit, 4-year or above",2,21,20,200411,170862,371273,200411,170862,371273,Basketball
12856,2015,212832,Gwynedd Mercy University,Gwynedd Valley,PA,194370901,7,NCAA Division III without football,450,1344,1794,2,"Private nonprofit, 4-year or above",2,14,14,78750,46119,124869,78750,46119,124869,Basketball
30312,2016,212832,Gwynedd Mercy University,Gwynedd Valley,PA,19437,7,NCAA Division III without football,444,1380,1824,2,"Private nonprofit, 4-year or above",2,14,14,79493,57031,136524,79493,57031,136524,Basketball
47809,2017,212832,Gwynedd Mercy University,Gwynedd Valley,PA,19437,7,NCAA Division III without football,419,1449,1868,2,"Private nonprofit, 4-year or above",2,15,19,93745,48457,142202,93745,48457,142202,Basketball
65561,2018,212832,Gwynedd Mercy University,Gwynedd Valley,PA,19437,7,NCAA Division III without football,441,1389,1830,2,"Private nonprofit, 4-year or above",2,16,15,96011,49322,145333,96011,49322,145333,Basketball
115271,2019,212832,Gwynedd Mercy University,Gwynedd Valley,PA,19437,7,NCAA Division III without football,384,1312,1696,2,"Private nonprofit, 4-year or above",2,15,16,106203,49204,155407,106203,49204,155407,Basketball
9758,2015,191515,Hamilton College,Clinton,NY,13323,6,NCAA Division III with football,908,953,1861,2,"Private nonprofit, 4-year or above",2,15,14,201002,192661,393663,201002,192661,393663,Basketball
27178,2016,191515,Hamilton College,Clinton,NY,13323,6,NCAA Division III with football,906,960,1866,2,"Private nonprofit, 4-year or above",2,14,13,228375,177973,406348,228375,177973,406348,Basketball
44662,2017,191515,Hamilton College,Clinton,NY,13323,6,NCAA Division III with football,886,999,1885,2,"Private nonprofit, 4-year or above",2,15,13,225747,172697,398444,225747,172697,398444,Basketball
62389,2018,191515,Hamilton College,Clinton,NY,13323,6,NCAA Division III with football,942,1047,1989,2,"Private nonprofit, 4-year or above",2,13,14,256571,214938,471509,256571,214938,471509,Basketball
104646,2019,191515,Hamilton College,Clinton,NY,13323,6,NCAA Division III with football,946,1051,1997,2,"Private nonprofit, 4-year or above",2,14,14,258894,204672,463566,258894,204672,463566,Basketball
7599,2015,173665,Hamline University,Saint Paul,MN,551041284,6,NCAA Division III with football,885,1225,2110,2,"Private nonprofit, 4-year or above",2,19,9,193475,189446,382921,193475,189446,382921,Basketball
25013,2016,173665,Hamline University,Saint Paul,MN,55104,6,NCAA Division III with football,838,1241,2079,2,"Private nonprofit, 4-year or above",2,18,14,178347,182602,360949,178347,182602,360949,Basketball
42510,2017,173665,Hamline University,Saint Paul,MN,55104,6,NCAA Division III with football,811,1263,2074,2,"Private nonprofit, 4-year or above",2,21,21,195313,165510,360823,195313,165510,360823,Basketball
60217,2018,173665,Hamline University,Saint Paul,MN,55104,6,NCAA Division III with football,760,1262,2022,2,"Private nonprofit, 4-year or above",2,19,20,193053,160667,353720,193053,160667,353720,Basketball
96734,2019,173665,Hamline University,Saint Paul,MN,55104,6,NCAA Division III with football,741,1255,1996,2,"Private nonprofit, 4-year or above",2,22,19,201383,176921,378304,201383,176921,378304,Basketball
15671,2015,232256,Hampden-Sydney College,Hampden-Sydney,VA,239430128,6,NCAA Division III with football,1082,4,1086,2,"Private nonprofit, 4-year or above",2,19,0,449387,NA,449387,449387,NA,449387,Basketball
33143,2016,232256,Hampden-Sydney College,Hampden-Sydney,VA,23943,6,NCAA Division III with football,1024,2,1026,2,"Private nonprofit, 4-year or above",2,18,0,457452,NA,457452,457452,NA,457452,Basketball
50686,2017,232256,Hampden-Sydney College,Hampden-Sydney,VA,23943,6,NCAA Division III with football,1038,1,1039,2,"Private nonprofit, 4-year or above",2,17,0,429356,NA,429356,429356,NA,429356,Basketball
68436,2018,232256,Hampden-Sydney College,Hampden-Sydney,VA,23943,6,NCAA Division III with football,1068,2,1070,2,"Private nonprofit, 4-year or above",2,25,0,581178,NA,581178,581178,NA,581178,Basketball
125619,2019,232256,Hampden-Sydney College,Hampden-Sydney,VA,23943,6,NCAA Division III with football,981,5,986,2,"Private nonprofit, 4-year or above",2,18,0,564745,NA,564745,564745,NA,564745,Basketball
15680,2015,232265,Hampton University,Hampton,VA,236680099,2,NCAA Division I-FCS,1100,2153,3253,2,"Private nonprofit, 4-year or above",2,22,15,1154030,1412521,2566551,1154030,1412521,2566551,Basketball
33152,2016,232265,Hampton University,Hampton,VA,23668,2,NCAA Division I-FCS,1191,2461,3652,2,"Private nonprofit, 4-year or above",2,15,16,988748,1095958,2084706,988748,1095958,2084706,Basketball
50695,2017,232265,Hampton University,Hampton,VA,23668,2,NCAA Division I-FCS,1187,2461,3648,2,"Private nonprofit, 4-year or above",2,17,16,1252604,1354359,2606963,1149617,1344647,2494264,Basketball
68444,2018,232265,Hampton University,Hampton,VA,23668,2,NCAA Division I-FCS,1191,2314,3505,2,"Private nonprofit, 4-year or above",2,15,12,1828090,1130506,2958596,1460137,1440013,2900150,Basketball
125628,2019,232265,Hampton University,Hampton,VA,23668,2,NCAA Division I-FCS,1179,2309,3488,2,"Private nonprofit, 4-year or above",2,17,15,1034611,1128999,2163610,1299095,1103965,2403060,Basketball
4421,2015,150756,Hanover College,Hanover,IN,47243,6,NCAA Division III with football,465,660,1125,2,"Private nonprofit, 4-year or above",2,16,11,209795,147807,357602,196714,135980,332694,Basketball
21792,2016,150756,Hanover College,Hanover,IN,47243,6,NCAA Division III with football,462,618,1080,2,"Private nonprofit, 4-year or above",2,17,22,243292,136636,379928,212851,134851,347702,Basketball
39262,2017,150756,Hanover College,Hanover,IN,47243,6,NCAA Division III with football,497,582,1079,2,"Private nonprofit, 4-year or above",2,18,18,246695,153735,400430,223851,139172,363023,Basketball
56921,2018,150756,Hanover College,Hanover,IN,47243,6,NCAA Division III with football,491,603,1094,2,"Private nonprofit, 4-year or above",2,19,19,240398,202007,442405,234573,123609,358182,Basketball
86286,2019,150756,Hanover College,Hanover,IN,47243,6,NCAA Division III with football,473,589,1062,2,"Private nonprofit, 4-year or above",2,17,17,294969,245692,540661,241854,245692,487546,Basketball
14778,2015,225247,Hardin-Simmons University,Abilene,TX,796980001,6,NCAA Division III with football,692,782,1474,2,"Private nonprofit, 4-year or above",2,14,11,178329,172090,350419,178329,172090,350419,Basketball
32248,2016,225247,Hardin-Simmons University,Abilene,TX,79698,6,NCAA Division III with football,695,825,1520,2,"Private nonprofit, 4-year or above",2,14,11,157476,172792,330268,162474,154522,316996,Basketball
49771,2017,225247,Hardin-Simmons University,Abilene,TX,79698,6,NCAA Division III with football,756,828,1584,2,"Private nonprofit, 4-year or above",2,15,17,211126,214512,425638,212639,216394,429033,Basketball
67546,2018,225247,Hardin-Simmons University,Abilene,TX,79698,6,NCAA Division III with football,763,864,1627,2,"Private nonprofit, 4-year or above",2,17,24,205798,200702,406500,202072,192522,394594,Basketball
122003,2019,225247,Hardin-Simmons University,Abilene,TX,79698,6,NCAA Division III with football,748,866,1614,2,"Private nonprofit, 4-year or above",2,15,20,201181,201131,402312,215398,205617,421015,Basketball
548,2015,107044,Harding University,Searcy,AR,72143,4,NCAA Division II with football,1837,2269,4106,2,"Private nonprofit, 4-year or above",2,17,14,438125,402070,840195,438125,402070,840195,Basketball
17894,2016,107044,Harding University,Searcy,AR,72149,4,NCAA Division II with football,1834,2309,4143,2,"Private nonprofit, 4-year or above",2,14,13,427139,424550,851689,427139,424550,851689,Basketball
35324,2017,107044,Harding University,Searcy,AR,72149,4,NCAA Division II with football,1749,2195,3944,2,"Private nonprofit, 4-year or above",2,16,14,502406,466441,968847,502406,466441,968847,Basketball
52944,2018,107044,Harding University,Searcy,AR,72149,4,NCAA Division II with football,1718,2024,3742,2,"Private nonprofit, 4-year or above",2,17,16,494473,431915,926388,494473,431915,926388,Basketball
72650,2019,107044,Harding University,Searcy,AR,72149,4,NCAA Division II with football,1592,1940,3532,2,"Private nonprofit, 4-year or above",2,19,17,429475,497933,927408,429475,497933,927408,Basketball
9774,2015,191533,Hartwick College,Oneonta,NY,138204020,6,NCAA Division III with football,540,812,1352,2,"Private nonprofit, 4-year or above",2,16,12,160476,138723,299199,160476,138723,299199,Basketball
27194,2016,191533,Hartwick College,Oneonta,NY,13820,6,NCAA Division III with football,546,816,1362,2,"Private nonprofit, 4-year or above",2,15,12,126317,122501,248818,126317,122501,248818,Basketball
44678,2017,191533,Hartwick College,Oneonta,NY,13820,6,NCAA Division III with football,488,690,1178,2,"Private nonprofit, 4-year or above",2,17,13,154305,123334,277639,154305,123334,277639,Basketball
62405,2018,191533,Hartwick College,Oneonta,NY,13820,6,NCAA Division III with football,479,670,1149,2,"Private nonprofit, 4-year or above",2,11,15,119997,139212,259209,119997,139212,259209,Basketball
104684,2019,191533,Hartwick College,Oneonta,NY,13820,6,NCAA Division III with football,461,703,1164,2,"Private nonprofit, 4-year or above",2,17,13,131881,129188,261069,131881,129188,261069,Basketball
6577,2015,166027,Harvard University,Cambridge,MA,2138,2,NCAA Division I-FCS,3637,3256,6893,2,"Private nonprofit, 4-year or above",2,16,19,1296186,743673,2039859,1296186,743673,2039859,Basketball
23964,2016,166027,Harvard University,Cambridge,MA,2138,2,NCAA Division I-FCS,3681,3250,6931,2,"Private nonprofit, 4-year or above",2,20,15,1363485,782932,2146417,1363485,782932,2146417,Basketball
41476,2017,166027,Harvard University,Cambridge,MA,2138,2,NCAA Division I-FCS,3624,3321,6945,2,"Private nonprofit, 4-year or above",2,21,14,1407818,778439,2186257,1407818,778439,2186257,Basketball
59175,2018,166027,Harvard University,Cambridge,MA,2138,2,NCAA Division I-FCS,3583,3397,6980,2,"Private nonprofit, 4-year or above",2,20,15,1474941,1025101,2500042,1474941,1025101,2500042,Basketball
93665,2019,166027,Harvard University,Cambridge,MA,2138,2,NCAA Division I-FCS,3531,3454,6985,2,"Private nonprofit, 4-year or above",2,19,14,1525604,1016233,2541837,1525604,1016233,2541837,Basketball
12876,2015,212911,Haverford College,Haverford,PA,190411392,7,NCAA Division III without football,597,632,1229,2,"Private nonprofit, 4-year or above",2,14,15,115996,112685,228681,115996,112685,228681,Basketball
30334,2016,212911,Haverford College,Haverford,PA,190411392,7,NCAA Division III without football,607,654,1261,2,"Private nonprofit, 4-year or above",2,15,17,121577,117052,238629,121577,117052,238629,Basketball
47829,2017,212911,Haverford College,Haverford,PA,19041,7,NCAA Division III without football,619,671,1290,2,"Private nonprofit, 4-year or above",2,15,17,116013,156526,272539,116013,156526,272539,Basketball
65581,2018,212911,Haverford College,Haverford,PA,19041,7,NCAA Division III without football,634,669,1303,2,"Private nonprofit, 4-year or above",2,16,15,153374,134397,287771,153374,134397,287771,Basketball
115358,2019,212911,Haverford College,Haverford,PA,19041,7,NCAA Division III without football,620,688,1308,2,"Private nonprofit, 4-year or above",2,16,16,106518,127622,234140,106518,127622,234140,Basketball
3515,2015,141644,Hawaii Pacific University,Honolulu,HI,96813,5,NCAA Division II without football,1065,1759,2824,2,"Private nonprofit, 4-year or above",2,16,17,790004,546030,1336034,790004,546030,1336034,Basketball
20885,2016,141644,Hawaii Pacific University,Honolulu,HI,96813,5,NCAA Division II without football,959,1594,2553,2,"Private nonprofit, 4-year or above",2,15,18,788027,669759,1457786,788027,669759,1457786,Basketball
38341,2017,141644,Hawaii Pacific University,Honolulu,HI,96813,5,NCAA Division II without football,839,1565,2404,2,"Private nonprofit, 4-year or above",2,16,17,752161,665274,1417435,752161,665274,1417435,Basketball
55994,2018,141644,Hawaii Pacific University,Honolulu,HI,96813,5,NCAA Division II without football,810,1554,2364,2,"Private nonprofit, 4-year or above",2,16,14,746040,693227,1439267,746040,693227,1439267,Basketball
82933,2019,141644,Hawaii Pacific University,Honolulu,HI,96813,5,NCAA Division II without football,744,1457,2201,2,"Private nonprofit, 4-year or above",2,19,14,583606,531056,1114662,583606,531056,1114662,Basketball
11592,2015,203085,Heidelberg University,Tiffin,OH,448832462,6,NCAA Division III with football,522,472,994,2,"Private nonprofit, 4-year or above",2,27,22,131321,135848,267169,131321,135848,267169,Basketball
29029,2016,203085,Heidelberg University,Tiffin,OH,44883,6,NCAA Division III with football,576,529,1105,2,"Private nonprofit, 4-year or above",2,23,21,137191,137552,274743,137191,137552,274743,Basketball
46530,2017,203085,Heidelberg University,Tiffin,OH,44883,6,NCAA Division III with football,559,472,1031,2,"Private nonprofit, 4-year or above",2,24,22,146779,123749,270528,155886,133467,289353,Basketball
64254,2018,203085,Heidelberg University,Tiffin,OH,44883,6,NCAA Division III with football,530,505,1035,2,"Private nonprofit, 4-year or above",2,24,25,146802,133344,280146,144833,128483,273316,Basketball
110738,2019,203085,Heidelberg University,Tiffin,OH,44883,6,NCAA Division III with football,523,513,1036,2,"Private nonprofit, 4-year or above",2,30,28,138418,130748,269166,140229,121448,261677,Basketball
557,2015,107071,Henderson State University,Arkadelphia,AR,719990001,4,NCAA Division II with football,1181,1566,2747,1,"Public, 4-year or above",2,15,14,378380,361178,739558,378380,361178,739558,Basketball
17903,2016,107071,Henderson State University,Arkadelphia,AR,71999,4,NCAA Division II with football,1201,1589,2790,1,"Public, 4-year or above",2,18,14,423433,347332,770765,423433,347332,770765,Basketball
35333,2017,107071,Henderson State University,Arkadelphia,AR,71999,4,NCAA Division II with football,1120,1445,2565,1,"Public, 4-year or above",2,15,15,411603,366551,778154,411603,366551,778154,Basketball
52953,2018,107071,Henderson State University,Arkadelphia,AR,71999,4,NCAA Division II with football,1190,1536,2726,1,"Public, 4-year or above",2,16,12,404235,363365,767600,404235,363365,767600,Basketball
72688,2019,107071,Henderson State University,Arkadelphia,AR,71999,4,NCAA Division II with football,1167,1528,2695,1,"Public, 4-year or above",2,15,15,472149,395355,867504,472149,395355,867504,Basketball
566,2015,107080,Hendrix College,Conway,AR,720323080,6,NCAA Division III with football,611,688,1299,2,"Private nonprofit, 4-year or above",2,22,18,134213,126290,260503,134213,126290,260503,Basketball
17912,2016,107080,Hendrix College,Conway,AR,72032,6,NCAA Division III with football,622,689,1311,2,"Private nonprofit, 4-year or above",2,18,12,146638,123747,270385,146638,123747,270385,Basketball
35342,2017,107080,Hendrix College,Conway,AR,72032,6,NCAA Division III with football,584,644,1228,2,"Private nonprofit, 4-year or above",2,17,14,139726,132953,272679,139726,132953,272679,Basketball
52962,2018,107080,Hendrix College,Conway,AR,72032,6,NCAA Division III with football,573,619,1192,2,"Private nonprofit, 4-year or above",2,18,14,131116,124132,255248,131116,124132,255248,Basketball
72698,2019,107080,Hendrix College,Conway,AR,72032,6,NCAA Division III with football,526,575,1101,2,"Private nonprofit, 4-year or above",2,19,10,118804,109169,227973,118804,109169,227973,Basketball
89045,2019,155177,Hesston College,Hesston,KS,67062,5,NCAA Division II without football,144,199,343,2,"Private nonprofit, 4-year or above",2,16,14,214868,177072,391940,214868,177071,391939,Basketball
10957,2015,198695,High Point University,High Point,NC,27268,3,NCAA Division I without football,1741,2579,4320,2,"Private nonprofit, 4-year or above",2,15,13,2021481,1313897,3335378,1747761,1287193,3034954,Basketball
28398,2016,198695,High Point University,High Point,NC,27268,3,NCAA Division I without football,1817,2659,4476,2,"Private nonprofit, 4-year or above",2,15,15,2066953,1307318,3374271,1755309,1275539,3030848,Basketball
45896,2017,198695,High Point University,High Point,NC,27268,3,NCAA Division I without football,1804,2571,4375,2,"Private nonprofit, 4-year or above",2,15,14,2322532,1351542,3674074,1976328,1322458,3298786,Basketball
63615,2018,198695,High Point University,High Point,NC,27268,3,NCAA Division I without football,1903,2569,4472,2,"Private nonprofit, 4-year or above",2,15,14,3457345,1541750,4999095,3369936,1489498,4859434,Basketball
108354,2019,198695,High Point University,High Point,NC,27268,3,NCAA Division I without football,1971,2559,4530,2,"Private nonprofit, 4-year or above",2,15,13,3112826,1286213,4399039,2946042,1335863,4281905,Basketball
9798,2015,191621,Hilbert College,Hamburg,NY,140751597,7,NCAA Division III without football,356,430,786,2,"Private nonprofit, 4-year or above",2,17,12,76095,72455,148550,74133,65597,139730,Basketball
27217,2016,191621,Hilbert College,Hamburg,NY,14075,7,NCAA Division III without football,326,414,740,2,"Private nonprofit, 4-year or above",2,17,16,73458,67857,141315,73153,67877,141030,Basketball
44702,2017,191621,Hilbert College,Hamburg,NY,14075,7,NCAA Division III without football,310,370,680,2,"Private nonprofit, 4-year or above",2,14,12,87079,59470,146549,84277,59470,143747,Basketball
62430,2018,191621,Hilbert College,Hamburg,NY,14075,7,NCAA Division III without football,306,382,688,2,"Private nonprofit, 4-year or above",2,16,11,108485,96043,204528,86735,96228,182963,Basketball
104759,2019,191621,Hilbert College,Hamburg,NY,14075,7,NCAA Division III without football,311,375,686,2,"Private nonprofit, 4-year or above",2,16,14,125403,108959,234362,106606,105161,211767,Basketball
11604,2015,203128,Hiram College,Hiram,OH,442340067,6,NCAA Division III with football,450,455,905,2,"Private nonprofit, 4-year or above",2,21,15,134700,110244,244944,134700,110244,244944,Basketball
29042,2016,203128,Hiram College,Hiram,OH,44234,6,NCAA Division III with football,425,417,842,2,"Private nonprofit, 4-year or above",2,21,18,142281,106543,248824,142281,106543,248824,Basketball
46543,2017,203128,Hiram College,Hiram,OH,44234,6,NCAA Division III with football,398,440,838,2,"Private nonprofit, 4-year or above",2,20,16,153104,118150,271254,153104,118150,271254,Basketball
64265,2018,203128,Hiram College,Hiram,OH,44234,6,NCAA Division III with football,372,440,812,2,"Private nonprofit, 4-year or above",2,20,16,171734,126638,298372,171734,126638,298372,Basketball
110750,2019,203128,Hiram College,Hiram,OH,44234,6,NCAA Division III with football,357,444,801,2,"Private nonprofit, 4-year or above",2,15,15,152705,116155,268860,152705,116155,268860,Basketball
9805,2015,191630,Hobart William Smith Colleges,Geneva,NY,14456,6,NCAA Division III with football,1111,1135,2246,2,"Private nonprofit, 4-year or above",2,14,14,209407,182706,392113,209407,182706,392113,Basketball
27224,2016,191630,Hobart William Smith Colleges,Geneva,NY,14456,6,NCAA Division III with football,1107,1125,2232,2,"Private nonprofit, 4-year or above",2,17,17,218149,205160,423309,218149,205160,423309,Basketball
44710,2017,191630,Hobart William Smith Colleges,Geneva,NY,14456,6,NCAA Division III with football,1087,1122,2209,2,"Private nonprofit, 4-year or above",2,15,13,237684,202679,440363,237684,202679,440363,Basketball
62439,2018,191630,Hobart William Smith Colleges,Geneva,NY,14456,6,NCAA Division III with football,1062,1135,2197,2,"Private nonprofit, 4-year or above",2,17,13,294832,215182,510014,294832,215182,510014,Basketball
104797,2019,191630,Hobart William Smith Colleges,Geneva,NY,14456,6,NCAA Division III with football,963,1068,2031,2,"Private nonprofit, 4-year or above",2,19,12,256932,204922,461854,256932,204922,461854,Basketball
9819,2015,191649,Hofstra University,Hempstead,NY,11549,3,NCAA Division I without football,2871,3494,6365,2,"Private nonprofit, 4-year or above",2,12,13,2545499,1900703,4446202,2545499,1900703,4446202,Basketball
27238,2016,191649,Hofstra University,Hempstead,NY,11549,3,NCAA Division I without football,2912,3550,6462,2,"Private nonprofit, 4-year or above",2,13,13,2613307,1927970,4541277,2613307,1927970,4541277,Basketball
44724,2017,191649,Hofstra University,Hempstead,NY,11549,3,NCAA Division I without football,2881,3588,6469,2,"Private nonprofit, 4-year or above",2,13,14,2858591,2003775,4862366,2858591,2003775,4862366,Basketball
62453,2018,191649,Hofstra University,Hempstead,NY,11549,3,NCAA Division I without football,2784,3514,6298,2,"Private nonprofit, 4-year or above",2,14,15,2939154,2219733,5158887,2939154,2219733,5158887,Basketball
104835,2019,191649,Hofstra University,Hempstead,NY,11549,3,NCAA Division I without football,2708,3408,6116,2,"Private nonprofit, 4-year or above",2,14,16,2804668,2100593,4905261,2804668,2100593,4905261,Basketball
12886,2015,212984,Holy Family University,Philadelphia,PA,191142009,5,NCAA Division II without football,351,1079,1430,2,"Private nonprofit, 4-year or above",2,14,13,479047,469501,948548,479047,469501,948548,Basketball
30344,2016,212984,Holy Family University,Philadelphia,PA,19114,5,NCAA Division II without football,356,1064,1420,2,"Private nonprofit, 4-year or above",2,13,13,302059,448093,750152,302059,448093,750152,Basketball
47839,2017,212984,Holy Family University,Philadelphia,PA,19114,5,NCAA Division II without football,420,1205,1625,2,"Private nonprofit, 4-year or above",2,13,14,370773,406814,777587,370773,406814,777587,Basketball
65591,2018,212984,Holy Family University,Philadelphia,PA,19114,5,NCAA Division II without football,412,1150,1562,2,"Private nonprofit, 4-year or above",2,13,12,436624,340429,777053,436624,340429,777053,Basketball
115369,2019,212984,Holy Family University,Philadelphia,PA,19114,5,NCAA Division II without football,430,1266,1696,2,"Private nonprofit, 4-year or above",2,14,11,390247,298114,688361,378372,293277,671649,Basketball
1325,2015,115728,Holy Names University,Oakland,CA,946191699,5,NCAA Division II without football,203,313,516,2,"Private nonprofit, 4-year or above",2,21,17,423270,370823,794093,423270,370823,794093,Basketball
18685,2016,115728,Holy Names University,Oakland,CA,94619,5,NCAA Division II without football,172,273,445,2,"Private nonprofit, 4-year or above",2,18,15,438890,381823,820713,438890,381823,820713,Basketball
36118,2017,115728,Holy Names University,Oakland,CA,94619,5,NCAA Division II without football,207,336,543,2,"Private nonprofit, 4-year or above",2,19,15,524522,426022,950544,524522,426022,950544,Basketball
53741,2018,115728,Holy Names University,Oakland,CA,94619,5,NCAA Division II without football,208,383,591,2,"Private nonprofit, 4-year or above",2,20,15,502273,420493,922766,502273,420493,922766,Basketball
75176,2019,115728,Holy Names University,Oakland,CA,94619,5,NCAA Division II without football,214,375,589,2,"Private nonprofit, 4-year or above",2,21,15,400648,350852,751500,400648,350852,751500,Basketball
6142,2015,162760,Hood College,Frederick,MD,21701,7,NCAA Division III without football,444,727,1171,2,"Private nonprofit, 4-year or above",2,18,17,126168,116033,242201,125868,115933,241801,Basketball
23525,2016,162760,Hood College,Frederick,MD,21701,7,NCAA Division III without football,417,669,1086,2,"Private nonprofit, 4-year or above",2,18,19,127122,142280,269402,127122,142280,269402,Basketball
41030,2017,162760,Hood College,Frederick,MD,21701,7,NCAA Division III without football,398,648,1046,2,"Private nonprofit, 4-year or above",2,16,16,135593,129610,265203,135593,129610,265203,Basketball
58721,2018,162760,Hood College,Frederick,MD,21701,7,NCAA Division III without football,376,637,1013,2,"Private nonprofit, 4-year or above",2,15,14,110478,92953,203431,110478,92953,203431,Basketball
92250,2019,162760,Hood College,Frederick,MD,21701,7,NCAA Division III without football,384,673,1057,2,"Private nonprofit, 4-year or above",2,15,16,69886,73451,143337,69886,71345,141231,Basketball
7191,2015,170301,Hope College,Holland,MI,494229000,6,NCAA Division III with football,1257,1933,3190,2,"Private nonprofit, 4-year or above",2,16,16,260390,164192,424582,260390,164192,424582,Basketball
24589,2016,170301,Hope College,Holland,MI,49422,6,NCAA Division III with football,1177,1843,3020,2,"Private nonprofit, 4-year or above",2,14,16,242691,154407,397098,242691,154407,397098,Basketball
42091,2017,170301,Hope College,Holland,MI,494229000,6,NCAA Division III with football,1163,1850,3013,2,"Private nonprofit, 4-year or above",2,15,15,287096,159135,446231,287096,159135,446231,Basketball
59788,2018,170301,Hope College,Holland,MI,494229000,6,NCAA Division III with football,1142,1890,3032,2,"Private nonprofit, 4-year or above",2,15,17,211106,166005,377111,211106,166005,377111,Basketball
95325,2019,170301,Hope College,Holland,MI,494229000,6,NCAA Division III with football,1092,1818,2910,2,"Private nonprofit, 4-year or above",2,17,16,187481,218895,406376,185481,210895,396376,Basketball
9830,2015,191676,Houghton College,Houghton,NY,14744,7,NCAA Division III without football,353,636,989,2,"Private nonprofit, 4-year or above",2,14,15,72090,69587,141677,72090,69587,141677,Basketball
27249,2016,191676,Houghton College,Houghton,NY,14744,7,NCAA Division III without football,375,623,998,2,"Private nonprofit, 4-year or above",2,15,15,80588,73955,154543,80588,73955,154543,Basketball
44735,2017,191676,Houghton College,Houghton,NY,14744,7,NCAA Division III without football,370,600,970,2,"Private nonprofit, 4-year or above",2,15,15,78287,75411,153698,78287,75411,153698,Basketball
62465,2018,191676,Houghton College,Houghton,NY,14744,7,NCAA Division III without football,385,537,922,2,"Private nonprofit, 4-year or above",2,14,16,90275,102702,192977,90275,102702,192977,Basketball
104873,2019,191676,Houghton College,Houghton,NY,14744,7,NCAA Division III without football,358,525,883,2,"Private nonprofit, 4-year or above",2,15,10,70191,113856,184047,70191,113856,184047,Basketball
14798,2015,225399,Houston Baptist University,Houston,TX,770743298,2,NCAA Division I-FCS,821,1294,2115,2,"Private nonprofit, 4-year or above",2,17,14,1613999,923111,2537110,1273000,873141,2146141,Basketball
32268,2016,225399,Houston Baptist University,Houston,TX,77074,2,NCAA Division I-FCS,817,1343,2160,2,"Private nonprofit, 4-year or above",2,16,15,1372694,879732,2252426,1372694,879732,2252426,Basketball
49793,2017,225399,Houston Baptist University,Houston,TX,77074,2,NCAA Division I-FCS,776,1321,2097,2,"Private nonprofit, 4-year or above",2,17,17,1291054,976516,2267570,1291054,976516,2267570,Basketball
67568,2018,225399,Houston Baptist University,Houston,TX,77074,2,NCAA Division I-FCS,685,1190,1875,2,"Private nonprofit, 4-year or above",2,15,16,1345408,1050068,2395476,1345408,1050068,2395476,Basketball
122117,2019,225399,Houston Baptist University,Houston,TX,77074,2,NCAA Division I-FCS,722,1345,2067,2,"Private nonprofit, 4-year or above",2,15,17,1337537,1079801,2417338,1337537,1079801,2417338,Basketball
14825,2015,225548,Howard Payne University,Brownwood,TX,768012794,6,NCAA Division III with football,516,435,951,2,"Private nonprofit, 4-year or above",2,18,19,165600,184643,350243,156213,154680,310893,Basketball
32295,2016,225548,Howard Payne University,Brownwood,TX,76801,6,NCAA Division III with football,517,442,959,2,"Private nonprofit, 4-year or above",2,17,19,180889,176818,357707,169046,150375,319421,Basketball
49820,2017,225548,Howard Payne University,Brownwood,TX,76801,6,NCAA Division III with football,440,391,831,2,"Private nonprofit, 4-year or above",2,25,18,200625,193189,393814,190798,187882,378680,Basketball
67595,2018,225548,Howard Payne University,Brownwood,TX,76801,6,NCAA Division III with football,447,365,812,2,"Private nonprofit, 4-year or above",2,32,19,190469,181161,371630,182276,158925,341201,Basketball
122269,2019,225548,Howard Payne University,Brownwood,TX,76801,6,NCAA Division III with football,400,338,738,2,"Private nonprofit, 4-year or above",2,30,17,189413,192977,382390,187732,191955,379687,Basketball
2673,2015,131520,Howard University,Washington,DC,200590001,2,NCAA Division I-FCS,2059,4327,6386,2,"Private nonprofit, 4-year or above",2,18,17,1682347,1568246,3250593,1682347,1568246,3250593,Basketball
20044,2016,131520,Howard University,Washington,DC,20059,2,NCAA Division I-FCS,1797,3756,5553,2,"Private nonprofit, 4-year or above",2,18,15,1641048,1027076,2668124,1321719,1031218,2352937,Basketball
37483,2017,131520,Howard University,Washington,DC,20059,2,NCAA Division I-FCS,1853,4208,6061,2,"Private nonprofit, 4-year or above",2,19,14,1099615,1143063,2242678,1099615,1143063,2242678,Basketball
55127,2018,131520,Howard University,Washington,DC,20059,2,NCAA Division I-FCS,1808,4151,5959,2,"Private nonprofit, 4-year or above",2,21,15,1338284,1133820,2472104,1338284,1133820,2472104,Basketball
79623,2019,131520,Howard University,Washington,DC,20059,2,NCAA Division I-FCS,1795,4469,6264,2,"Private nonprofit, 4-year or above",2,17,23,410169,554934,965103,1272835,1106682,2379517,Basketball
1332,2015,115755,Humboldt State University,Arcata,CA,955218299,4,NCAA Division II with football,3367,4323,7690,1,"Public, 4-year or above",2,15,18,583583,489670,1073253,583583,489670,1073253,Basketball
18692,2016,115755,Humboldt State University,Arcata,CA,95521,4,NCAA Division II with football,3234,4251,7485,1,"Public, 4-year or above",2,16,15,580081,443854,1023935,580081,443066,1023147,Basketball
36125,2017,115755,Humboldt State University,Arcata,CA,95521,4,NCAA Division II with football,3107,4147,7254,1,"Public, 4-year or above",2,17,14,553257,494096,1047353,553257,494096,1047353,Basketball
53748,2018,115755,Humboldt State University,Arcata,CA,95521,4,NCAA Division II with football,2869,3851,6720,1,"Public, 4-year or above",2,20,12,599014,468878,1067892,599014,468878,1067892,Basketball
75185,2019,115755,Humboldt State University,Arcata,CA,95521,5,NCAA Division II without football,2557,3518,6075,1,"Public, 4-year or above",2,16,12,520225,480046,1000271,520225,480046,1000271,Basketball
128,2015,101435,Huntingdon College,Montgomery,AL,361062148,6,NCAA Division III with football,485,409,894,2,"Private nonprofit, 4-year or above",2,29,31,230750,206610,437360,230750,206610,437360,Basketball
17471,2016,101435,Huntingdon College,Montgomery,AL,36106,6,NCAA Division III with football,504,376,880,2,"Private nonprofit, 4-year or above",2,24,22,272436,218532,490968,272436,218532,490968,Basketball
34882,2017,101435,Huntingdon College,Montgomery,AL,36106,6,NCAA Division III with football,463,415,878,2,"Private nonprofit, 4-year or above",2,31,24,284744,216660,501404,284744,216660,501404,Basketball
52511,2018,101435,Huntingdon College,Montgomery,AL,36106,6,NCAA Division III with football,477,404,881,2,"Private nonprofit, 4-year or above",2,28,24,227665,220341,448006,227665,220341,448006,Basketball
70695,2019,101435,Huntingdon College,Montgomery,AL,36106,6,NCAA Division III with football,442,388,830,2,"Private nonprofit, 4-year or above",2,30,26,174752,148141,322893,174752,148141,322893,Basketball
17324,2015,487524,Husson University,Bangor,ME,4401,6,NCAA Division III with football,1059,1168,2227,2,"Private nonprofit, 4-year or above",2,15,13,78043,64666,142709,75557,64020,139577,Basketball
34733,2016,487524,Husson University,Bangor,ME,4401,6,NCAA Division III with football,1080,1251,2331,2,"Private nonprofit, 4-year or above",2,17,14,99919,75805,175724,99919,75805,175724,Basketball
52348,2017,487524,Husson University,Bangor,ME,4401,6,NCAA Division III with football,1070,1235,2305,2,"Private nonprofit, 4-year or above",2,17,15,128225,87498,215723,100960,68895,169855,Basketball
70113,2018,487524,Husson University,Bangor,ME,4401,6,NCAA Division III with football,1052,1342,2394,2,"Private nonprofit, 4-year or above",2,13,13,140394,140656,281050,116686,116202,232888,Basketball
132159,2019,487524,Husson University,Bangor,ME,4401,6,NCAA Division III with football,1072,1332,2404,2,"Private nonprofit, 4-year or above",2,13,13,100335,170585,270920,76660,155639,232299,Basketball
3535,2015,142276,Idaho State University,Pocatello,ID,83209,2,NCAA Division I-FCS,3559,3342,6901,1,"Public, 4-year or above",2,15,15,1210089,621662,1831751,1290851,1074755,2365606,Basketball
20905,2016,142276,Idaho State University,Pocatello,ID,83209,2,NCAA Division I-FCS,3168,3330,6498,1,"Public, 4-year or above",2,15,14,1195626,769684,1965310,1236259,1098579,2334838,Basketball
38360,2017,142276,Idaho State University,Pocatello,ID,83209,2,NCAA Division I-FCS,2869,3350,6219,1,"Public, 4-year or above",2,19,15,1298448,1156506,2454954,1298448,1156506,2454954,Basketball
56013,2018,142276,Idaho State University,Pocatello,ID,83209,2,NCAA Division I-FCS,2726,3343,6069,1,"Public, 4-year or above",2,15,18,1461637,1226310,2687947,1461637,1226310,2687947,Basketball
82980,2019,142276,Idaho State University,Pocatello,ID,83209,2,NCAA Division I-FCS,2598,3277,5875,1,"Public, 4-year or above",2,17,18,1221275,1205781,2427056,1221275,1205781,2427056,Basketball
3818,2015,145691,Illinois College,Jacksonville,IL,626502299,6,NCAA Division III with football,453,487,940,2,"Private nonprofit, 4-year or above",2,21,17,146718,115867,262585,146718,115867,262585,Basketball
21188,2016,145691,Illinois College,Jacksonville,IL,62650,6,NCAA Division III with football,449,500,949,2,"Private nonprofit, 4-year or above",2,27,16,139542,138332,277874,139542,138332,277874,Basketball
38643,2017,145691,Illinois College,Jacksonville,IL,62650,6,NCAA Division III with football,463,480,943,2,"Private nonprofit, 4-year or above",2,22,18,105240,134645,239885,105240,134645,239885,Basketball
56299,2018,145691,Illinois College,Jacksonville,IL,62650,6,NCAA Division III with football,477,492,969,2,"Private nonprofit, 4-year or above",2,20,20,154353,150674,305027,154353,150674,305027,Basketball
84148,2019,145691,Illinois College,Jacksonville,IL,62650,6,NCAA Division III with football,499,538,1037,2,"Private nonprofit, 4-year or above",2,24,25,154688,149457,304145,154688,149457,304145,Basketball
3830,2015,145725,Illinois Institute of Technology,Chicago,IL,60616,7,NCAA Division III without football,1952,837,2789,2,"Private nonprofit, 4-year or above",2,13,14,151059,144537,295596,151059,144537,295596,Basketball
21201,2016,145725,Illinois Institute of Technology,Chicago,IL,60616,7,NCAA Division III without football,1883,826,2709,2,"Private nonprofit, 4-year or above",2,15,14,148191,178771,326962,148191,178771,326962,Basketball
38656,2017,145725,Illinois Institute of Technology,Chicago,IL,60616,7,NCAA Division III without football,1800,827,2627,2,"Private nonprofit, 4-year or above",2,14,12,152329,154866,307195,152329,154866,307195,Basketball
56312,2018,145725,Illinois Institute of Technology,Chicago,IL,60616,7,NCAA Division III without football,1895,894,2789,2,"Private nonprofit, 4-year or above",2,17,10,156544,144348,300892,156544,144348,300892,Basketball
84223,2019,145725,Illinois Institute of Technology,Chicago,IL,60616,7,NCAA Division III without football,1948,930,2878,2,"Private nonprofit, 4-year or above",2,17,12,130648,134933,265581,130648,134933,265581,Basketball
3839,2015,145813,Illinois State University,Normal,IL,617901000,2,NCAA Division I-FCS,7662,9442,17104,1,"Public, 4-year or above",2,14,14,2452961,1414630,3867591,2452961,1414630,3867591,Basketball
21210,2016,145813,Illinois State University,Normal,IL,61790,2,NCAA Division I-FCS,7658,9762,17420,1,"Public, 4-year or above",2,15,13,2311466,1616567,3928033,2311466,1616567,3928033,Basketball
38666,2017,145813,Illinois State University,Normal,IL,61790,2,NCAA Division I-FCS,7570,9569,17139,1,"Public, 4-year or above",2,13,13,2209131,1419472,3628603,2209131,1419472,3628603,Basketball
56323,2018,145813,Illinois State University,Normal,IL,61790,2,NCAA Division I-FCS,7456,9435,16891,1,"Public, 4-year or above",2,17,14,2440752,1314217,3754969,2440752,1314217,3754969,Basketball
84234,2019,145813,Illinois State University,Normal,IL,61790,2,NCAA Division I-FCS,7539,9533,17072,1,"Public, 4-year or above",2,16,15,2503350,1380331,3883681,2503350,1380331,3883681,Basketball
3800,2015,145646,Illinois Wesleyan University,Bloomington,IL,617022900,6,NCAA Division III with football,804,1017,1821,2,"Private nonprofit, 4-year or above",2,27,20,155917,135715,291632,155917,135715,291632,Basketball
21170,2016,145646,Illinois Wesleyan University,Bloomington,IL,61702,6,NCAA Division III with football,817,943,1760,2,"Private nonprofit, 4-year or above",2,23,22,169925,152730,322655,169925,152730,322655,Basketball
38625,2017,145646,Illinois Wesleyan University,Bloomington,IL,61702,6,NCAA Division III with football,745,895,1640,2,"Private nonprofit, 4-year or above",2,27,19,183730,158198,341928,183730,158198,341928,Basketball
56282,2018,145646,Illinois Wesleyan University,Bloomington,IL,61702,6,NCAA Division III with football,803,881,1684,2,"Private nonprofit, 4-year or above",2,23,14,167725,165119,332844,167725,165119,332844,Basketball
84072,2019,145646,Illinois Wesleyan University,Bloomington,IL,61702,6,NCAA Division III with football,769,841,1610,2,"Private nonprofit, 4-year or above",2,21,15,195842,186911,382753,195842,186911,382753,Basketball
12896,2015,213011,Immaculata University,Immaculata,PA,193450702,7,NCAA Division III without football,318,700,1018,2,"Private nonprofit, 4-year or above",2,16,10,62342,71386,133728,51847,61592,113439,Basketball
30354,2016,213011,Immaculata University,Immaculata,PA,19345,7,NCAA Division III without football,283,660,943,2,"Private nonprofit, 4-year or above",2,20,15,50641,54453,105094,50341,51092,101433,Basketball
47849,2017,213011,Immaculata University,Immaculata,PA,19345,7,NCAA Division III without football,244,640,884,2,"Private nonprofit, 4-year or above",2,19,16,64743,73008,137751,61360,72016,133376,Basketball
65601,2018,213011,Immaculata University,Immaculata,PA,19345,7,NCAA Division III without football,248,573,821,2,"Private nonprofit, 4-year or above",2,15,17,68826,74085,142911,61334,74102,135436,Basketball
115407,2019,213011,Immaculata University,Immaculata,PA,19345,7,NCAA Division III without football,284,619,903,2,"Private nonprofit, 4-year or above",2,15,17,63268,67144,130412,60275,65352,125627,Basketball
4493,2015,151324,Indiana State University,Terre Haute,IN,47809,2,NCAA Division I-FCS,4549,5074,9623,1,"Public, 4-year or above",2,14,15,1832975,1229722,3062697,1832975,1229722,3062697,Basketball
21865,2016,151324,Indiana State University,Terre Haute,IN,47809,2,NCAA Division I-FCS,4320,5027,9347,1,"Public, 4-year or above",2,15,12,1884192,1211884,3096076,1866603,1211884,3078487,Basketball
39339,2017,151324,Indiana State University,Terre Haute,IN,47809,2,NCAA Division I-FCS,4341,5012,9353,1,"Public, 4-year or above",2,15,14,2055794,1363805,3419599,2055794,1363805,3419599,Basketball
56999,2018,151324,Indiana State University,Terre Haute,IN,47809,2,NCAA Division I-FCS,3978,4897,8875,1,"Public, 4-year or above",2,15,14,2129934,1362920,3492854,2129934,1362920,3492854,Basketball
86561,2019,151324,Indiana State University,Terre Haute,IN,47809,2,NCAA Division I-FCS,3563,4539,8102,1,"Public, 4-year or above",2,15,14,2128080,1204711,3332791,2128080,1204711,3332791,Basketball
12908,2015,213020,Indiana University of Pennsylvania-Main Campus,Indiana,PA,157051098,4,NCAA Division II with football,4815,6016,10831,1,"Public, 4-year or above",2,14,13,995599,532355,1527954,876487,526167,1402654,Basketball
30366,2016,213020,Indiana University of Pennsylvania-Main Campus,Indiana,PA,15705,4,NCAA Division II with football,4296,5661,9957,1,"Public, 4-year or above",2,14,14,1040301,606352,1646653,780999,580465,1361464,Basketball
47861,2017,213020,Indiana University of Pennsylvania-Main Campus,Indiana,PA,15705,4,NCAA Division II with football,3966,5506,9472,1,"Public, 4-year or above",2,14,15,1006025,708584,1714609,819329,685910,1505239,Basketball
65614,2018,213020,Indiana University of Pennsylvania-Main Campus,Indiana,PA,15705,4,NCAA Division II with football,3535,4987,8522,1,"Public, 4-year or above",2,14,16,976649,681086,1657735,862643,686176,1548819,Basketball
115445,2019,213020,Indiana University of Pennsylvania-Main Campus,Indiana,PA,15705,4,NCAA Division II with football,3120,4535,7655,1,"Public, 4-year or above",2,14,14,955274,638917,1594191,825543,637145,1462688,Basketball
4510,2015,151351,Indiana University-Bloomington,Bloomington,IN,474057000,1,NCAA Division I-FBS,15796,15763,31559,1,"Public, 4-year or above",2,15,25,23094923,197081,23292004,12129479,3189403,15318882,Basketball
21884,2016,151351,Indiana University-Bloomington,Bloomington,IN,47405,1,NCAA Division I-FBS,16085,15799,31884,1,"Public, 4-year or above",2,16,26,24560829,261502,24822331,12855019,3790121,16645140,Basketball
39361,2017,151351,Indiana University-Bloomington,Bloomington,IN,47405,1,NCAA Division I-FBS,16179,15934,32113,1,"Public, 4-year or above",2,18,25,25086839,480554,25567393,13693497,4120140,17813637,Basketball
57021,2018,151351,Indiana University-Bloomington,Bloomington,IN,47405,1,NCAA Division I-FBS,16111,15889,32000,1,"Public, 4-year or above",2,17,33,27008415,307989,27316404,13230211,4550549,17780760,Basketball
86675,2019,151351,Indiana University-Bloomington,Bloomington,IN,47405,1,NCAA Division I-FBS,16072,15806,31878,1,"Public, 4-year or above",2,16,32,25140266,362492,25502758,12869789,4672786,17542575,Basketball
4445,2015,151102,Indiana University-Purdue University-Fort Wayne,Fort Wayne,IN,468051499,3,NCAA Division I without football,3045,3550,6595,1,"Public, 4-year or above",2,15,13,1269206,1004566,2273772,1269206,1004566,2273772,Basketball
21816,2016,151102,Indiana University-Purdue University-Fort Wayne,Fort Wayne,IN,46805,3,NCAA Division I without football,2808,3527,6335,1,"Public, 4-year or above",2,15,19,1548148,968899,2517047,1548148,968899,2517047,Basketball
39289,2017,151102,Indiana University-Purdue University-Fort Wayne,Fort Wayne,IN,46805,3,NCAA Division I without football,2622,3257,5879,1,"Public, 4-year or above",2,14,21,1545947,1099546,2645493,1545947,1099546,2645493,Basketball
56949,2018,151102,Indiana University-Purdue University-Fort Wayne,Fort Wayne,IN,46805,3,NCAA Division I without football,2678,2991,5669,1,"Public, 4-year or above",2,15,22,1700944,1078957,2779901,1700944,1078957,2779901,Basketball
4452,2015,151111,Indiana University-Purdue University-Indianapolis,Indianapolis,IN,462025143,3,NCAA Division I without football,7302,9630,16932,1,"Public, 4-year or above",2,15,14,1564479,1236843,2801322,1564479,1236843,2801322,Basketball
21823,2016,151111,Indiana University-Purdue University-Indianapolis,Indianapolis,IN,46202,3,NCAA Division I without football,7477,9810,17287,1,"Public, 4-year or above",2,17,12,1556965,1226786,2783751,1556965,1226786,2783751,Basketball
39296,2017,151111,Indiana University-Purdue University-Indianapolis,Indianapolis,IN,46202,3,NCAA Division I without football,7425,10012,17437,1,"Public, 4-year or above",2,17,15,1614116,1350292,2964408,1614116,1350292,2964408,Basketball
56956,2018,151111,Indiana University-Purdue University-Indianapolis,Indianapolis,IN,46202,3,NCAA Division I without football,7187,10282,17469,1,"Public, 4-year or above",2,15,15,1928860,1286185,3215045,1928860,1286185,3215045,Basketball
86414,2019,151111,Indiana University-Purdue University-Indianapolis,Indianapolis,IN,46202,3,NCAA Division I without football,7149,10399,17548,1,"Public, 4-year or above",2,16,12,1818044,1293882,3111926,1818044,1293882,3111926,Basketball
9851,2015,191931,Iona College,New Rochelle,NY,108011890,2,NCAA Division I-FCS,1422,1536,2958,2,"Private nonprofit, 4-year or above",2,15,16,2308176,1673227,3981403,2308176,1673227,3981403,Basketball
27270,2016,191931,Iona College,New Rochelle,NY,10801,2,NCAA Division I-FCS,1469,1597,3066,2,"Private nonprofit, 4-year or above",2,15,22,2514963,1598331,4113294,2514963,1598331,4113294,Basketball
44756,2017,191931,Iona College,New Rochelle,NY,10801,2,NCAA Division I-FCS,1440,1508,2948,2,"Private nonprofit, 4-year or above",2,16,14,2755804,1731995,4487799,2755804,1731995,4487799,Basketball
62486,2018,191931,Iona College,New Rochelle,NY,10801,2,NCAA Division I-FCS,1468,1487,2955,2,"Private nonprofit, 4-year or above",2,13,13,2881346,1773279,4654625,2881346,1773279,4654625,Basketball
104949,2019,191931,Iona College,New Rochelle,NY,10801,2,NCAA Division I-FCS,1390,1312,2702,2,"Private nonprofit, 4-year or above",2,14,16,3037713,1969241,5006954,3037714,1969241,5006955,Basketball
4872,2015,153603,Iowa State University,Ames,IA,500112030,1,NCAA Division I-FBS,16217,12414,28631,1,"Public, 4-year or above",2,14,25,10767763,844341,11612104,6885453,3395945,10281398,Basketball
22234,2016,153603,Iowa State University,Ames,IA,50011,1,NCAA Division I-FBS,16457,12334,28791,1,"Public, 4-year or above",2,15,26,13604289,778885,14383174,6858775,4052987,10911762,Basketball
39710,2017,153603,Iowa State University,Ames,IA,50011,1,NCAA Division I-FBS,16398,12242,28640,1,"Public, 4-year or above",2,13,24,13956343,582595,14538938,6851315,3838930,10690245,Basketball
57376,2018,153603,Iowa State University,Ames,IA,50011,1,NCAA Division I-FBS,15988,11844,27832,1,"Public, 4-year or above",2,15,24,14670525,630789,15301314,7693014,4336491,12029505,Basketball
87886,2019,153603,Iowa State University,Ames,IA,50011,1,NCAA Division I-FBS,15180,11447,26627,1,"Public, 4-year or above",2,17,19,11624983,507027,12132010,7561594,4123387,11684981,Basketball
4884,2015,153621,Iowa Wesleyan University,Mount Pleasant,IA,52641,6,NCAA Division III with football,176,211,387,2,"Private nonprofit, 4-year or above",2,19,12,75731,103633,179364,75731,103633,179364,Basketball
22246,2016,153621,Iowa Wesleyan University,Mount Pleasant,IA,52641,6,NCAA Division III with football,237,242,479,2,"Private nonprofit, 4-year or above",2,25,9,85815,86611,172426,85815,86611,172426,Basketball
39722,2017,153621,Iowa Wesleyan University,Mount Pleasant,IA,52641,6,NCAA Division III with football,277,266,543,2,"Private nonprofit, 4-year or above",2,21,13,96866,73051,169917,96866,73051,169917,Basketball
57388,2018,153621,Iowa Wesleyan University,Mount Pleasant,IA,52641,6,NCAA Division III with football,279,281,560,2,"Private nonprofit, 4-year or above",2,28,16,123194,77559,200753,123194,77559,200753,Basketball
87924,2019,153621,Iowa Wesleyan University,Mount Pleasant,IA,52641,6,NCAA Division III with football,281,279,560,2,"Private nonprofit, 4-year or above",2,21,10,125581,90167,215748,125581,90167,215748,Basketball
9863,2015,191968,Ithaca College,Ithaca,NY,148507002,6,NCAA Division III with football,2616,3581,6197,2,"Private nonprofit, 4-year or above",2,14,16,202681,185693,388374,202681,185693,388374,Basketball
27281,2016,191968,Ithaca College,Ithaca,NY,14850,6,NCAA Division III with football,2536,3563,6099,2,"Private nonprofit, 4-year or above",2,16,15,216733,193622,410355,216733,193622,410355,Basketball
44768,2017,191968,Ithaca College,Ithaca,NY,14850,6,NCAA Division III with football,2501,3431,5932,2,"Private nonprofit, 4-year or above",2,17,17,191004,149955,340959,191004,149955,340959,Basketball
62497,2018,191968,Ithaca College,Ithaca,NY,14850,6,NCAA Division III with football,2560,3425,5985,2,"Private nonprofit, 4-year or above",2,16,17,241622,210821,452443,241622,210821,452443,Basketball
104987,2019,191968,Ithaca College,Ithaca,NY,14850,6,NCAA Division III with football,2435,3300,5735,2,"Private nonprofit, 4-year or above",2,16,16,257250,243115,500365,257250,243115,500365,Basketball
7947,2015,175856,Jackson State University,Jackson,MS,39217,2,NCAA Division I-FCS,2495,4181,6676,1,"Public, 4-year or above",2,19,15,619321,649446,1268767,619321,649446,1268767,Basketball
25362,2016,175856,Jackson State University,Jackson,MS,39217,2,NCAA Division I-FCS,2366,4138,6504,1,"Public, 4-year or above",2,18,20,759210,752626,1511836,759210,752626,1511836,Basketball
42862,2017,175856,Jackson State University,Jackson,MS,39217,2,NCAA Division I-FCS,2180,3751,5931,1,"Public, 4-year or above",2,18,16,577680,542935,1120615,577680,542935,1120615,Basketball
60567,2018,175856,Jackson State University,Jackson,MS,39217,2,NCAA Division I-FCS,1756,3083,4839,1,"Public, 4-year or above",2,21,16,676673,693509,1370182,676673,693509,1370182,Basketball
98029,2019,175856,Jackson State University,Jackson,MS,39217,2,NCAA Division I-FCS,1568,2555,4123,1,"Public, 4-year or above",2,21,15,789914,712375,1502289,789914,712375,1502289,Basketball
138,2015,101480,Jacksonville State University,Jacksonville,AL,36265,2,NCAA Division I-FCS,2364,3031,5395,1,"Public, 4-year or above",2,18,13,1111582,777924,1889506,1111582,777924,1889506,Basketball
17482,2016,101480,Jacksonville State University,Jacksonville,AL,36265,2,NCAA Division I-FCS,2360,3032,5392,1,"Public, 4-year or above",2,16,14,1616369,851940,2468309,1616369,851940,2468309,Basketball
34894,2017,101480,Jacksonville State University,Jacksonville,AL,36265,2,NCAA Division I-FCS,2318,3100,5418,1,"Public, 4-year or above",2,16,16,1558308,1044161,2602469,1558308,1044161,2602469,Basketball
52523,2018,101480,Jacksonville State University,Jacksonville,AL,36265,2,NCAA Division I-FCS,2266,3090,5356,1,"Public, 4-year or above",2,13,14,1497090,1097540,2594630,1497090,1097540,2594630,Basketball
70733,2019,101480,Jacksonville State University,Jacksonville,AL,36265,2,NCAA Division I-FCS,2347,3412,5759,1,"Public, 4-year or above",2,14,17,1546609,1076520,2623129,1546609,1076520,2623129,Basketball
2897,2015,134945,Jacksonville University,Jacksonville,FL,322113394,2,NCAA Division I-FCS,939,1115,2054,2,"Private nonprofit, 4-year or above",2,16,13,1653294,1183278,2836572,1653294,1183278,2836572,Basketball
20269,2016,134945,Jacksonville University,Jacksonville,FL,32211,2,NCAA Division I-FCS,959,1154,2113,2,"Private nonprofit, 4-year or above",2,16,15,1682001,1488057,3170058,1682001,1488057,3170058,Basketball
37716,2017,134945,Jacksonville University,Jacksonville,FL,32211,2,NCAA Division I-FCS,985,1189,2174,2,"Private nonprofit, 4-year or above",2,15,14,1904265,1518620,3422885,1904265,1518620,3422885,Basketball
55363,2018,134945,Jacksonville University,Jacksonville,FL,32211,2,NCAA Division I-FCS,999,1284,2283,2,"Private nonprofit, 4-year or above",2,15,15,2025816,1454163,3479979,2025816,1454163,3479979,Basketball
80568,2019,134945,Jacksonville University,Jacksonville,FL,32211,2,NCAA Division I-FCS,1059,1324,2383,2,"Private nonprofit, 4-year or above",2,15,15,1917471,1518212,3435683,1917471,1518212,3435683,Basketball
15691,2015,232423,James Madison University,Harrisonburg,VA,22807,2,NCAA Division I-FCS,7450,10870,18320,1,"Public, 4-year or above",2,14,28,3483621,2484643,5968264,3483621,2484643,5968264,Basketball
33163,2016,232423,James Madison University,Harrisonburg,VA,22807,2,NCAA Division I-FCS,7460,11007,18467,1,"Public, 4-year or above",2,16,26,2911439,2432324,5343763,2911439,2432324,5343763,Basketball
50706,2017,232423,James Madison University,Harrisonburg,VA,22807,2,NCAA Division I-FCS,7737,11123,18860,1,"Public, 4-year or above",2,14,35,2761166,2508321,5269487,2761166,2508321,5269487,Basketball
68455,2018,232423,James Madison University,Harrisonburg,VA,22807,2,NCAA Division I-FCS,7804,11017,18821,1,"Public, 4-year or above",2,14,36,2709807,2681161,5390968,2709807,2681161,5390968,Basketball
125666,2019,232423,James Madison University,Harrisonburg,VA,22807,2,NCAA Division I-FCS,7851,10921,18772,1,"Public, 4-year or above",2,13,33,3637197,2565200,6202397,3637197,2565200,6202397,Basketball
48355,2017,215099,Jefferson (Philadelphia University + Thomas Jefferson University),Philadelphia,PA,19144,5,NCAA Division II without football,765,1506,2271,2,"Private nonprofit, 4-year or above",2,13,14,499546,472812,972358,502568,496827,999395,Basketball
11615,2015,203368,John Carroll University,University Heights,OH,441184581,6,NCAA Division III with football,1502,1457,2959,2,"Private nonprofit, 4-year or above",2,19,15,159028,175093,334121,159028,175093,334121,Basketball
29055,2016,203368,John Carroll University,University Heights,OH,44118,6,NCAA Division III with football,1480,1430,2910,2,"Private nonprofit, 4-year or above",2,20,10,168377,187207,355584,168377,187207,355584,Basketball
46558,2017,203368,John Carroll University,University Heights,OH,44118,6,NCAA Division III with football,1509,1433,2942,2,"Private nonprofit, 4-year or above",2,19,15,197105,204243,401348,197105,204243,401348,Basketball
64282,2018,203368,John Carroll University,University Heights,OH,44118,6,NCAA Division III with football,1562,1407,2969,2,"Private nonprofit, 4-year or above",2,20,22,193836,219713,413549,193836,219713,413549,Basketball
110826,2019,203368,John Carroll University,University Heights,OH,44118,6,NCAA Division III with football,1549,1355,2904,2,"Private nonprofit, 4-year or above",2,20,15,188955,209158,398113,188955,209158,398113,Basketball
69967,2018,439288,Johnson & Wales University-Denver,Denver,CO,80220,7,NCAA Division III without football,345,567,912,2,"Private nonprofit, 4-year or above",2,20,11,130108,97436,227544,130108,97436,227544,Basketball
131386,2019,439288,Johnson & Wales University-Denver,Denver,CO,80220,7,NCAA Division III without football,329,527,856,2,"Private nonprofit, 4-year or above",2,14,9,130260,108045,238305,130260,108045,238305,Basketball
13804,2015,217235,Johnson & Wales University-Providence,Providence,RI,29033703,7,NCAA Division III without football,3174,4740,7914,2,"Private nonprofit, 4-year or above",2,14,11,164087,114713,278800,150974,114358,265332,Basketball
31258,2016,217235,Johnson & Wales University-Providence,Providence,RI,2903,7,NCAA Division III without football,3021,4577,7598,2,"Private nonprofit, 4-year or above",2,13,13,146426,117205,263631,146426,117205,263631,Basketball
48770,2017,217235,Johnson & Wales University-Providence,Providence,RI,2903,7,NCAA Division III without football,2842,4241,7083,2,"Private nonprofit, 4-year or above",2,15,10,174627,111102,285729,174627,111102,285729,Basketball
66524,2018,217235,Johnson & Wales University-Providence,Providence,RI,2903,7,NCAA Division III without football,2466,3707,6173,2,"Private nonprofit, 4-year or above",2,15,12,155508,111009,266517,155508,111009,266517,Basketball
118116,2019,217235,Johnson & Wales University-Providence,Providence,RI,2903,7,NCAA Division III without football,2273,3419,5692,2,"Private nonprofit, 4-year or above",2,14,13,151815,108352,260167,151815,108352,260167,Basketball
10965,2015,198756,Johnson C Smith University,Charlotte,NC,282165398,4,NCAA Division II with football,519,803,1322,2,"Private nonprofit, 4-year or above",2,17,17,375266,425440,800706,375266,425440,800706,Basketball
28406,2016,198756,Johnson C Smith University,Charlotte,NC,28216,4,NCAA Division II with football,502,782,1284,2,"Private nonprofit, 4-year or above",2,16,15,425841,503694,929535,425841,503694,929535,Basketball
45902,2017,198756,Johnson C Smith University,Charlotte,NC,28216,4,NCAA Division II with football,510,818,1328,2,"Private nonprofit, 4-year or above",2,14,14,487896,496157,984053,476756,489606,966362,Basketball
63621,2018,198756,Johnson C Smith University,Charlotte,NC,28216,4,NCAA Division II with football,550,877,1427,2,"Private nonprofit, 4-year or above",2,15,15,556309,598166,1154475,556309,598166,1154475,Basketball
108392,2019,198756,Johnson C Smith University,Charlotte,NC,28216,4,NCAA Division II with football,538,821,1359,2,"Private nonprofit, 4-year or above",2,17,16,399747,460952,860699,399747,460952,860699,Basketball
15481,2015,230913,Johnson State College,Johnson,VT,56569464,7,NCAA Division III without football,333,585,918,1,"Public, 4-year or above",2,14,13,115875,115520,231395,107543,115520,223063,Basketball
32948,2016,230913,Johnson State College,Johnson,VT,5656,7,NCAA Division III without football,326,555,881,1,"Public, 4-year or above",2,17,17,103043,108421,211464,103043,105257,208300,Basketball
50480,2017,230913,Johnson State College,Johnson,VT,5656,7,NCAA Division III without football,329,553,882,1,"Public, 4-year or above",2,18,18,94578,113496,208074,91904,113396,205300,Basketball
68250,2018,230913,Johnson State College,Johnson,VT,5656,7,NCAA Division III without football,735,825,1560,1,"Public, 4-year or above",2,35,24,182743,138093,320836,161448,135380,296828,Basketball
12922,2015,213251,Juniata College,Huntingdon,PA,166522196,6,NCAA Division III with football,648,819,1467,2,"Private nonprofit, 4-year or above",2,16,14,161685,144442,306127,162807,134271,297078,Basketball
30379,2016,213251,Juniata College,Huntingdon,PA,16652,6,NCAA Division III with football,645,807,1452,2,"Private nonprofit, 4-year or above",2,16,16,143494,111722,255216,143385,108019,251404,Basketball
47874,2017,213251,Juniata College,Huntingdon,PA,16652,6,NCAA Division III with football,610,756,1366,2,"Private nonprofit, 4-year or above",2,21,16,147966,148713,296679,146065,141909,287974,Basketball
65626,2018,213251,Juniata College,Huntingdon,PA,16652,6,NCAA Division III with football,567,734,1301,2,"Private nonprofit, 4-year or above",2,18,12,155744,153921,309665,154915,146686,301601,Basketball
115460,2019,213251,Juniata College,Huntingdon,PA,16652,6,NCAA Division III with football,564,705,1269,2,"Private nonprofit, 4-year or above",2,14,13,154511,160438,314949,170620,175014,345634,Basketball
7209,2015,170532,Kalamazoo College,Kalamazoo,MI,490063295,6,NCAA Division III with football,621,785,1406,2,"Private nonprofit, 4-year or above",2,17,16,115785,87740,203525,115335,87740,203075,Basketball
24607,2016,170532,Kalamazoo College,Kalamazoo,MI,49006,6,NCAA Division III with football,634,780,1414,2,"Private nonprofit, 4-year or above",2,16,19,120955,93081,214036,102802,94536,197338,Basketball
42109,2017,170532,Kalamazoo College,Kalamazoo,MI,49006,6,NCAA Division III with football,610,796,1406,2,"Private nonprofit, 4-year or above",2,19,12,132562,119442,252004,132562,119442,252004,Basketball
59807,2018,170532,Kalamazoo College,Kalamazoo,MI,49006,6,NCAA Division III with football,611,826,1437,2,"Private nonprofit, 4-year or above",2,15,13,193586,128734,322320,193586,128734,322320,Basketball
95374,2019,170532,Kalamazoo College,Kalamazoo,MI,49006,6,NCAA Division III with football,554,702,1256,2,"Private nonprofit, 4-year or above",2,16,13,141236,138517,279753,141236,138517,279753,Basketball
5315,2015,155399,Kansas State University,Manhattan,KS,66506,1,NCAA Division I-FBS,9297,8458,17755,1,"Public, 4-year or above",2,17,40,9370870,384074,9754944,6772157,3729555,10501712,Basketball
22679,2016,155399,Kansas State University,Manhattan,KS,66506,1,NCAA Division I-FBS,9215,8347,17562,1,"Public, 4-year or above",2,17,36,9192918,455479,9648397,7354065,3746211,11100276,Basketball
40162,2017,155399,Kansas State University,Manhattan,KS,66506,1,NCAA Division I-FBS,8854,7798,16652,1,"Public, 4-year or above",2,18,40,9083722,349072,9432794,7591505,4108486,11699991,Basketball
57835,2018,155399,Kansas State University,Manhattan,KS,66506,1,NCAA Division I-FBS,8619,7528,16147,1,"Public, 4-year or above",2,14,34,10733840,340864,11074704,8028533,4253009,12281542,Basketball
89298,2019,155399,Kansas State University,Manhattan,KS,66506,1,NCAA Division I-FBS,8127,7348,15475,1,"Public, 4-year or above",2,14,32,9802910,276142,10079052,7774810,4132036,11906846,Basketball
9056,2015,185262,Kean University,Union,NJ,7083,6,NCAA Division III with football,3735,5456,9191,1,"Public, 4-year or above",2,14,17,165373,133403,298776,165373,133403,298776,Basketball
26481,2016,185262,Kean University,Union,NJ,7083,6,NCAA Division III with football,3701,5484,9185,1,"Public, 4-year or above",2,10,14,184514,163646,348160,184514,163646,348160,Basketball
43974,2017,185262,Kean University,Union,NJ,7083,6,NCAA Division III with football,3884,5549,9433,1,"Public, 4-year or above",2,17,13,151894,162748,314642,151894,162748,314642,Basketball
61696,2018,185262,Kean University,Union,NJ,7083,6,NCAA Division III with football,3837,5669,9506,1,"Public, 4-year or above",2,17,15,194243,189659,383902,194243,189659,383902,Basketball
102300,2019,185262,Kean University,Union,NJ,7083,6,NCAA Division III with football,3938,5764,9702,1,"Public, 4-year or above",2,18,17,193743,190433,384176,193743,190433,384176,Basketball
8844,2015,183062,Keene State College,Keene,NH,34351506,7,NCAA Division III without football,1788,2302,4090,1,"Public, 4-year or above",2,17,14,228077,191259,419336,220961,191197,412158,Basketball
26271,2016,183062,Keene State College,Keene,NH,3435,7,NCAA Division III without football,1794,2196,3990,1,"Public, 4-year or above",2,18,18,235770,193265,429035,228949,182423,411372,Basketball
43768,2017,183062,Keene State College,Keene,NH,3435,7,NCAA Division III without football,1620,1989,3609,1,"Public, 4-year or above",2,16,12,216681,170829,387510,216681,170829,387510,Basketball
61485,2018,183062,Keene State College,Keene,NH,3435,7,NCAA Division III without football,1499,1863,3362,1,"Public, 4-year or above",2,18,13,220432,175304,395736,220432,175304,395736,Basketball
101488,2019,183062,Keene State College,Keene,NH,3435,7,NCAA Division III without football,1486,1780,3266,1,"Public, 4-year or above",2,16,16,166556,162594,329150,164643,162594,327237,Basketball
17302,2015,486840,Kennesaw State University,Kennesaw,GA,30144,2,NCAA Division I-FCS,11514,11212,22726,1,"Public, 4-year or above",2,12,14,1435160,1103715,2538875,1435160,1103715,2538875,Basketball
34709,2016,486840,Kennesaw State University,Kennesaw,GA,30144,2,NCAA Division I-FCS,12404,11767,24171,1,"Public, 4-year or above",2,15,12,1428268,1083676,2511944,1428268,1083676,2511944,Basketball
52324,2017,486840,Kennesaw State University,Kennesaw,GA,30144,2,NCAA Division I-FCS,12763,11834,24597,1,"Public, 4-year or above",2,15,13,1371745,1010283,2382028,1371745,1010283,2382028,Basketball
70089,2018,486840,Kennesaw State University,Kennesaw,GA,30144,2,NCAA Division I-FCS,12243,11594,23837,1,"Public, 4-year or above",2,14,13,1511263,1229059,2740322,1510719,1228108,2738827,Basketball
132107,2019,486840,Kennesaw State University,Kennesaw,GA,30144,2,NCAA Division I-FCS,12977,12308,25285,1,"Public, 4-year or above",2,16,14,558521,163907,722428,1471167,1192178,2663345,Basketball
11627,2015,203517,Kent State University at Kent,Kent,OH,442420001,1,NCAA Division I-FBS,7546,11343,18889,1,"Public, 4-year or above",2,16,15,2152644,1319008,3471652,2152644,1319008,3471652,Basketball
29067,2016,203517,Kent State University at Kent,Kent,OH,44242,1,NCAA Division I-FBS,7337,11697,19034,1,"Public, 4-year or above",2,15,15,2348157,1496096,3844253,2348157,1496096,3844253,Basketball
46570,2017,203517,Kent State University at Kent,Kent,OH,44242,1,NCAA Division I-FBS,7303,11623,18926,1,"Public, 4-year or above",2,15,15,2227998,1374207,3602205,2227998,1374207,3602205,Basketball
64302,2018,203517,Kent State University at Kent,Kent,OH,44242,1,NCAA Division I-FBS,6976,11460,18436,1,"Public, 4-year or above",2,15,14,2158311,1483140,3641451,2158311,1483140,3641451,Basketball
110902,2019,203517,Kent State University at Kent,Kent,OH,44242,1,NCAA Division I-FBS,6880,11396,18276,1,"Public, 4-year or above",2,16,14,364684,66427,431111,2034026,1392283,3426309,Basketball
40453,2017,157100,Kentucky Christian University,Grayson,KY,41143,4,NCAA Division II with football,267,172,439,2,"Private nonprofit, 4-year or above",2,18,15,61626,61035,122661,61626,61035,122661,Basketball
5555,2015,157058,Kentucky State University,Frankfort,KY,406012355,4,NCAA Division II with football,460,639,1099,1,"Public, 4-year or above",2,16,14,301257,317900,619157,260927,311950,572877,Basketball
22930,2016,157058,Kentucky State University,Frankfort,KY,40601,4,NCAA Division II with football,446,599,1045,1,"Public, 4-year or above",2,16,18,328084,511665,839749,328084,511665,839749,Basketball
40425,2017,157058,Kentucky State University,Frankfort,KY,40601,4,NCAA Division II with football,500,620,1120,1,"Public, 4-year or above",2,15,16,389479,493766,883245,389479,493766,883245,Basketball
58103,2018,157058,Kentucky State University,Frankfort,KY,40601,4,NCAA Division II with football,468,584,1052,1,"Public, 4-year or above",2,16,13,351048,476754,827802,351048,476754,827802,Basketball
90032,2019,157058,Kentucky State University,Frankfort,KY,40601,4,NCAA Division II with football,514,625,1139,1,"Public, 4-year or above",2,16,13,429007,551208,980215,429007,551208,980215,Basketball
5562,2015,157076,Kentucky Wesleyan College,Owensboro,KY,42301,4,NCAA Division II with football,356,309,665,2,"Private nonprofit, 4-year or above",2,15,15,617056,467793,1084849,617056,467793,1084849,Basketball
22937,2016,157076,Kentucky Wesleyan College,Owensboro,KY,42301,4,NCAA Division II with football,344,319,663,2,"Private nonprofit, 4-year or above",2,15,15,607725,516178,1123903,607725,516178,1123903,Basketball
40432,2017,157076,Kentucky Wesleyan College,Owensboro,KY,42301,4,NCAA Division II with football,351,322,673,2,"Private nonprofit, 4-year or above",2,15,14,592900,504187,1097087,592900,504187,1097087,Basketball
58111,2018,157076,Kentucky Wesleyan College,Owensboro,KY,42301,4,NCAA Division II with football,388,365,753,2,"Private nonprofit, 4-year or above",2,16,12,570928,497069,1067997,570928,497069,1067997,Basketball
90040,2019,157076,Kentucky Wesleyan College,Owensboro,KY,42301,4,NCAA Division II with football,411,392,803,2,"Private nonprofit, 4-year or above",2,18,14,733790,606345,1340135,722979,594152,1317131,Basketball
11638,2015,203535,Kenyon College,Gambier,OH,43022,6,NCAA Division III with football,769,929,1698,2,"Private nonprofit, 4-year or above",2,13,14,185676,168683,354359,185676,168683,354359,Basketball
29078,2016,203535,Kenyon College,Gambier,OH,43022,6,NCAA Division III with football,760,928,1688,2,"Private nonprofit, 4-year or above",2,18,13,194755,167965,362720,194755,167965,362720,Basketball
46581,2017,203535,Kenyon College,Gambier,OH,43022,6,NCAA Division III with football,734,927,1661,2,"Private nonprofit, 4-year or above",2,16,12,202917,172423,375340,202917,172423,375340,Basketball
64314,2018,203535,Kenyon College,Gambier,OH,43022,6,NCAA Division III with football,774,945,1719,2,"Private nonprofit, 4-year or above",2,12,17,232470,171069,403539,232470,171069,403539,Basketball
110937,2019,203535,Kenyon College,Gambier,OH,43022,6,NCAA Division III with football,787,947,1734,2,"Private nonprofit, 4-year or above",2,16,16,213397,210029,423426,213397,210029,423426,Basketball
9894,2015,192192,Keuka College,Keuka Park,NY,14478,7,NCAA Division III without football,376,959,1335,2,"Private nonprofit, 4-year or above",2,15,11,106340,102757,209097,106340,102757,209097,Basketball
27313,2016,192192,Keuka College,Keuka Park,NY,14478,7,NCAA Division III without football,374,974,1348,2,"Private nonprofit, 4-year or above",2,16,15,105078,95383,200461,105078,95383,200461,Basketball
44799,2017,192192,Keuka College,Keuka Park,NY,14478,7,NCAA Division III without football,368,941,1309,2,"Private nonprofit, 4-year or above",2,16,16,94137,97149,191286,94137,97149,191286,Basketball
62527,2018,192192,Keuka College,Keuka Park,NY,14478,7,NCAA Division III without football,378,996,1374,2,"Private nonprofit, 4-year or above",2,13,11,89783,87485,177268,89783,87485,177268,Basketball
105069,2019,192192,Keuka College,Keuka Park,NY,14478,7,NCAA Division III without football,374,909,1283,2,"Private nonprofit, 4-year or above",2,16,12,105756,94408,200164,104099,94383,198482,Basketball
12934,2015,213303,Keystone College,La Plume,PA,184400200,7,NCAA Division III without football,467,670,1137,2,"Private nonprofit, 4-year or above",2,19,15,95136,81369,176505,95136,81369,176505,Basketball
30391,2016,213303,Keystone College,La Plume,PA,18440,7,NCAA Division III without football,445,642,1087,2,"Private nonprofit, 4-year or above",2,15,12,88139,84539,172678,88139,84539,172678,Basketball
47888,2017,213303,Keystone College,La Plume,PA,18440,7,NCAA Division III without football,452,613,1065,2,"Private nonprofit, 4-year or above",2,18,12,101178,80935,182113,101178,80935,182113,Basketball
65640,2018,213303,Keystone College,La Plume,PA,18440,7,NCAA Division III without football,437,611,1048,2,"Private nonprofit, 4-year or above",2,17,12,92883,94925,187808,92883,94925,187808,Basketball
115474,2019,213303,Keystone College,La Plume,PA,18440,7,NCAA Division III without football,487,561,1048,2,"Private nonprofit, 4-year or above",2,20,10,91499,100122,191621,91499,100122,191621,Basketball
14405,2015,220516,King University,Bristol,TN,376202699,5,NCAA Division II without football,782,1456,2238,2,"Private nonprofit, 4-year or above",2,36,18,574318,508299,1082617,574318,508299,1082617,Basketball
31867,2016,220516,King University,Bristol,TN,37620,5,NCAA Division II without football,773,1346,2119,2,"Private nonprofit, 4-year or above",2,27,17,536919,472176,1009095,536919,472176,1009095,Basketball
49384,2017,220516,King University,Bristol,TN,37620,5,NCAA Division II without football,624,983,1607,2,"Private nonprofit, 4-year or above",2,36,17,564993,503698,1068691,564993,503698,1068691,Basketball
67153,2018,220516,King University,Bristol,TN,37620,5,NCAA Division II without football,558,900,1458,2,"Private nonprofit, 4-year or above",2,25,15,525920,516905,1042825,525920,516905,1042825,Basketball
120474,2019,220516,King University,Bristol,TN,37620,5,NCAA Division II without football,522,964,1486,2,"Private nonprofit, 4-year or above",2,26,16,512916,505035,1017951,508316,504507,1012823,Basketball
12946,2015,213321,King's College,Wilkes-Barre,PA,187110801,6,NCAA Division III with football,947,853,1800,2,"Private nonprofit, 4-year or above",2,14,16,136820,87254,224074,136820,87254,224074,Basketball
30402,2016,213321,King's College,Wilkes-Barre,PA,18711,6,NCAA Division III with football,1021,882,1903,2,"Private nonprofit, 4-year or above",2,19,14,141409,118306,259715,141409,118306,259715,Basketball
47901,2017,213321,King's College,Wilkes-Barre,PA,18711,6,NCAA Division III with football,1110,914,2024,2,"Private nonprofit, 4-year or above",2,18,14,141376,120901,262277,141376,120901,262277,Basketball
65653,2018,213321,King's College,Wilkes-Barre,PA,18711,6,NCAA Division III with football,1109,956,2065,2,"Private nonprofit, 4-year or above",2,17,12,146429,120242,266671,146429,120242,266671,Basketball
115512,2019,213321,King's College,Wilkes-Barre,PA,18711,6,NCAA Division III with football,1106,934,2040,2,"Private nonprofit, 4-year or above",2,18,12,141493,117941,259434,141493,117941,259434,Basketball
3896,2015,146427,Knox College,Galesburg,IL,614019999,6,NCAA Division III with football,558,810,1368,2,"Private nonprofit, 4-year or above",2,20,17,132097,132746,264843,132097,132746,264843,Basketball
21268,2016,146427,Knox College,Galesburg,IL,61401,6,NCAA Division III with football,539,786,1325,2,"Private nonprofit, 4-year or above",2,22,16,189041,138687,327728,189041,138687,327728,Basketball
38726,2017,146427,Knox College,Galesburg,IL,61401,6,NCAA Division III with football,567,767,1334,2,"Private nonprofit, 4-year or above",2,20,19,146371,147382,293753,146371,147382,293753,Basketball
56386,2018,146427,Knox College,Galesburg,IL,61401,6,NCAA Division III with football,569,740,1309,2,"Private nonprofit, 4-year or above",2,23,16,143804,146490,290294,143804,146490,290294,Basketball
84419,2019,146427,Knox College,Galesburg,IL,61401,6,NCAA Division III with football,527,696,1223,2,"Private nonprofit, 4-year or above",2,24,15,151364,142860,294224,151363,142860,294223,Basketball
12959,2015,213349,Kutztown University of Pennsylvania,Kutztown,PA,195300730,4,NCAA Division II with football,3530,4269,7799,1,"Public, 4-year or above",2,14,13,449001,437970,886971,390968,347800,738768,Basketball
30415,2016,213349,Kutztown University of Pennsylvania,Kutztown,PA,19530,4,NCAA Division II with football,3345,3937,7282,1,"Public, 4-year or above",2,17,13,470671,430116,900787,429404,389899,819303,Basketball
47915,2017,213349,Kutztown University of Pennsylvania,Kutztown,PA,19530,4,NCAA Division II with football,3275,3768,7043,1,"Public, 4-year or above",2,16,15,497140,449508,946648,425672,380956,806628,Basketball
65667,2018,213349,Kutztown University of Pennsylvania,Kutztown,PA,19530,4,NCAA Division II with football,3220,3707,6927,1,"Public, 4-year or above",2,15,13,504151,504075,1008226,432778,389132,821910,Basketball
115550,2019,213349,Kutztown University of Pennsylvania,Kutztown,PA,19530,4,NCAA Division II with football,2903,3540,6443,1,"Public, 4-year or above",2,14,14,516180,471295,987475,445472,369640,815112,Basketball
12973,2015,213358,La Roche College,Pittsburgh,PA,152375898,7,NCAA Division III without football,539,623,1162,2,"Private nonprofit, 4-year or above",2,11,10,62803,69351,132154,61603,65875,127478,Basketball
30429,2016,213358,La Roche College,Pittsburgh,PA,15237,7,NCAA Division III without football,544,607,1151,2,"Private nonprofit, 4-year or above",2,12,13,61011,73613,134624,59417,72056,131473,Basketball
47929,2017,213358,La Roche College,Pittsburgh,PA,15237,7,NCAA Division III without football,551,611,1162,2,"Private nonprofit, 4-year or above",2,13,11,85660,67576,153236,82330,65615,147945,Basketball
65681,2018,213358,La Roche College,Pittsburgh,PA,15237,7,NCAA Division III without football,503,613,1116,2,"Private nonprofit, 4-year or above",2,15,10,88016,90455,178471,76691,85645,162336,Basketball
115588,2019,213358,La Roche University,Pittsburgh,PA,15237,7,NCAA Division III without football,482,588,1070,2,"Private nonprofit, 4-year or above",2,15,10,92896,87730,180626,81776,81640,163416,Basketball
12982,2015,213367,La Salle University,Philadelphia,PA,191411199,3,NCAA Division I without football,1342,2007,3349,2,"Private nonprofit, 4-year or above",2,14,14,2946555,1579669,4526224,2946555,1579669,4526224,Basketball
30438,2016,213367,La Salle University,Philadelphia,PA,19141,3,NCAA Division I without football,1283,1891,3174,2,"Private nonprofit, 4-year or above",2,13,14,3096492,1546002,4642494,3096492,1553762,4650254,Basketball
47938,2017,213367,La Salle University,Philadelphia,PA,19141,3,NCAA Division I without football,1330,1984,3314,2,"Private nonprofit, 4-year or above",2,15,15,3440092,1598651,5038743,3269978,1598651,4868629,Basketball
65690,2018,213367,La Salle University,Philadelphia,PA,19141,3,NCAA Division I without football,1322,2029,3351,2,"Private nonprofit, 4-year or above",2,15,15,3558014,1528939,5086953,3558014,1528939,5086953,Basketball
115598,2019,213367,La Salle University,Philadelphia,PA,19141,3,NCAA Division I without football,1232,1945,3177,2,"Private nonprofit, 4-year or above",2,15,14,3265413,1645605,4911018,3146557,1645605,4792162,Basketball
13001,2015,213385,Lafayette College,Easton,PA,180421768,2,NCAA Division I-FCS,1273,1218,2491,2,"Private nonprofit, 4-year or above",2,14,11,1816334,1860512,3676846,1816334,1860512,3676846,Basketball
30460,2016,213385,Lafayette College,Easton,PA,18042,2,NCAA Division I-FCS,1227,1278,2505,2,"Private nonprofit, 4-year or above",2,14,13,1698999,1845728,3544727,1698999,1845728,3544727,Basketball
47961,2017,213385,Lafayette College,Easton,PA,18042,2,NCAA Division I-FCS,1227,1324,2551,2,"Private nonprofit, 4-year or above",2,13,12,1945129,1839655,3784784,1945129,1839655,3784784,Basketball
65713,2018,213385,Lafayette College,Easton,PA,18042,2,NCAA Division I-FCS,1237,1366,2603,2,"Private nonprofit, 4-year or above",2,15,14,1938231,1960105,3898336,1938231,1960105,3898336,Basketball
115645,2019,213385,Lafayette College,Easton,PA,18042,2,NCAA Division I-FCS,1291,1342,2633,2,"Private nonprofit, 4-year or above",2,15,13,1895736,1938707,3834443,1895736,1938707,3834443,Basketball
3345,2015,140234,LaGrange College,Lagrange,GA,302402999,6,NCAA Division III with football,440,416,856,2,"Private nonprofit, 4-year or above",2,30,20,217223,134346,351569,217223,134346,351569,Basketball
20710,2016,140234,LaGrange College,Lagrange,GA,30240,6,NCAA Division III with football,444,410,854,2,"Private nonprofit, 4-year or above",2,26,16,232944,202071,435015,232944,202071,435015,Basketball
38170,2017,140234,LaGrange College,Lagrange,GA,30240,6,NCAA Division III with football,439,447,886,2,"Private nonprofit, 4-year or above",2,26,15,233491,174712,408203,233491,174712,408203,Basketball
55822,2018,140234,LaGrange College,Lagrange,GA,30240,6,NCAA Division III with football,402,425,827,2,"Private nonprofit, 4-year or above",2,27,17,219487,147179,366666,219487,147179,366666,Basketball
82425,2019,140234,LaGrange College,Lagrange,GA,30240,6,NCAA Division III with football,436,408,844,2,"Private nonprofit, 4-year or above",2,23,18,197226,128831,326057,197226,128831,326057,Basketball
11652,2015,203580,Lake Erie College,Painesville,OH,440773389,4,NCAA Division II with football,406,361,767,2,"Private nonprofit, 4-year or above",2,17,16,500919,442262,943181,500919,442262,943181,Basketball
29092,2016,203580,Lake Erie College,Painesville,OH,44077,4,NCAA Division II with football,383,340,723,2,"Private nonprofit, 4-year or above",2,16,17,518644,392907,911551,518644,392907,911551,Basketball
46595,2017,203580,Lake Erie College,Painesville,OH,44077,4,NCAA Division II with football,353,346,699,2,"Private nonprofit, 4-year or above",2,16,16,456558,335731,792289,456558,335731,792289,Basketball
64328,2018,203580,Lake Erie College,Painesville,OH,44077,4,NCAA Division II with football,337,332,669,2,"Private nonprofit, 4-year or above",2,17,13,474773,297514,772287,474773,297514,772287,Basketball
110953,2019,203580,Lake Erie College,Painesville,OH,44077,4,NCAA Division II with football,358,313,671,2,"Private nonprofit, 4-year or above",2,17,18,447938,429140,877078,447938,429140,877078,Basketball
3915,2015,146481,Lake Forest College,Lake Forest,IL,600452399,6,NCAA Division III with football,678,868,1546,2,"Private nonprofit, 4-year or above",2,13,16,122597,86934,209531,122597,86934,209531,Basketball
21286,2016,146481,Lake Forest College,Lake Forest,IL,600452399,6,NCAA Division III with football,646,856,1502,2,"Private nonprofit, 4-year or above",2,15,17,131484,88693,220177,131484,88693,220177,Basketball
38745,2017,146481,Lake Forest College,Lake Forest,IL,600452338,6,NCAA Division III with football,623,848,1471,2,"Private nonprofit, 4-year or above",2,13,15,128701,119454,248155,128701,119454,248155,Basketball
56405,2018,146481,Lake Forest College,Lake Forest,IL,600452338,6,NCAA Division III with football,621,828,1449,2,"Private nonprofit, 4-year or above",2,15,16,131450,141676,273126,131450,141676,273126,Basketball
84469,2019,146481,Lake Forest College,Lake Forest,IL,600452338,6,NCAA Division III with football,638,871,1509,2,"Private nonprofit, 4-year or above",2,18,15,131777,122648,254425,131777,122648,254425,Basketball
7235,2015,170639,Lake Superior State University,Sault Ste Marie,MI,49783,5,NCAA Division II without football,905,902,1807,1,"Public, 4-year or above",2,16,15,465350,396334,861684,465350,396138,861488,Basketball
24633,2016,170639,Lake Superior State University,Sault Ste Marie,MI,49783,5,NCAA Division II without football,897,914,1811,1,"Public, 4-year or above",2,14,17,461825,441083,902908,461825,441083,902908,Basketball
42135,2017,170639,Lake Superior State University,Sault Ste Marie,MI,49783,5,NCAA Division II without football,839,864,1703,1,"Public, 4-year or above",2,23,18,511183,392866,904049,511183,392866,904049,Basketball
59833,2018,170639,Lake Superior State University,Sault Ste Marie,MI,49783,5,NCAA Division II without football,826,841,1667,1,"Public, 4-year or above",2,26,23,498559,329378,827937,498559,329378,827937,Basketball
95564,2019,170639,Lake Superior State University,Sault Ste Marie,MI,49783,5,NCAA Division II without football,740,798,1538,1,"Public, 4-year or above",2,12,12,571819,439259,1011078,571819,439259,1011078,Basketball
16505,2015,238980,Lakeland College,Plymouth,WI,53073,6,NCAA Division III with football,469,443,912,2,"Private nonprofit, 4-year or above",2,21,14,177151,201461,378612,158831,175614,334445,Basketball
33981,2016,238980,Lakeland University,Plymouth,WI,53073,6,NCAA Division III with football,414,394,808,2,"Private nonprofit, 4-year or above",2,26,24,231787,244460,476247,210142,171945,382087,Basketball
51537,2017,238980,Lakeland University,Plymouth,WI,53073,6,NCAA Division III with football,402,374,776,2,"Private nonprofit, 4-year or above",2,22,23,179269,191578,370847,171953,154892,326845,Basketball
69281,2018,238980,Lakeland University,Plymouth,WI,53073,6,NCAA Division III with football,401,377,778,2,"Private nonprofit, 4-year or above",2,21,26,192707,231479,424186,174229,192479,366708,Basketball
128720,2019,238980,Lakeland University,Plymouth,WI,53073,6,NCAA Division III with football,405,389,794,2,"Private nonprofit, 4-year or above",2,23,26,245677,184697,430374,260820,232437,493257,Basketball
14870,2015,226091,Lamar University,Beaumont,TX,77705,2,NCAA Division I-FCS,2785,3529,6314,1,"Public, 4-year or above",2,15,14,1377911,1066538,2444449,1377911,1046446,2424357,Basketball
32340,2016,226091,Lamar University,Beaumont,TX,77705,2,NCAA Division I-FCS,2709,3452,6161,1,"Public, 4-year or above",2,14,16,1536478,1166815,2703293,1520948,1149088,2670036,Basketball
49863,2017,226091,Lamar University,Beaumont,TX,77705,2,NCAA Division I-FCS,2647,3310,5957,1,"Public, 4-year or above",2,12,15,1433580,1244932,2678512,1417212,1244932,2662144,Basketball
67638,2018,226091,Lamar University,Beaumont,TX,77705,2,NCAA Division I-FCS,2508,3222,5730,1,"Public, 4-year or above",2,13,14,1405823,1272926,2678749,1384151,1247747,2631898,Basketball
122465,2019,226091,Lamar University,Beaumont,TX,77705,2,NCAA Division I-FCS,2276,2961,5237,1,"Public, 4-year or above",2,14,12,1444668,1126343,2571011,1391150,1114110,2505260,Basketball
13014,2015,213400,Lancaster Bible College,Lancaster,PA,176015036,7,NCAA Division III without football,422,419,841,2,"Private nonprofit, 4-year or above",2,17,11,84864,65213,150077,77332,62319,139651,Basketball
30473,2016,213400,Lancaster Bible College,Lancaster,PA,17601,7,NCAA Division III without football,384,440,824,2,"Private nonprofit, 4-year or above",2,15,10,91091,74625,165716,89881,74574,164455,Basketball
47974,2017,213400,Lancaster Bible College,Lancaster,PA,17601,7,NCAA Division III without football,420,470,890,2,"Private nonprofit, 4-year or above",2,24,10,98074,66778,164852,85865,62779,148644,Basketball
65726,2018,213400,Lancaster Bible College,Lancaster,PA,17601,7,NCAA Division III without football,474,512,986,2,"Private nonprofit, 4-year or above",2,21,11,74238,70928,145166,74238,70928,145166,Basketball
115659,2019,213400,Lancaster Bible College,Lancaster,PA,17601,7,NCAA Division III without football,466,528,994,2,"Private nonprofit, 4-year or above",2,30,14,111230,96522,207752,111230,96522,207752,Basketball
14027,2015,218229,Lander University,Greenwood,SC,296492099,5,NCAA Division II without football,756,1688,2444,1,"Public, 4-year or above",2,15,13,857896,809295,1667191,698704,669948,1368652,Basketball
31484,2016,218229,Lander University,Greenwood,SC,29649,5,NCAA Division II without football,783,1746,2529,1,"Public, 4-year or above",2,16,16,581165,611839,1193004,591196,609851,1201047,Basketball
48996,2017,218229,Lander University,Greenwood,SC,29649,5,NCAA Division II without football,824,1759,2583,1,"Public, 4-year or above",2,17,14,755084,751913,1506997,714951,716552,1431503,Basketball
66757,2018,218229,Lander University,Greenwood,SC,29649,5,NCAA Division II without football,870,1889,2759,1,"Public, 4-year or above",2,20,14,877945,851941,1729886,680399,686913,1367312,Basketball
118877,2019,218229,Lander University,Greenwood,SC,29649,5,NCAA Division II without football,932,2003,2935,1,"Public, 4-year or above",2,17,15,880178,819056,1699234,730617,687829,1418446,Basketball
14417,2015,220598,Lane College,Jackson,TN,383014598,4,NCAA Division II with football,731,620,1351,2,"Private nonprofit, 4-year or above",2,15,15,289933,205261,495194,289933,205261,495194,Basketball
31879,2016,220598,Lane College,Jackson,TN,38301,4,NCAA Division II with football,711,645,1356,2,"Private nonprofit, 4-year or above",2,15,14,305530,239949,545479,305530,239949,545479,Basketball
49396,2017,220598,Lane College,Jackson,TN,38301,4,NCAA Division II with football,735,635,1370,2,"Private nonprofit, 4-year or above",2,12,14,305387,251165,556552,305387,251165,556552,Basketball
67165,2018,220598,Lane College,Jackson,TN,38301,4,NCAA Division II with football,618,566,1184,2,"Private nonprofit, 4-year or above",2,16,12,627532,331455,958987,627532,331455,958987,Basketball
120512,2019,220598,Lane College,Jackson,TN,38301,4,NCAA Division II with football,611,628,1239,2,"Private nonprofit, 4-year or above",2,19,17,341260,323495,664755,341260,323495,664755,Basketball
6620,2015,166391,Lasell College,Newton,MA,2466,7,NCAA Division III without football,611,1177,1788,2,"Private nonprofit, 4-year or above",2,17,17,58511,58383,116894,55259,54063,109322,Basketball
24007,2016,166391,Lasell College,Newton,MA,2466,7,NCAA Division III without football,605,1142,1747,2,"Private nonprofit, 4-year or above",2,17,9,57101,57941,115042,61378,54305,115683,Basketball
41519,2017,166391,Lasell College,Newton,MA,2466,7,NCAA Division III without football,606,1063,1669,2,"Private nonprofit, 4-year or above",2,19,14,58366,64634,123000,58292,63984,122276,Basketball
59216,2018,166391,Lasell College,Newton,MA,2466,7,NCAA Division III without football,581,1042,1623,2,"Private nonprofit, 4-year or above",2,17,18,59803,60613,120416,62073,59909,121982,Basketball
93779,2019,166391,Lasell University,Newton,MA,2466,7,NCAA Division III without football,576,1028,1604,2,"Private nonprofit, 4-year or above",2,16,13,57405,55267,112672,58540,52085,110625,Basketball
16516,2015,239017,Lawrence University,Appleton,WI,54911,6,NCAA Division III with football,669,825,1494,2,"Private nonprofit, 4-year or above",2,11,11,113720,100690,214410,108867,89143,198010,Basketball
33992,2016,239017,Lawrence University,Appleton,WI,54911,6,NCAA Division III with football,683,809,1492,2,"Private nonprofit, 4-year or above",2,16,10,124994,96989,221983,119625,95359,214984,Basketball
51548,2017,239017,Lawrence University,Appleton,WI,54911,6,NCAA Division III with football,655,763,1418,2,"Private nonprofit, 4-year or above",2,24,15,158414,113702,272116,156544,113715,270259,Basketball
69292,2018,239017,Lawrence University,Appleton,WI,54911,6,NCAA Division III with football,653,751,1404,2,"Private nonprofit, 4-year or above",2,24,15,161567,129067,290634,163831,118351,282182,Basketball
128758,2019,239017,Lawrence University,Appleton,WI,54911,6,NCAA Division III with football,643,754,1397,2,"Private nonprofit, 4-year or above",2,18,15,148317,115031,263348,165703,126132,291835,Basketball
9905,2015,192323,Le Moyne College,Syracuse,NY,132141301,5,NCAA Division II without football,1075,1412,2487,2,"Private nonprofit, 4-year or above",2,14,13,716412,587411,1303823,644741,584011,1228752,Basketball
27323,2016,192323,Le Moyne College,Syracuse,NY,13214,5,NCAA Division II without football,1058,1473,2531,2,"Private nonprofit, 4-year or above",2,13,12,716032,700912,1416944,716032,700912,1416944,Basketball
44809,2017,192323,Le Moyne College,Syracuse,NY,13214,5,NCAA Division II without football,1030,1368,2398,2,"Private nonprofit, 4-year or above",2,12,12,818351,714327,1532678,786898,707911,1494809,Basketball
62537,2018,192323,Le Moyne College,Syracuse,NY,13214,5,NCAA Division II without football,1015,1333,2348,2,"Private nonprofit, 4-year or above",2,14,13,783115,763355,1546470,756950,757604,1514554,Basketball
105080,2019,192323,Le Moyne College,Syracuse,NY,13214,5,NCAA Division II without football,1006,1378,2384,2,"Private nonprofit, 4-year or above",2,13,12,728823,745584,1474407,712804,724093,1436897,Basketball
14425,2015,220604,Le Moyne-Owen College,Memphis,TN,381266595,5,NCAA Division II without football,301,535,836,2,"Private nonprofit, 4-year or above",2,15,12,188437,162116,350553,188437,162116,350553,Basketball
31887,2016,220604,Le Moyne-Owen College,Memphis,TN,38126,5,NCAA Division II without football,277,570,847,2,"Private nonprofit, 4-year or above",2,15,12,234131,178630,412761,234131,178630,412761,Basketball
49404,2017,220604,Le Moyne-Owen College,Memphis,TN,38126,5,NCAA Division II without football,255,515,770,2,"Private nonprofit, 4-year or above",2,16,17,305437,256058,561495,305437,256058,561495,Basketball
67173,2018,220604,Le Moyne-Owen College,Memphis,TN,38126,5,NCAA Division II without football,237,524,761,2,"Private nonprofit, 4-year or above",2,16,14,179548,161778,341326,179548,161778,341326,Basketball
120550,2019,220604,Le Moyne-Owen College,Memphis,TN,38126,5,NCAA Division II without football,256,493,749,2,"Private nonprofit, 4-year or above",2,13,13,426648,267193,693841,426648,267193,693841,Basketball
13022,2015,213507,Lebanon Valley College,Annville,PA,170031400,6,NCAA Division III with football,743,860,1603,2,"Private nonprofit, 4-year or above",2,18,13,166895,134602,301497,166895,134602,301497,Basketball
30481,2016,213507,Lebanon Valley College,Annville,PA,17003,6,NCAA Division III with football,733,865,1598,2,"Private nonprofit, 4-year or above",2,19,11,201859,121289,323148,201859,117611,319470,Basketball
47982,2017,213507,Lebanon Valley College,Annville,PA,17003,6,NCAA Division III with football,734,884,1618,2,"Private nonprofit, 4-year or above",2,18,12,163972,123520,287492,161525,120575,282100,Basketball
65736,2018,213507,Lebanon Valley College,Annville,PA,17003,6,NCAA Division III with football,768,881,1649,2,"Private nonprofit, 4-year or above",2,15,13,159739,156904,316643,146609,139217,285826,Basketball
115697,2019,213507,Lebanon Valley College,Annville,PA,17003,6,NCAA Division III with football,753,880,1633,2,"Private nonprofit, 4-year or above",2,18,9,157808,110132,267940,147498,110132,257630,Basketball
14432,2015,220613,Lee University,Cleveland,TN,37311,5,NCAA Division II without football,1508,2272,3780,2,"Private nonprofit, 4-year or above",2,17,14,519124,534730,1053854,519124,534730,1053854,Basketball
31894,2016,220613,Lee University,Cleveland,TN,37311,5,NCAA Division II without football,1423,2398,3821,2,"Private nonprofit, 4-year or above",2,17,16,595149,575114,1170263,595149,575114,1170263,Basketball
49411,2017,220613,Lee University,Cleveland,TN,37311,5,NCAA Division II without football,1389,2459,3848,2,"Private nonprofit, 4-year or above",2,16,15,576701,619345,1196046,576701,619345,1196046,Basketball
67180,2018,220613,Lee University,Cleveland,TN,37311,5,NCAA Division II without football,1361,2412,3773,2,"Private nonprofit, 4-year or above",2,14,18,593051,636243,1229294,593051,636243,1229294,Basketball
120588,2019,220613,Lee University,Cleveland,TN,37311,5,NCAA Division II without football,1380,2294,3674,2,"Private nonprofit, 4-year or above",2,11,15,604754,629287,1234041,604754,629287,1234041,Basketball
10974,2015,198808,Lees-McRae College,Banner Elk,NC,28604,5,NCAA Division II without football,352,675,1027,2,"Private nonprofit, 4-year or above",2,28,15,401036,358043,759079,401037,358043,759080,Basketball
28416,2016,198808,Lees-McRae College,Banner Elk,NC,28604,5,NCAA Division II without football,332,646,978,2,"Private nonprofit, 4-year or above",2,24,15,422055,307121,729176,422055,307121,729176,Basketball
45912,2017,198808,Lees-McRae College,Banner Elk,NC,28604,5,NCAA Division II without football,294,597,891,2,"Private nonprofit, 4-year or above",2,23,17,406124,332678,738802,395723,326533,722256,Basketball
63631,2018,198808,Lees-McRae College,Banner Elk,NC,28604,5,NCAA Division II without football,325,590,915,2,"Private nonprofit, 4-year or above",2,29,19,449455,360473,809928,449455,360473,809928,Basketball
108431,2019,198808,Lees-McRae College,Banner Elk,NC,28604,5,NCAA Division II without football,260,534,794,2,"Private nonprofit, 4-year or above",2,19,18,428668,392878,821546,428668,392878,821546,Basketball
13043,2015,213543,Lehigh University,Bethlehem,PA,18015,2,NCAA Division I-FCS,2758,2228,4986,2,"Private nonprofit, 4-year or above",2,14,15,1482439,1497357,2979796,1482439,1497357,2979796,Basketball
30502,2016,213543,Lehigh University,Bethlehem,PA,18015,2,NCAA Division I-FCS,2801,2189,4990,2,"Private nonprofit, 4-year or above",2,14,15,1614580,1550238,3164818,1614580,1550238,3164818,Basketball
48004,2017,213543,Lehigh University,Bethlehem,PA,18015,2,NCAA Division I-FCS,2725,2275,5000,2,"Private nonprofit, 4-year or above",2,14,15,1646395,1610242,3256637,1646395,1610242,3256637,Basketball
65758,2018,213543,Lehigh University,Bethlehem,PA,18015,2,NCAA Division I-FCS,2690,2282,4972,2,"Private nonprofit, 4-year or above",2,16,15,1725866,1709148,3435014,1725866,1709148,3435014,Basketball
115749,2019,213543,Lehigh University,Bethlehem,PA,18015,2,NCAA Division I-FCS,2731,2367,5098,2,"Private nonprofit, 4-year or above",2,14,16,1779793,1834548,3614341,1779793,1834548,3614341,Basketball
10989,2015,198835,Lenoir-Rhyne University,Hickory,NC,28601,4,NCAA Division II with football,600,753,1353,2,"Private nonprofit, 4-year or above",2,17,17,652052,595311,1247363,652052,595311,1247363,Basketball
28430,2016,198835,Lenoir-Rhyne University,Hickory,NC,28601,4,NCAA Division II with football,603,845,1448,2,"Private nonprofit, 4-year or above",2,16,15,546339,640407,1186746,546339,640407,1186746,Basketball
45925,2017,198835,Lenoir-Rhyne University,Hickory,NC,28601,4,NCAA Division II with football,608,815,1423,2,"Private nonprofit, 4-year or above",2,17,14,718290,532146,1250436,718290,532146,1250436,Basketball
63645,2018,198835,Lenoir-Rhyne University,Hickory,NC,28601,4,NCAA Division II with football,654,895,1549,2,"Private nonprofit, 4-year or above",2,17,16,768524,609280,1377804,768524,609280,1377804,Basketball
108480,2019,198835,Lenoir-Rhyne University,Hickory,NC,28601,4,NCAA Division II with football,680,895,1575,2,"Private nonprofit, 4-year or above",2,17,15,757892,607069,1364961,757892,607069,1364961,Basketball
6628,2015,166452,Lesley University,Cambridge,MA,21382790,7,NCAA Division III without football,348,1113,1461,2,"Private nonprofit, 4-year or above",2,12,10,31835,30173,62008,31835,30173,62008,Basketball
24015,2016,166452,Lesley University,Cambridge,MA,2138,7,NCAA Division III without football,355,1177,1532,2,"Private nonprofit, 4-year or above",2,12,10,36995,30602,67597,36995,30602,67597,Basketball
41527,2017,166452,Lesley University,Cambridge,MA,2138,7,NCAA Division III without football,352,1281,1633,2,"Private nonprofit, 4-year or above",2,11,13,42864,42305,85169,42864,42305,85169,Basketball
59224,2018,166452,Lesley University,Cambridge,MA,2138,7,NCAA Division III without football,347,1340,1687,2,"Private nonprofit, 4-year or above",2,13,8,25110,22282,47392,25110,22282,47392,Basketball
93817,2019,166452,Lesley University,Cambridge,MA,2138,7,NCAA Division III without football,365,1221,1586,2,"Private nonprofit, 4-year or above",2,11,8,35802,20466,56268,35802,20466,56268,Basketball
14895,2015,226231,LeTourneau University,Longview,TX,75602,7,NCAA Division III without football,832,411,1243,2,"Private nonprofit, 4-year or above",2,18,19,152311,151912,304223,136836,146978,283814,Basketball
32365,2016,226231,LeTourneau University,Longview,TX,75602,7,NCAA Division III without football,823,422,1245,2,"Private nonprofit, 4-year or above",2,25,17,184644,151062,335706,158717,143235,301952,Basketball
49888,2017,226231,LeTourneau University,Longview,TX,75602,7,NCAA Division III without football,837,431,1268,2,"Private nonprofit, 4-year or above",2,18,20,186724,158013,344737,158511,143762,302273,Basketball
67663,2018,226231,LeTourneau University,Longview,TX,75602,7,NCAA Division III without football,816,452,1268,2,"Private nonprofit, 4-year or above",2,19,17,172855,149453,322308,169118,138470,307588,Basketball
122624,2019,226231,LeTourneau University,Longview,TX,75602,7,NCAA Division III without football,865,441,1306,2,"Private nonprofit, 4-year or above",2,17,20,173489,148445,321934,171149,149947,321096,Basketball
12330,2015,209056,Lewis & Clark College,Portland,OR,972197899,6,NCAA Division III with football,786,1292,2078,2,"Private nonprofit, 4-year or above",2,15,14,184512,123923,308435,184512,123923,308435,Basketball
29775,2016,209056,Lewis & Clark College,Portland,OR,97219,6,NCAA Division III with football,768,1256,2024,2,"Private nonprofit, 4-year or above",2,17,14,173838,135667,309505,173838,135667,309505,Basketball
47270,2017,209056,Lewis & Clark College,Portland,OR,97219,6,NCAA Division III with football,826,1181,2007,2,"Private nonprofit, 4-year or above",2,15,15,195759,156528,352287,195759,156528,352287,Basketball
65015,2018,209056,Lewis & Clark College,Portland,OR,97219,6,NCAA Division III with football,774,1226,2000,2,"Private nonprofit, 4-year or above",2,17,14,191464,160975,352439,191464,160975,352439,Basketball
113460,2019,209056,Lewis & Clark College,Portland,OR,97219,6,NCAA Division III with football,728,1159,1887,2,"Private nonprofit, 4-year or above",2,16,12,150244,137141,287385,150244,137142,287386,Basketball
3937,2015,146612,Lewis University,Romeoville,IL,604462200,5,NCAA Division II without football,1693,2114,3807,2,"Private nonprofit, 4-year or above",2,15,14,571576,594573,1166149,571576,594573,1166149,Basketball
21308,2016,146612,Lewis University,Romeoville,IL,60446,5,NCAA Division II without football,1732,2009,3741,2,"Private nonprofit, 4-year or above",2,15,17,585089,562579,1147668,585089,562579,1147668,Basketball
38769,2017,146612,Lewis University,Romeoville,IL,60446,5,NCAA Division II without football,1714,1971,3685,2,"Private nonprofit, 4-year or above",2,15,18,654943,613665,1268608,654943,613665,1268608,Basketball
56429,2018,146612,Lewis University,Romeoville,IL,60446,5,NCAA Division II without football,1733,1842,3575,2,"Private nonprofit, 4-year or above",2,14,14,661650,605979,1267629,661650,605979,1267629,Basketball
84558,2019,146612,Lewis University,Romeoville,IL,60446,5,NCAA Division II without football,1720,1821,3541,2,"Private nonprofit, 4-year or above",2,16,16,669018,611073,1280091,669018,611073,1280091,Basketball
15703,2015,232557,Liberty University,Lynchburg,VA,24515,2,NCAA Division I-FCS,11870,15775,27645,2,"Private nonprofit, 4-year or above",2,14,18,3720371,2175898,5896269,3720371,2175898,5896269,Basketball
33175,2016,232557,Liberty University,Lynchburg,VA,24515,2,NCAA Division I-FCS,11494,15606,27100,2,"Private nonprofit, 4-year or above",2,16,17,2856213,1801761,4657974,2856213,1801761,4657974,Basketball
50718,2017,232557,Liberty University,Lynchburg,VA,24515,2,NCAA Division I-FCS,11157,15703,26860,2,"Private nonprofit, 4-year or above",2,16,18,2735684,1968693,4704377,2735684,1968693,4704377,Basketball
68467,2018,232557,Liberty University,Lynchburg,VA,24515,1,NCAA Division I-FBS,11212,16156,27368,2,"Private nonprofit, 4-year or above",2,14,16,3400852,2449947,5850799,3400852,2449947,5850799,Basketball
125704,2019,232557,Liberty University,Lynchburg,VA,24515,1,NCAA Division I-FBS,11613,16821,28434,2,"Private nonprofit, 4-year or above",2,16,16,3528543,2191777,5720320,3528543,2191777,5720320,Basketball
14034,2015,218238,Limestone College,Gaffney,SC,293403799,4,NCAA Division II with football,1091,1160,2251,2,"Private nonprofit, 4-year or above",2,15,23,498258,475118,973376,498258,475118,973376,Basketball
31491,2016,218238,Limestone College,Gaffney,SC,29340,4,NCAA Division II with football,1005,1151,2156,2,"Private nonprofit, 4-year or above",2,27,20,489406,451616,941022,489406,451616,941022,Basketball
49004,2017,218238,Limestone College,Gaffney,SC,29340,4,NCAA Division II with football,935,1006,1941,2,"Private nonprofit, 4-year or above",2,30,17,487464,446907,934371,487464,446907,934371,Basketball
66765,2018,218238,Limestone College,Gaffney,SC,29340,4,NCAA Division II with football,835,961,1796,2,"Private nonprofit, 4-year or above",2,26,18,490713,481485,972198,490713,481485,972198,Basketball
118887,2019,218238,Limestone College,Gaffney,SC,29340,4,NCAA Division II with football,782,865,1647,2,"Private nonprofit, 4-year or above",2,31,18,527664,463174,990838,527664,463174,990838,Basketball
14440,2015,220631,Lincoln Memorial University,Harrogate,TN,377529900,5,NCAA Division II without football,362,776,1138,2,"Private nonprofit, 4-year or above",2,21,20,631136,496404,1127540,631136,482477,1113613,Basketball
31903,2016,220631,Lincoln Memorial University,Harrogate,TN,37752,5,NCAA Division II without football,411,778,1189,2,"Private nonprofit, 4-year or above",2,23,16,977272,640353,1617625,977272,640353,1617625,Basketball
49420,2017,220631,Lincoln Memorial University,Harrogate,TN,37752,5,NCAA Division II without football,457,883,1340,2,"Private nonprofit, 4-year or above",2,18,18,985919,596823,1582742,985919,596823,1582742,Basketball
67189,2018,220631,Lincoln Memorial University,Harrogate,TN,37752,5,NCAA Division II without football,442,942,1384,2,"Private nonprofit, 4-year or above",2,20,15,943670,554820,1498490,943670,554820,1498490,Basketball
120626,2019,220631,Lincoln Memorial University,Harrogate,TN,37752,5,NCAA Division II without football,483,931,1414,2,"Private nonprofit, 4-year or above",2,19,17,1085128,611294,1696422,1080002,524789,1604791,Basketball
8185,2015,177940,Lincoln University,Jefferson City,MO,65101,4,NCAA Division II with football,898,1013,1911,1,"Public, 4-year or above",2,13,15,351330,304130,655460,351330,304130,655460,Basketball
25612,2016,177940,Lincoln University,Jefferson City,MO,65101,4,NCAA Division II with football,803,1023,1826,1,"Public, 4-year or above",2,15,13,382810,328777,711587,382810,328777,711587,Basketball
30516,2016,213598,Lincoln University,Lincoln University,PA,19352,4,NCAA Division II with football,619,1048,1667,1,"Public, 4-year or above",2,17,14,541698,421738,963436,541698,421738,963436,Basketball
43102,2017,177940,Lincoln University,Jefferson City,MO,65101,4,NCAA Division II with football,790,984,1774,1,"Public, 4-year or above",2,14,14,355373,330831,686204,355373,325768,681141,Basketball
48018,2017,213598,Lincoln University,Lincoln University,PA,19352,4,NCAA Division II with football,621,1205,1826,1,"Public, 4-year or above",2,13,14,414921,435029,849950,414921,435029,849950,Basketball
60819,2018,177940,Lincoln University,Jefferson City,MO,65101,4,NCAA Division II with football,685,964,1649,1,"Public, 4-year or above",2,13,13,424025,349142,773167,424025,346669,770694,Basketball
65772,2018,213598,Lincoln University,Lincoln University,PA,19352,4,NCAA Division II with football,673,1288,1961,1,"Public, 4-year or above",2,16,15,450377,487289,937666,450377,487289,937666,Basketball
99094,2019,177940,Lincoln University,Jefferson City,MO,65101,4,NCAA Division II with football,573,941,1514,1,"Public, 4-year or above",2,15,12,344359,290959,635318,340202,289915,630117,Basketball
115787,2019,213598,Lincoln University,Lincoln University,PA,19352,4,NCAA Division II with football,647,1252,1899,1,"Public, 4-year or above",2,14,17,449302,534275,983577,449302,534275,983577,Basketball
8193,2015,177968,Lindenwood University,Saint Charles,MO,633011695,4,NCAA Division II with football,3318,3908,7226,2,"Private nonprofit, 4-year or above",2,29,27,846915,637534,1484449,846915,637534,1484449,Basketball
25619,2016,177968,Lindenwood University,Saint Charles,MO,63301,4,NCAA Division II with football,3155,3600,6755,2,"Private nonprofit, 4-year or above",2,31,32,835100,855717,1690817,835100,855717,1690817,Basketball
43109,2017,177968,Lindenwood University,Saint Charles,MO,63301,4,NCAA Division II with football,2893,3299,6192,2,"Private nonprofit, 4-year or above",2,75,75,925097,856809,1781906,925097,856809,1781906,Basketball
60826,2018,177968,Lindenwood University,Saint Charles,MO,63301,4,NCAA Division II with football,2760,3195,5955,2,"Private nonprofit, 4-year or above",2,63,56,910699,766475,1677174,910699,766475,1677174,Basketball
99131,2019,177968,Lindenwood University,Saint Charles,MO,63301,4,NCAA Division II with football,2290,2708,4998,2,"Private nonprofit, 4-year or above",2,41,35,786113,795380,1581493,786114,795381,1581495,Basketball
12342,2015,209065,Linfield College-McMinnville Campus,McMinnville,OR,971286894,6,NCAA Division III with football,654,981,1635,2,"Private nonprofit, 4-year or above",2,19,14,175711,136736,312447,175711,134176,309887,Basketball
29788,2016,209065,Linfield College-McMinnville Campus,McMinnville,OR,97128,6,NCAA Division III with football,595,989,1584,2,"Private nonprofit, 4-year or above",2,17,16,179099,132329,311428,179099,132329,311428,Basketball
47282,2017,209065,Linfield College-McMinnville Campus,McMinnville,OR,97128,6,NCAA Division III with football,590,891,1481,2,"Private nonprofit, 4-year or above",2,19,13,211274,152448,363722,211274,152448,363722,Basketball
65027,2018,209065,Linfield College-McMinnville Campus,McMinnville,OR,97128,6,NCAA Division III with football,521,792,1313,2,"Private nonprofit, 4-year or above",2,20,11,212728,188267,400995,209133,163219,372352,Basketball
113498,2019,209065,Linfield College-McMinnville Campus,McMinnville,OR,97128,6,NCAA Division III with football,522,841,1363,2,"Private nonprofit, 4-year or above",2,19,20,217857,222868,440725,225126,194160,419286,Basketball
14347,2015,219976,Lipscomb University,Nashville,TN,372043951,3,NCAA Division I without football,1039,1685,2724,2,"Private nonprofit, 4-year or above",2,15,12,1756611,1342361,3098972,1756611,1342361,3098972,Basketball
31811,2016,219976,Lipscomb University,Nashville,TN,37204,3,NCAA Division I without football,1024,1627,2651,2,"Private nonprofit, 4-year or above",2,15,19,1625556,1500739,3126295,1624416,1496472,3120888,Basketball
49329,2017,219976,Lipscomb University,Nashville,TN,37204,3,NCAA Division I without football,1074,1648,2722,2,"Private nonprofit, 4-year or above",2,15,15,1776627,1426489,3203116,1776627,1426489,3203116,Basketball
67101,2018,219976,Lipscomb University,Nashville,TN,37204,3,NCAA Division I without football,1066,1670,2736,2,"Private nonprofit, 4-year or above",2,15,16,2228677,1473559,3702236,2228677,1473559,3702236,Basketball
120200,2019,219976,Lipscomb University,Nashville,TN,372043951,3,NCAA Division I without football,1063,1614,2677,2,"Private nonprofit, 4-year or above",2,16,17,1872429,1521761,3394190,1872429,1521761,3394190,Basketball
9915,2015,192439,LIU Brooklyn,Brooklyn,NY,112018423,3,NCAA Division I without football,1302,2736,4038,2,"Private nonprofit, 4-year or above",2,16,15,1805546,1517343,3322889,1805546,1517343,3322889,Basketball
27333,2016,192439,LIU Brooklyn,Brooklyn,NY,11201,3,NCAA Division I without football,1174,2575,3749,2,"Private nonprofit, 4-year or above",2,15,14,1950050,1544552,3494602,1950050,1544552,3494602,Basketball
44819,2017,192439,LIU Brooklyn,Brooklyn,NY,11201,3,NCAA Division I without football,1009,2384,3393,2,"Private nonprofit, 4-year or above",2,13,14,2779924,1585691,4365615,2779924,1585691,4365615,Basketball
9928,2015,192448,LIU Post,Brookville,NY,115481327,4,NCAA Division II with football,1221,1839,3060,2,"Private nonprofit, 4-year or above",2,18,15,672229,631510,1303739,672229,631510,1303739,Basketball
27347,2016,192448,LIU Post,Brookville,NY,11548,4,NCAA Division II with football,1156,1682,2838,2,"Private nonprofit, 4-year or above",2,16,15,696482,629072,1325554,696482,629072,1325554,Basketball
44833,2017,192448,LIU Post,Brookville,NY,11548,4,NCAA Division II with football,1133,1668,2801,2,"Private nonprofit, 4-year or above",2,16,16,654075,665820,1319895,654075,665820,1319895,Basketball
62547,2018,192448,LIU Post,Brookville,NY,11548,4,NCAA Division II with football,1896,3744,5640,2,"Private nonprofit, 4-year or above",2,23,29,3062619,2356891,5419510,3062619,2356891,5419510,Basketball
11001,2015,198862,Livingstone College,Salisbury,NC,28144,4,NCAA Division II with football,630,619,1249,2,"Private nonprofit, 4-year or above",2,19,14,412009,302225,714234,412009,302225,714234,Basketball
28440,2016,198862,Livingstone College,Salisbury,NC,28144,4,NCAA Division II with football,580,602,1182,2,"Private nonprofit, 4-year or above",2,24,16,495145,260384,755529,495145,260384,755529,Basketball
45935,2017,198862,Livingstone College,Salisbury,NC,28144,4,NCAA Division II with football,575,558,1133,2,"Private nonprofit, 4-year or above",2,30,18,455151,241344,696495,455151,241344,696495,Basketball
63655,2018,198862,Livingstone College,Salisbury,NC,28144,4,NCAA Division II with football,565,574,1139,2,"Private nonprofit, 4-year or above",2,33,12,629905,397389,1027294,629905,397389,1027294,Basketball
108515,2019,198862,Livingstone College,Salisbury,NC,28144,4,NCAA Division II with football,560,543,1103,2,"Private nonprofit, 4-year or above",2,32,12,463227,243996,707223,463227,243996,707223,Basketball
13064,2015,213613,Lock Haven University,Lock Haven,PA,177452390,4,NCAA Division II with football,1702,2172,3874,1,"Public, 4-year or above",2,16,16,312022,302625,614647,333923,290487,624410,Basketball
30523,2016,213613,Lock Haven University,Lock Haven,PA,17745,4,NCAA Division II with football,1547,1975,3522,1,"Public, 4-year or above",2,14,16,325738,290990,616728,303340,291888,595228,Basketball
48025,2017,213613,Lock Haven University,Lock Haven,PA,17745,4,NCAA Division II with football,1380,1786,3166,1,"Public, 4-year or above",2,15,17,314465,284746,599211,321532,289953,611485,Basketball
65779,2018,213613,Lock Haven University,Lock Haven,PA,17745,4,NCAA Division II with football,1209,1573,2782,1,"Public, 4-year or above",2,14,18,364726,305438,670164,328564,307328,635892,Basketball
115825,2019,213613,Lock Haven University,Lock Haven,PA,17745,4,NCAA Division II with football,1035,1430,2465,1,"Public, 4-year or above",2,14,16,373200,355766,728966,349751,324505,674256,Basketball
105118,2019,192448,Long Island University,Brookville,NY,11548,2,NCAA Division I-FCS,1835,3699,5534,2,"Private nonprofit, 4-year or above",2,16,14,2537572,1886537,4424109,2537572,1886537,4424109,Basketball
15715,2015,232566,Longwood University,Farmville,VA,23909,3,NCAA Division I without football,1351,2780,4131,1,"Public, 4-year or above",2,16,17,1919660,1042223,2961883,1466648,1157059,2623707,Basketball
33187,2016,232566,Longwood University,Farmville,VA,23909,3,NCAA Division I without football,1290,2661,3951,1,"Public, 4-year or above",2,19,18,1709008,1293956,3002964,1709008,1293956,3002964,Basketball
50730,2017,232566,Longwood University,Farmville,VA,23909,3,NCAA Division I without football,1323,2627,3950,1,"Public, 4-year or above",2,17,22,1893456,1234576,3128032,1774475,1234576,3009051,Basketball
68479,2018,232566,Longwood University,Farmville,VA,23909,3,NCAA Division I without football,1234,2547,3781,1,"Public, 4-year or above",2,15,17,1837437,1084471,2921908,1640350,1162809,2803159,Basketball
125742,2019,232566,Longwood University,Farmville,VA,23909,3,NCAA Division I without football,1121,2312,3433,1,"Public, 4-year or above",2,15,22,1614612,923519,2538131,1829908,1286089,3115997,Basketball
4920,2015,153825,Loras College,Dubuque,IA,520040178,6,NCAA Division III with football,739,678,1417,2,"Private nonprofit, 4-year or above",2,31,22,201058,152222,353280,201058,152222,353280,Basketball
22281,2016,153825,Loras College,Dubuque,IA,52004,6,NCAA Division III with football,731,669,1400,2,"Private nonprofit, 4-year or above",2,28,30,235118,153030,388148,235118,153030,388148,Basketball
39757,2017,153825,Loras College,Dubuque,IA,52004,6,NCAA Division III with football,694,641,1335,2,"Private nonprofit, 4-year or above",2,39,26,251785,162518,414303,251785,162518,414303,Basketball
57425,2018,153825,Loras College,Dubuque,IA,52004,6,NCAA Division III with football,730,609,1339,2,"Private nonprofit, 4-year or above",2,41,31,345421,186626,532047,345421,186626,532047,Basketball
88075,2019,153825,Loras College,Dubuque,IA,52004,6,NCAA Division III with football,705,555,1260,2,"Private nonprofit, 4-year or above",2,31,30,282676,259969,542645,282676,259969,542645,Basketball
5772,2015,159568,Louisiana College,Pineville,LA,71359,6,NCAA Division III with football,456,399,855,2,"Private nonprofit, 4-year or above",2,16,16,167673,125671,293344,167673,125671,293344,Basketball
23152,2016,159568,Louisiana College,Pineville,LA,71359,6,NCAA Division III with football,447,383,830,2,"Private nonprofit, 4-year or above",2,23,27,233097,187650,420747,233097,187650,420747,Basketball
40649,2017,159568,Louisiana College,Pineville,LA,71359,6,NCAA Division III with football,474,388,862,2,"Private nonprofit, 4-year or above",2,20,19,200877,135725,336602,200877,135725,336602,Basketball
58336,2018,159568,Louisiana College,Pineville,LA,71359,6,NCAA Division III with football,472,411,883,2,"Private nonprofit, 4-year or above",2,15,17,200899,137298,338197,200899,137298,338197,Basketball
90820,2019,159568,Louisiana College,Pineville,LA,71359,6,NCAA Division III with football,469,420,889,2,"Private nonprofit, 4-year or above",2,18,17,197180,139434,336614,197180,139434,336614,Basketball
5753,2015,159391,Louisiana State University and Agricultural & Mechanical College,Baton Rouge,LA,708032750,1,NCAA Division I-FBS,11211,12239,23450,1,"Public, 4-year or above",2,14,18,8676366,308100,8984466,6325362,4207988,10533350,Basketball
23133,2016,159391,Louisiana State University and Agricultural & Mechanical College,Baton Rouge,LA,70803,1,NCAA Division I-FBS,10896,12140,23036,1,"Public, 4-year or above",2,15,13,8135734,327732,8463466,6516369,4327215,10843584,Basketball
40629,2017,159391,Louisiana State University and Agricultural & Mechanical College,Baton Rouge,LA,70803,1,NCAA Division I-FBS,10492,11457,21949,1,"Public, 4-year or above",2,15,13,8911799,291507,9203306,8618878,4513182,13132060,Basketball
58316,2018,159391,Louisiana State University and Agricultural & Mechanical College,Baton Rouge,LA,70803,1,NCAA Division I-FBS,10443,11830,22273,1,"Public, 4-year or above",2,14,14,9965537,248005,10213542,9512515,4294960,13807475,Basketball
90706,2019,159391,Louisiana State University and Agricultural & Mechanical College,Baton Rouge,LA,70803,1,NCAA Division I-FBS,10543,12042,22585,1,"Public, 4-year or above",2,15,15,8760820,380518,9141338,9257738,4729709,13987447,Basketball
5780,2015,159647,Louisiana Tech University,Ruston,LA,71272,1,NCAA Division I-FBS,3977,3016,6993,1,"Public, 4-year or above",2,13,12,2496927,1736195,4233122,2443159,1693633,4136792,Basketball
23162,2016,159647,Louisiana Tech University,Ruston,LA,71272,1,NCAA Division I-FBS,4187,3247,7434,1,"Public, 4-year or above",2,14,14,2503640,1674809,4178449,2491705,1664654,4156359,Basketball
40660,2017,159647,Louisiana Tech University,Ruston,LA,71272,1,NCAA Division I-FBS,4191,3373,7564,1,"Public, 4-year or above",2,14,14,2453633,1868689,4322322,2378057,1808056,4186113,Basketball
58346,2018,159647,Louisiana Tech University,Ruston,LA,71272,1,NCAA Division I-FBS,4319,3401,7720,1,"Public, 4-year or above",2,13,13,2566614,1712193,4278807,2556193,1699056,4255249,Basketball
90858,2019,159647,Louisiana Tech University,Ruston,LA,71272,1,NCAA Division I-FBS,4272,3429,7701,1,"Public, 4-year or above",2,15,15,2624299,1822628,4446927,2506012,1723553,4229565,Basketball
1456,2015,117946,Loyola Marymount University,Los Angeles,CA,900452659,3,NCAA Division I without football,2611,3407,6018,2,"Private nonprofit, 4-year or above",2,16,17,3533469,1674907,5208376,3533468,1674907,5208375,Basketball
18817,2016,117946,Loyola Marymount University,Los Angeles,CA,90045,3,NCAA Division I without football,2605,3382,5987,2,"Private nonprofit, 4-year or above",2,13,14,3645976,1901671,5547647,3645976,1901671,5547647,Basketball
36251,2017,117946,Loyola Marymount University,Los Angeles,CA,90045,3,NCAA Division I without football,2684,3435,6119,2,"Private nonprofit, 4-year or above",2,14,15,3854857,2013700,5868557,3854857,2013700,5868557,Basketball
53875,2018,117946,Loyola Marymount University,Los Angeles,CA,90045,3,NCAA Division I without football,2832,3568,6400,2,"Private nonprofit, 4-year or above",2,14,14,4137858,2147235,6285093,4137858,2147235,6285093,Basketball
75685,2019,117946,Loyola Marymount University,Los Angeles,CA,90045,3,NCAA Division I without football,2922,3554,6476,2,"Private nonprofit, 4-year or above",2,14,15,5402284,2266424,7668708,5402284,2266424,7668708,Basketball
3963,2015,146719,Loyola University Chicago,Chicago,IL,60660,3,NCAA Division I without football,3351,6247,9598,2,"Private nonprofit, 4-year or above",2,17,20,2745553,1698297,4443850,2745553,1698297,4443850,Basketball
21334,2016,146719,Loyola University Chicago,Chicago,IL,60660,3,NCAA Division I without football,3472,6789,10261,2,"Private nonprofit, 4-year or above",2,19,12,2821576,1661595,4483171,2821576,1661595,4483171,Basketball
38796,2017,146719,Loyola University Chicago,Chicago,IL,60660,3,NCAA Division I without football,3553,6994,10547,2,"Private nonprofit, 4-year or above",2,17,14,6194444,1754214,7948658,6194444,1754214,7948658,Basketball
56457,2018,146719,Loyola University Chicago,Chicago,IL,60660,3,NCAA Division I without football,3692,7400,11092,2,"Private nonprofit, 4-year or above",2,14,12,4348837,1867202,6216039,4348837,1867202,6216039,Basketball
84676,2019,146719,Loyola University Chicago,Chicago,IL,60660,3,NCAA Division I without football,3783,7778,11561,2,"Private nonprofit, 4-year or above",2,16,15,4412586,1799711,6212297,4412586,1799711,6212297,Basketball
6173,2015,163046,Loyola University Maryland,Baltimore,MD,212102699,3,NCAA Division I without football,1697,2305,4002,2,"Private nonprofit, 4-year or above",2,14,16,2048853,1485910,3534763,2048853,1485910,3534763,Basketball
23556,2016,163046,Loyola University Maryland,Baltimore,MD,21210,3,NCAA Division I without football,1716,2314,4030,2,"Private nonprofit, 4-year or above",2,15,17,2137410,1768849,3906259,2137410,1768849,3906259,Basketball
41059,2017,163046,Loyola University Maryland,Baltimore,MD,21210,3,NCAA Division I without football,1632,2241,3873,2,"Private nonprofit, 4-year or above",2,16,16,2275922,1668931,3944853,2275922,1668931,3944853,Basketball
58752,2018,163046,Loyola University Maryland,Baltimore,MD,21210,3,NCAA Division I without football,1591,2234,3825,2,"Private nonprofit, 4-year or above",2,15,12,2002011,1603076,3605087,2002011,1603076,3605087,Basketball
92364,2019,163046,Loyola University Maryland,Baltimore,MD,21210,3,NCAA Division I without football,1644,2230,3874,2,"Private nonprofit, 4-year or above",2,17,13,2146896,1747554,3894450,2146896,1747554,3894450,Basketball
14903,2015,226383,Lubbock Christian University,Lubbock,TX,794072099,5,NCAA Division II without football,541,730,1271,2,"Private nonprofit, 4-year or above",2,14,21,636202,641226,1277428,636202,641226,1277428,Basketball
32373,2016,226383,Lubbock Christian University,Lubbock,TX,79407,5,NCAA Division II without football,525,742,1267,2,"Private nonprofit, 4-year or above",2,17,19,550299,634387,1184686,550299,634387,1184686,Basketball
49898,2017,226383,Lubbock Christian University,Lubbock,TX,79407,5,NCAA Division II without football,543,732,1275,2,"Private nonprofit, 4-year or above",2,17,23,610724,688740,1299464,585262,657651,1242913,Basketball
67673,2018,226383,Lubbock Christian University,Lubbock,TX,79407,5,NCAA Division II without football,520,752,1272,2,"Private nonprofit, 4-year or above",2,15,20,687569,775581,1463150,667311,753996,1421307,Basketball
122662,2019,226383,Lubbock Christian University,Lubbock,TX,79407,5,NCAA Division II without football,486,714,1200,2,"Private nonprofit, 4-year or above",2,13,22,633961,737046,1371007,633961,737046,1371007,Basketball
4934,2015,153834,Luther College,Decorah,IA,521011045,6,NCAA Division III with football,1015,1260,2275,2,"Private nonprofit, 4-year or above",2,23,24,192274,172398,364672,182005,172235,354240,Basketball
22295,2016,153834,Luther College,Decorah,IA,52101,6,NCAA Division III with football,943,1164,2107,2,"Private nonprofit, 4-year or above",2,26,25,190958,159084,350042,182876,157555,340431,Basketball
39771,2017,153834,Luther College,Decorah,IA,52101,6,NCAA Division III with football,888,1102,1990,2,"Private nonprofit, 4-year or above",2,24,25,187603,134185,321788,170645,121631,292276,Basketball
57439,2018,153834,Luther College,Decorah,IA,52101,6,NCAA Division III with football,839,1122,1961,2,"Private nonprofit, 4-year or above",2,25,27,172841,137529,310370,173424,133565,306989,Basketball
88089,2019,153834,Luther College,Decorah,IA,52101,6,NCAA Division III with football,816,1097,1913,2,"Private nonprofit, 4-year or above",2,23,22,169149,154092,323241,137530,118608,256138,Basketball
13080,2015,213668,Lycoming College,Williamsport,PA,177015192,6,NCAA Division III with football,593,661,1254,2,"Private nonprofit, 4-year or above",2,16,12,175487,140588,316075,152487,137463,289950,Basketball
30538,2016,213668,Lycoming College,Williamsport,PA,17701,6,NCAA Division III with football,595,644,1239,2,"Private nonprofit, 4-year or above",2,15,17,164589,146540,311129,149456,139764,289220,Basketball
48040,2017,213668,Lycoming College,Williamsport,PA,17701,6,NCAA Division III with football,597,591,1188,2,"Private nonprofit, 4-year or above",2,16,17,194353,160211,354564,170000,150952,320952,Basketball
65792,2018,213668,Lycoming College,Williamsport,PA,17701,6,NCAA Division III with football,535,596,1131,2,"Private nonprofit, 4-year or above",2,15,14,195384,163367,358751,159243,153736,312979,Basketball
115900,2019,213668,Lycoming College,Williamsport,PA,17701,6,NCAA Division III with football,537,585,1122,2,"Private nonprofit, 4-year or above",2,19,16,235082,161048,396130,202093,148802,350895,Basketball
15724,2015,232609,Lynchburg College,Lynchburg,VA,245013113,7,NCAA Division III without football,813,1164,1977,2,"Private nonprofit, 4-year or above",2,24,14,201847,133558,335405,201847,133558,335405,Basketball
33196,2016,232609,Lynchburg College,Lynchburg,VA,24501,7,NCAA Division III without football,765,1169,1934,2,"Private nonprofit, 4-year or above",2,22,14,259412,148737,408149,259412,148737,408149,Basketball
15491,2015,230931,Lyndon State College,Lyndonville,VT,58510919,7,NCAA Division III without football,643,414,1057,1,"Public, 4-year or above",2,22,13,52350,39984,92334,52350,39984,92334,Basketball
32958,2016,230931,Lyndon State College,Lyndonville,VT,5851,7,NCAA Division III without football,577,384,961,1,"Public, 4-year or above",2,16,9,61004,45581,106585,61004,45581,106585,Basketball
50490,2017,230931,Lyndon State College,Lyndonville,VT,5851,7,NCAA Division III without football,514,357,871,1,"Public, 4-year or above",2,17,11,76163,56043,132206,71263,56043,127306,Basketball
2706,2015,132657,Lynn University,Boca Raton,FL,334315598,5,NCAA Division II without football,967,898,1865,2,"Private nonprofit, 4-year or above",2,16,13,730643,560469,1291112,730643,560469,1291112,Basketball
20081,2016,132657,Lynn University,Boca Raton,FL,33431,5,NCAA Division II without football,983,965,1948,2,"Private nonprofit, 4-year or above",2,13,11,719180,611906,1331086,719180,611906,1331086,Basketball
37520,2017,132657,Lynn University,Boca Raton,FL,33431,5,NCAA Division II without football,921,905,1826,2,"Private nonprofit, 4-year or above",2,14,14,708856,683960,1392816,708856,683960,1392816,Basketball
55164,2018,132657,Lynn University,Boca Raton,FL,33431,5,NCAA Division II without football,1041,1007,2048,2,"Private nonprofit, 4-year or above",2,16,15,750639,655253,1405892,750639,655253,1405892,Basketball
79714,2019,132657,Lynn University,Boca Raton,FL,33431,5,NCAA Division II without football,1089,1129,2218,2,"Private nonprofit, 4-year or above",2,15,14,698388,672997,1371385,698388,672997,1371385,Basketball
7622,2015,173902,Macalester College,Saint Paul,MN,551051899,6,NCAA Division III with football,842,1285,2127,2,"Private nonprofit, 4-year or above",2,19,14,187322,158053,345375,187322,158053,345375,Basketball
25036,2016,173902,Macalester College,Saint Paul,MN,551051899,6,NCAA Division III with football,842,1254,2096,2,"Private nonprofit, 4-year or above",2,19,16,185268,169417,354685,185268,169417,354685,Basketball
42532,2017,173902,Macalester College,Saint Paul,MN,55105,6,NCAA Division III with football,816,1265,2081,2,"Private nonprofit, 4-year or above",2,21,15,169774,144540,314314,169774,144540,314314,Basketball
60239,2018,173902,Macalester College,Saint Paul,MN,55105,6,NCAA Division III with football,865,1268,2133,2,"Private nonprofit, 4-year or above",2,17,12,161588,167125,328713,161588,167125,328713,Basketball
96848,2019,173902,Macalester College,Saint Paul,MN,55105,6,NCAA Division III with football,869,1193,2062,2,"Private nonprofit, 4-year or above",2,13,10,198279,189355,387634,198279,189355,387634,Basketball
3970,2015,146825,MacMurray College,Jacksonville,IL,626502590,6,NCAA Division III with football,275,268,543,2,"Private nonprofit, 4-year or above",2,22,14,90090,75221,165311,87261,72136,159397,Basketball
21341,2016,146825,MacMurray College,Jacksonville,IL,62650,6,NCAA Division III with football,268,263,531,2,"Private nonprofit, 4-year or above",2,23,14,109678,97462,207140,109678,97462,207140,Basketball
38803,2017,146825,MacMurray College,Jacksonville,IL,62650,6,NCAA Division III with football,235,265,500,2,"Private nonprofit, 4-year or above",2,20,14,93091,88169,181260,93091,88169,181260,Basketball
56464,2018,146825,MacMurray College,Jacksonville,IL,62650,6,NCAA Division III with football,280,257,537,2,"Private nonprofit, 4-year or above",2,21,11,91548,81840,173388,88950,79625,168575,Basketball
5970,2015,161299,Maine Maritime Academy,Castine,ME,44200001,6,NCAA Division III with football,832,136,968,1,"Public, 4-year or above",2,13,14,102193,131722,233915,102193,131722,233915,Basketball
23357,2016,161299,Maine Maritime Academy,Castine,ME,4420,6,NCAA Division III with football,834,147,981,1,"Public, 4-year or above",2,14,15,115475,145264,260739,114435,145264,259699,Basketball
40857,2017,161299,Maine Maritime Academy,Castine,ME,4420,6,NCAA Division III with football,843,146,989,1,"Public, 4-year or above",2,11,13,107303,141970,249273,107303,141970,249273,Basketball
58544,2018,161299,Maine Maritime Academy,Castine,ME,4420,6,NCAA Division III with football,806,152,958,1,"Public, 4-year or above",2,12,15,105536,126415,231951,105536,126415,231951,Basketball
91570,2019,161299,Maine Maritime Academy,Castine,ME,4420,6,NCAA Division III with football,811,156,967,1,"Public, 4-year or above",2,13,19,92879,145292,238171,92879,145292,238171,Basketball
11680,2015,203775,Malone University,Canton,OH,447093308,4,NCAA Division II with football,476,693,1169,2,"Private nonprofit, 4-year or above",2,25,15,429618,339883,769501,429618,339883,769501,Basketball
29123,2016,203775,Malone University,Canton,OH,447093308,4,NCAA Division II with football,480,655,1135,2,"Private nonprofit, 4-year or above",2,22,27,398105,478124,876229,398105,478124,876229,Basketball
46624,2017,203775,Malone University,Canton,OH,44709,4,NCAA Division II with football,474,618,1092,2,"Private nonprofit, 4-year or above",2,30,20,351588,352160,703748,351588,352160,703748,Basketball
64358,2018,203775,Malone University,Canton,OH,44709,4,NCAA Division II with football,464,570,1034,2,"Private nonprofit, 4-year or above",2,17,14,306752,333863,640615,306752,333863,640615,Basketball
111079,2019,203775,Malone University,Canton,OH,44709,5,NCAA Division II without football,372,543,915,2,"Private nonprofit, 4-year or above",2,17,16,278255,313028,591283,278255,313028,591283,Basketball
4539,2015,151777,Manchester University,North Manchester,IN,46962,6,NCAA Division III with football,594,639,1233,2,"Private nonprofit, 4-year or above",2,17,16,110763,87581,198344,107613,86880,194493,Basketball
21914,2016,151777,Manchester University,North Manchester,IN,46962,6,NCAA Division III with football,600,647,1247,2,"Private nonprofit, 4-year or above",2,25,14,112575,93978,206553,111610,93978,205588,Basketball
39392,2017,151777,Manchester University,North Manchester,IN,46962,6,NCAA Division III with football,600,644,1244,2,"Private nonprofit, 4-year or above",2,20,14,117703,97186,214889,114672,92179,206851,Basketball
57052,2018,151777,Manchester University,North Manchester,IN,46962,6,NCAA Division III with football,552,623,1175,2,"Private nonprofit, 4-year or above",2,22,17,105676,100154,205830,104055,100154,204209,Basketball
86827,2019,151777,Manchester University,North Manchester,IN,46962,6,NCAA Division III with football,491,569,1060,2,"Private nonprofit, 4-year or above",2,23,13,113645,89219,202864,113645,89219,202864,Basketball
9942,2015,192703,Manhattan College,Riverdale,NY,104714098,3,NCAA Division I without football,1833,1551,3384,2,"Private nonprofit, 4-year or above",2,16,16,2097510,1660270,3757780,2097510,1660270,3757780,Basketball
27363,2016,192703,Manhattan College,Riverdale,NY,10471,3,NCAA Division I without football,1874,1570,3444,2,"Private nonprofit, 4-year or above",2,15,14,2337236,1559495,3896731,2337236,1559495,3896731,Basketball
44850,2017,192703,Manhattan College,Riverdale,NY,10471,3,NCAA Division I without football,1893,1586,3479,2,"Private nonprofit, 4-year or above",2,18,18,2286578,1752307,4038885,2286578,1752307,4038885,Basketball
62564,2018,192703,Manhattan College,Riverdale,NY,10471,3,NCAA Division I without football,1880,1575,3455,2,"Private nonprofit, 4-year or above",2,19,15,2455366,1706291,4161657,2455366,1706291,4161657,Basketball
105139,2019,192703,Manhattan College,Riverdale,NY,10471,3,NCAA Division I without football,1869,1496,3365,2,"Private nonprofit, 4-year or above",2,21,15,2366118,1752765,4118883,2366118,1752765,4118883,Basketball
9952,2015,192749,Manhattanville College,Purchase,NY,10577,7,NCAA Division III without football,582,1132,1714,2,"Private nonprofit, 4-year or above",2,17,16,136648,119722,256370,136697,117428,254125,Basketball
27373,2016,192749,Manhattanville College,Purchase,NY,10577,7,NCAA Division III without football,613,1085,1698,2,"Private nonprofit, 4-year or above",2,17,15,130613,124664,255277,124775,123395,248170,Basketball
44861,2017,192749,Manhattanville College,Purchase,NY,10577,7,NCAA Division III without football,605,1027,1632,2,"Private nonprofit, 4-year or above",2,15,17,155122,117806,272928,144187,51391,195578,Basketball
62574,2018,192749,Manhattanville College,Purchase,NY,10577,7,NCAA Division III without football,603,909,1512,2,"Private nonprofit, 4-year or above",2,15,18,142672,128861,271533,139371,121415,260786,Basketball
105177,2019,192749,Manhattanville College,Purchase,NY,10577,7,NCAA Division III without football,619,851,1470,2,"Private nonprofit, 4-year or above",2,16,20,125080,123312,248392,126706,119211,245917,Basketball
13095,2015,213783,Mansfield University of Pennsylvania,Mansfield,PA,16933,5,NCAA Division II without football,844,1194,2038,1,"Public, 4-year or above",2,17,14,223455,257406,480861,223455,257406,480861,Basketball
30552,2016,213783,Mansfield University of Pennsylvania,Mansfield,PA,16933,5,NCAA Division II without football,786,1135,1921,1,"Public, 4-year or above",2,16,13,310413,246101,556514,310413,246101,556514,Basketball
48056,2017,213783,Mansfield University of Pennsylvania,Mansfield,PA,16933,5,NCAA Division II without football,683,964,1647,1,"Public, 4-year or above",2,16,15,266749,262221,528970,266749,262221,528970,Basketball
65810,2018,213783,Mansfield University of Pennsylvania,Mansfield,PA,16933,5,NCAA Division II without football,581,869,1450,1,"Public, 4-year or above",2,15,14,242089,214505,456594,242089,214505,456594,Basketball
115975,2019,213783,Mansfield University of Pennsylvania,Mansfield,PA,16933,5,NCAA Division II without football,547,929,1476,1,"Public, 4-year or above",2,16,14,272071,239448,511519,272071,239448,511519,Basketball
16528,2015,239071,Maranatha Baptist University,Watertown,WI,53094,6,NCAA Division III with football,292,360,652,2,"Private nonprofit, 4-year or above",2,22,18,62234,37749,99983,57709,36520,94229,Basketball
34003,2016,239071,Maranatha Baptist University,Watertown,WI,53094,6,NCAA Division III with football,311,358,669,2,"Private nonprofit, 4-year or above",2,24,19,73352,43081,116433,69418,41370,110788,Basketball
51559,2017,239071,Maranatha Baptist University,Watertown,WI,53094,7,NCAA Division III without football,264,320,584,2,"Private nonprofit, 4-year or above",2,22,18,75627,38696,114323,69538,36461,105999,Basketball
69304,2018,239071,Maranatha Baptist University,Watertown,WI,53094,7,NCAA Division III without football,226,299,525,2,"Private nonprofit, 4-year or above",2,24,14,83075,60655,143730,77974,55193,133167,Basketball
128796,2019,239071,Maranatha Baptist University,Watertown,WI,53094,7,NCAA Division III without football,217,282,499,2,"Private nonprofit, 4-year or above",2,20,16,31777,33319,65096,25657,29815,55472,Basketball
16535,2015,239080,Marian University,Fond Du Lac,WI,549354699,7,NCAA Division III without football,376,911,1287,2,"Private nonprofit, 4-year or above",2,19,13,94719,86119,180838,93773,85956,179729,Basketball
34010,2016,239080,Marian University,Fond Du Lac,WI,54935,7,NCAA Division III without football,368,816,1184,2,"Private nonprofit, 4-year or above",2,20,13,98254,89354,187608,93425,90354,183779,Basketball
51565,2017,239080,Marian University,Fond Du Lac,WI,54935,7,NCAA Division III without football,397,856,1253,2,"Private nonprofit, 4-year or above",2,26,17,94636,95434,190070,90735,89884,180619,Basketball
69310,2018,239080,Marian University,Fond Du Lac,WI,54935,7,NCAA Division III without football,391,827,1218,2,"Private nonprofit, 4-year or above",2,26,17,95231,94430,189661,89874,90102,179976,Basketball
128802,2019,239080,Marian University,Fond Du Lac,WI,54935,7,NCAA Division III without football,379,792,1171,2,"Private nonprofit, 4-year or above",2,29,18,92560,94560,187120,88560,87925,176485,Basketball
11690,2015,203845,Marietta College,Marietta,OH,45750,6,NCAA Division III with football,735,442,1177,2,"Private nonprofit, 4-year or above",2,21,17,161911,108308,270219,147266,104690,251956,Basketball
29132,2016,203845,Marietta College,Marietta,OH,45750,6,NCAA Division III with football,655,387,1042,2,"Private nonprofit, 4-year or above",2,24,15,215397,99855,315252,183879,99033,282912,Basketball
46633,2017,203845,Marietta College,Marietta,OH,45750,6,NCAA Division III with football,594,356,950,2,"Private nonprofit, 4-year or above",2,23,20,221476,138048,359524,196078,135107,331185,Basketball
64367,2018,203845,Marietta College,Marietta,OH,45750,6,NCAA Division III with football,590,388,978,2,"Private nonprofit, 4-year or above",2,24,15,300252,150184,450436,229373,139095,368468,Basketball
111087,2019,203845,Marietta College,Marietta,OH,45750,6,NCAA Division III with football,591,461,1052,2,"Private nonprofit, 4-year or above",2,21,23,266580,154243,420823,236264,153224,389488,Basketball
9964,2015,192819,Marist College,Poughkeepsie,NY,12601,2,NCAA Division I-FCS,2000,2873,4873,2,"Private nonprofit, 4-year or above",2,15,14,1865144,1552269,3417413,1865144,1552269,3417413,Basketball
27385,2016,192819,Marist College,Poughkeepsie,NY,12601,2,NCAA Division I-FCS,2046,2918,4964,2,"Private nonprofit, 4-year or above",2,14,14,1803822,1648694,3452516,1803822,1648694,3452516,Basketball
44873,2017,192819,Marist College,Poughkeepsie,NY,12601,2,NCAA Division I-FCS,2154,2930,5084,2,"Private nonprofit, 4-year or above",2,16,13,2196095,1767994,3964089,2196095,1767994,3964089,Basketball
62587,2018,192819,Marist College,Poughkeepsie,NY,12601,2,NCAA Division I-FCS,2154,2981,5135,2,"Private nonprofit, 4-year or above",2,16,14,2358993,1917983,4276976,2358993,1917983,4276976,Basketball
105190,2019,192819,Marist College,Poughkeepsie,NY,12601,2,NCAA Division I-FCS,2166,3032,5198,2,"Private nonprofit, 4-year or above",2,14,15,2316652,1857258,4173910,2316652,1857258,4173910,Basketball
16543,2015,239105,Marquette University,Milwaukee,WI,53233,3,NCAA Division I without football,3709,4243,7952,2,"Private nonprofit, 4-year or above",2,14,19,18307330,2865022,21172352,11308266,2828188,14136454,Basketball
34018,2016,239105,Marquette University,Milwaukee,WI,53233,3,NCAA Division I without football,3638,4281,7919,2,"Private nonprofit, 4-year or above",2,15,21,19327629,3431882,22759511,11803633,3359055,15162688,Basketball
51574,2017,239105,Marquette University,Milwaukee,WI,53233,3,NCAA Division I without football,3734,4227,7961,2,"Private nonprofit, 4-year or above",2,15,22,19668714,3976706,23645420,12094572,3938318,16032890,Basketball
69319,2018,239105,Marquette University,Milwaukee,WI,53233,3,NCAA Division I without football,3688,4377,8065,2,"Private nonprofit, 4-year or above",2,17,20,21856683,4572038,26428721,14979149,4427322,19406471,Basketball
128840,2019,239105,Marquette University,Milwaukee,WI,53233,3,NCAA Division I without football,3702,4425,8127,2,"Private nonprofit, 4-year or above",2,15,24,19732396,3746680,23479076,14040298,3746680,17786978,Basketball
11019,2015,198899,Mars Hill University,Mars Hill,NC,28754,4,NCAA Division II with football,646,632,1278,2,"Private nonprofit, 4-year or above",2,18,16,354689,330480,685169,341689,325980,667669,Basketball
28458,2016,198899,Mars Hill University,Mars Hill,NC,28754,4,NCAA Division II with football,599,659,1258,2,"Private nonprofit, 4-year or above",2,16,16,268299,251734,520033,257289,248993,506282,Basketball
45951,2017,198899,Mars Hill University,Mars Hill,NC,28754,4,NCAA Division II with football,542,657,1199,2,"Private nonprofit, 4-year or above",2,19,19,302510,265225,567735,290510,275748,566258,Basketball
63671,2018,198899,Mars Hill University,Mars Hill,NC,28754,4,NCAA Division II with football,503,576,1079,2,"Private nonprofit, 4-year or above",2,18,17,331136,286032,617168,331136,286032,617168,Basketball
108565,2019,198899,Mars Hill University,Mars Hill,NC,28754,4,NCAA Division II with football,459,526,985,2,"Private nonprofit, 4-year or above",2,17,15,355825,252302,608127,355825,252302,608127,Basketball
16321,2015,237525,Marshall University,Huntington,WV,25755,1,NCAA Division I-FBS,3442,4491,7933,1,"Public, 4-year or above",2,16,16,2400482,1343281,3743763,2333564,1343281,3676845,Basketball
33794,2016,237525,Marshall University,Huntington,WV,25755,1,NCAA Division I-FBS,3454,4463,7917,1,"Public, 4-year or above",2,17,12,2512872,1268380,3781252,2512872,1268380,3781252,Basketball
51349,2017,237525,Marshall University,Huntington,WV,25755,1,NCAA Division I-FBS,3357,4416,7773,1,"Public, 4-year or above",2,16,15,2980567,1349286,4329853,2980567,1349286,4329853,Basketball
69097,2018,237525,Marshall University,Huntington,WV,25755,1,NCAA Division I-FBS,3179,4211,7390,1,"Public, 4-year or above",2,17,14,3161233,1491852,4653085,3161233,1491852,4653085,Basketball
128128,2019,237525,Marshall University,Huntington,WV,25755,1,NCAA Division I-FBS,3026,4003,7029,1,"Public, 4-year or above",2,17,15,2993795,1567004,4560799,2993795,1567004,4560799,Basketball
7564,2015,173452,Martin Luther College,New Ulm,MN,560733965,6,NCAA Division III with football,338,367,705,2,"Private nonprofit, 4-year or above",2,12,16,52919,52505,105424,52919,52505,105424,Basketball
24977,2016,173452,Martin Luther College,New Ulm,MN,56073,6,NCAA Division III with football,349,368,717,2,"Private nonprofit, 4-year or above",2,17,14,53845,53424,107269,53845,53424,107269,Basketball
42474,2017,173452,Martin Luther College,New Ulm,MN,56073,6,NCAA Division III with football,367,376,743,2,"Private nonprofit, 4-year or above",2,12,15,54039,53745,107784,54039,53745,107784,Basketball
60180,2018,173452,Martin Luther College,New Ulm,MN,56073,6,NCAA Division III with football,386,364,750,2,"Private nonprofit, 4-year or above",2,15,12,54812,54678,109490,54812,54678,109490,Basketball
96663,2019,173452,Martin Luther College,New Ulm,MN,56073,6,NCAA Division III with football,346,359,705,2,"Private nonprofit, 4-year or above",2,17,14,55709,50938,106647,55709,50938,106647,Basketball
15734,2015,232672,Mary Baldwin College,Staunton,VA,24401,7,NCAA Division III without football,34,862,896,2,"Private nonprofit, 4-year or above",2,0,11,NA,63456,63456,NA,62707,62707,Basketball
33206,2016,232672,Mary Baldwin University,Staunton,VA,24401,7,NCAA Division III without football,38,806,844,2,"Private nonprofit, 4-year or above",2,0,8,NA,73201,73201,NA,69376,69376,Basketball
50749,2017,232672,Mary Baldwin University,Staunton,VA,24401,7,NCAA Division III without football,34,650,684,2,"Private nonprofit, 4-year or above",2,0,13,NA,84901,84901,NA,84901,84901,Basketball
68498,2018,232672,Mary Baldwin University,Staunton,VA,24401,7,NCAA Division III without football,127,812,939,2,"Private nonprofit, 4-year or above",2,0,16,NA,123365,123365,NA,123365,123365,Basketball
125793,2019,232672,Mary Baldwin University,Staunton,VA,24401,7,NCAA Division III without football,208,827,1035,2,"Private nonprofit, 4-year or above",2,0,16,NA,108381,108381,NA,108381,108381,Basketball
15752,2015,232706,Marymount University,Arlington,VA,222074224,7,NCAA Division III without football,705,1382,2087,2,"Private nonprofit, 4-year or above",2,16,15,199135,211437,410572,231688,172262,403950,Basketball
33226,2016,232706,Marymount University,Arlington,VA,22207,7,NCAA Division III without football,752,1369,2121,2,"Private nonprofit, 4-year or above",2,17,13,231687,241133,472820,199704,187048,386752,Basketball
50769,2017,232706,Marymount University,Arlington,VA,22207,7,NCAA Division III without football,725,1338,2063,2,"Private nonprofit, 4-year or above",2,18,16,218762,214080,432842,211721,192385,404106,Basketball
68516,2018,232706,Marymount University,Arlington,VA,22207,7,NCAA Division III without football,741,1324,2065,2,"Private nonprofit, 4-year or above",2,23,12,212319,184256,396575,212319,184256,396575,Basketball
125818,2019,232706,Marymount University,Arlington,VA,22207,7,NCAA Division III without football,667,1280,1947,2,"Private nonprofit, 4-year or above",2,19,12,250415,197442,447857,250415,197442,447857,Basketball
14459,2015,220710,Maryville College,Maryville,TN,378045907,6,NCAA Division III with football,536,623,1159,2,"Private nonprofit, 4-year or above",2,26,19,158817,134003,292820,157603,131289,288892,Basketball
31924,2016,220710,Maryville College,Maryville,TN,37804,6,NCAA Division III with football,519,647,1166,2,"Private nonprofit, 4-year or above",2,24,16,186761,135614,322375,186761,135614,322375,Basketball
49442,2017,220710,Maryville College,Maryville,TN,37804,6,NCAA Division III with football,528,615,1143,2,"Private nonprofit, 4-year or above",2,22,16,179113,142349,321462,169908,139470,309378,Basketball
67211,2018,220710,Maryville College,Maryville,TN,37804,6,NCAA Division III with football,491,603,1094,2,"Private nonprofit, 4-year or above",2,29,14,237673,128211,365884,237673,128211,365884,Basketball
120679,2019,220710,Maryville College,Maryville,TN,37804,6,NCAA Division III with football,465,596,1061,2,"Private nonprofit, 4-year or above",2,23,13,177688,129945,307633,177688,129945,307633,Basketball
8215,2015,178059,Maryville University of Saint Louis,Saint Louis,MO,631417299,5,NCAA Division II without football,667,1248,1915,2,"Private nonprofit, 4-year or above",2,16,20,688600,563432,1252032,658929,550551,1209480,Basketball
25642,2016,178059,Maryville University of Saint Louis,Saint Louis,MO,63141,5,NCAA Division II without football,804,1343,2147,2,"Private nonprofit, 4-year or above",2,17,19,769290,582918,1352208,714965,542713,1257678,Basketball
43131,2017,178059,Maryville University of Saint Louis,Saint Louis,MO,63141,5,NCAA Division II without football,914,1461,2375,2,"Private nonprofit, 4-year or above",2,13,13,737550,532393,1269943,717441,531806,1249247,Basketball
60848,2018,178059,Maryville University of Saint Louis,Saint Louis,MO,63141,5,NCAA Division II without football,994,1600,2594,2,"Private nonprofit, 4-year or above",2,13,15,745531,669305,1414836,715727,669305,1385032,Basketball
99185,2019,178059,Maryville University of Saint Louis,Saint Louis,MO,63141,5,NCAA Division II without football,1161,1829,2990,2,"Private nonprofit, 4-year or above",2,16,14,742143,625783,1367926,721284,632471,1353755,Basketball
13102,2015,213826,Marywood University,Scranton,PA,185091598,7,NCAA Division III without football,556,1176,1732,2,"Private nonprofit, 4-year or above",2,11,14,72735,79264,151999,70569,76602,147171,Basketball
30559,2016,213826,Marywood University,Scranton,PA,18509,7,NCAA Division III without football,546,1171,1717,2,"Private nonprofit, 4-year or above",2,16,10,74169,70521,144690,73409,69185,142594,Basketball
48063,2017,213826,Marywood University,Scranton,PA,18509,7,NCAA Division III without football,550,1172,1722,2,"Private nonprofit, 4-year or above",2,16,12,70430,71366,141796,70430,71366,141796,Basketball
65817,2018,213826,Marywood University,Scranton,PA,18509,7,NCAA Division III without football,565,1146,1711,2,"Private nonprofit, 4-year or above",2,17,10,66927,66476,133403,66927,66476,133403,Basketball
116013,2019,213826,Marywood University,Scranton,PA,18509,7,NCAA Division III without football,538,1109,1647,2,"Private nonprofit, 4-year or above",2,13,16,67808,60489,128297,67808,60489,128297,Basketball
6754,2015,167288,Massachusetts College of Liberal Arts,North Adams,MA,12474100,7,NCAA Division III without football,484,789,1273,1,"Public, 4-year or above",2,15,15,48457,52923,101380,48457,52923,101380,Basketball
24142,2016,167288,Massachusetts College of Liberal Arts,North Adams,MA,1247,7,NCAA Division III without football,489,767,1256,1,"Public, 4-year or above",2,12,16,64465,65209,129674,64465,65209,129674,Basketball
41642,2017,167288,Massachusetts College of Liberal Arts,North Adams,MA,1247,7,NCAA Division III without football,466,735,1201,1,"Public, 4-year or above",2,19,12,59403,51717,111120,59403,51717,111120,Basketball
59332,2018,167288,Massachusetts College of Liberal Arts,North Adams,MA,1247,7,NCAA Division III without football,429,677,1106,1,"Public, 4-year or above",2,19,13,64389,56724,121113,64389,56724,121113,Basketball
94028,2019,167288,Massachusetts College of Liberal Arts,North Adams,MA,1247,7,NCAA Division III without football,449,696,1145,1,"Public, 4-year or above",2,16,15,41794,49042,90836,41794,49042,90836,Basketball
6674,2015,166683,Massachusetts Institute of Technology,Cambridge,MA,21394307,6,NCAA Division III with football,2381,2059,4440,2,"Private nonprofit, 4-year or above",2,13,16,105149,93689,198838,105149,93689,198838,Basketball
24060,2016,166683,Massachusetts Institute of Technology,Cambridge,MA,2139,6,NCAA Division III with football,2391,2053,4444,2,"Private nonprofit, 4-year or above",2,14,12,112063,95489,207552,112063,95489,207552,Basketball
41571,2017,166683,Massachusetts Institute of Technology,Cambridge,MA,2139,6,NCAA Division III with football,2394,2062,4456,2,"Private nonprofit, 4-year or above",2,14,13,128272,98691,226963,128272,98691,226963,Basketball
59268,2018,166683,Massachusetts Institute of Technology,Cambridge,MA,2139,6,NCAA Division III with football,2393,2113,4506,2,"Private nonprofit, 4-year or above",2,19,14,134961,116979,251940,134961,116979,251940,Basketball
93918,2019,166683,Massachusetts Institute of Technology,Cambridge,MA,2139,6,NCAA Division III with football,2385,2102,4487,2,"Private nonprofit, 4-year or above",2,13,15,121771,102860,224631,121771,102860,224631,Basketball
6313,2015,164270,McDaniel College,Westminster,MD,21157,6,NCAA Division III with football,745,856,1601,2,"Private nonprofit, 4-year or above",2,19,12,137222,222755,359977,132164,123661,255825,Basketball
23696,2016,164270,McDaniel College,Westminster,MD,21157,6,NCAA Division III with football,742,781,1523,2,"Private nonprofit, 4-year or above",2,16,18,164720,271455,436175,160387,241993,402380,Basketball
41200,2017,164270,McDaniel College,Westminster,MD,21157,6,NCAA Division III with football,758,780,1538,2,"Private nonprofit, 4-year or above",2,19,18,140435,180707,321142,123048,100572,223620,Basketball
58897,2018,164270,McDaniel College,Westminster,MD,21157,6,NCAA Division III with football,749,778,1527,2,"Private nonprofit, 4-year or above",2,21,17,161763,224245,386008,192770,130309,323079,Basketball
92808,2019,164270,McDaniel College,Westminster,MD,21157,6,NCAA Division III with football,794,855,1649,2,"Private nonprofit, 4-year or above",2,20,17,193038,269223,462261,164932,141183,306115,Basketball
3983,2015,147013,McKendree University,Lebanon,IL,622541291,4,NCAA Division II with football,881,937,1818,2,"Private nonprofit, 4-year or above",2,16,16,716440,562680,1279120,690012,542013,1232025,Basketball
21356,2016,147013,McKendree University,Lebanon,IL,62254,4,NCAA Division II with football,887,933,1820,2,"Private nonprofit, 4-year or above",2,15,18,766009,566913,1332922,712462,555243,1267705,Basketball
38818,2017,147013,McKendree University,Lebanon,IL,62254,4,NCAA Division II with football,826,862,1688,2,"Private nonprofit, 4-year or above",2,15,13,788871,437498,1226369,780259,431201,1211460,Basketball
56479,2018,147013,McKendree University,Lebanon,IL,62254,4,NCAA Division II with football,811,815,1626,2,"Private nonprofit, 4-year or above",2,22,20,725396,501487,1226883,670832,493661,1164493,Basketball
84752,2019,147013,McKendree University,Lebanon,IL,62254,4,NCAA Division II with football,756,727,1483,2,"Private nonprofit, 4-year or above",2,16,15,619472,480309,1099781,619472,480309,1099781,Basketball
14922,2015,226587,McMurry University,Abilene,TX,79697,6,NCAA Division III with football,498,409,907,2,"Private nonprofit, 4-year or above",2,17,16,145483,155891,301374,145407,152535,297942,Basketball
32392,2016,226587,McMurry University,Abilene,TX,79697,6,NCAA Division III with football,521,411,932,2,"Private nonprofit, 4-year or above",2,16,21,173091,159386,332477,173091,158820,331911,Basketball
49917,2017,226587,McMurry University,Abilene,TX,79697,6,NCAA Division III with football,490,462,952,2,"Private nonprofit, 4-year or above",2,17,17,177442,175967,353409,176014,175852,351866,Basketball
67697,2018,226587,McMurry University,Abilene,TX,79697,6,NCAA Division III with football,490,499,989,2,"Private nonprofit, 4-year or above",2,14,15,204950,200600,405550,204268,200600,404868,Basketball
122775,2019,226587,McMurry University,Abilene,TX,79697,6,NCAA Division III with football,504,515,1019,2,"Private nonprofit, 4-year or above",2,13,22,271202,184798,456000,269213,184794,454007,Basketball
5796,2015,159717,McNeese State University,Lake Charles,LA,70605,2,NCAA Division I-FCS,2391,3384,5775,1,"Public, 4-year or above",2,16,14,819396,786123,1605519,819396,786123,1605519,Basketball
23180,2016,159717,McNeese State University,Lake Charles,LA,70605,2,NCAA Division I-FCS,2247,3197,5444,1,"Public, 4-year or above",2,14,16,882648,786882,1669530,874651,761130,1635781,Basketball
40678,2017,159717,McNeese State University,Lake Charles,LA,70605,2,NCAA Division I-FCS,2230,3183,5413,1,"Public, 4-year or above",2,16,17,1050592,774183,1824775,1056231,745661,1801892,Basketball
58364,2018,159717,McNeese State University,Lake Charles,LA,70605,2,NCAA Division I-FCS,2254,3194,5448,1,"Public, 4-year or above",2,16,14,1162753,773186,1935939,1162753,773186,1935939,Basketball
90930,2019,159717,McNeese State University,Lake Charles,LA,70605,2,NCAA Division I-FCS,2141,3090,5231,1,"Public, 4-year or above",2,17,14,1283893,774657,2058550,1283893,774657,2058550,Basketball
9976,2015,192925,Medaille College,Buffalo,NY,142142695,7,NCAA Division III without football,456,986,1442,2,"Private nonprofit, 4-year or above",2,16,10,98126,59719,157845,84334,56081,140415,Basketball
27397,2016,192925,Medaille College,Buffalo,NY,14214,7,NCAA Division III without football,362,822,1184,2,"Private nonprofit, 4-year or above",2,15,13,110153,57408,167561,97682,54810,152492,Basketball
44885,2017,192925,Medaille College,Buffalo,NY,14214,7,NCAA Division III without football,393,1019,1412,2,"Private nonprofit, 4-year or above",2,13,12,101850,46605,148455,85174,52926,138100,Basketball
62599,2018,192925,Medaille College,Buffalo,NY,14214,7,NCAA Division III without football,397,1001,1398,2,"Private nonprofit, 4-year or above",2,13,11,81906,57540,139446,72906,56335,129241,Basketball
105228,2019,192925,Medaille College,Buffalo,NY,14214,7,NCAA Division III without football,387,952,1339,2,"Private nonprofit, 4-year or above",2,12,9,67185,65523,132708,64246,65017,129263,Basketball
3364,2015,140447,Mercer University,Macon,GA,31207,2,NCAA Division I-FCS,1619,2204,3823,2,"Private nonprofit, 4-year or above",2,15,14,1883578,1454723,3338301,1883578,1454723,3338301,Basketball
20729,2016,140447,Mercer University,Macon,GA,31207,2,NCAA Division I-FCS,1632,2380,4012,2,"Private nonprofit, 4-year or above",2,16,14,1793214,1545815,3339029,1793214,1545815,3339029,Basketball
38189,2017,140447,Mercer University,Macon,GA,31207,2,NCAA Division I-FCS,1645,2471,4116,2,"Private nonprofit, 4-year or above",2,17,13,1865476,1524522,3389998,1865476,1524522,3389998,Basketball
55842,2018,140447,Mercer University,Macon,GA,31207,2,NCAA Division I-FCS,1684,2560,4244,2,"Private nonprofit, 4-year or above",2,17,14,2062738,1792704,3855442,2062738,1792704,3855442,Basketball
82446,2019,140447,Mercer University,Macon,GA,31207,2,NCAA Division I-FCS,1657,2596,4253,2,"Private nonprofit, 4-year or above",2,16,12,2217392,1663117,3880509,2217392,1663117,3880509,Basketball
9986,2015,193016,Mercy College,Dobbs Ferry,NY,10522,5,NCAA Division II without football,1655,3591,5246,2,"Private nonprofit, 4-year or above",2,18,13,212374,131898,344272,208489,131628,340117,Basketball
27407,2016,193016,Mercy College,Dobbs Ferry,NY,105221185,5,NCAA Division II without football,1698,3445,5143,2,"Private nonprofit, 4-year or above",2,16,13,227543,170315,397858,203919,157013,360932,Basketball
44895,2017,193016,Mercy College,Dobbs Ferry,NY,10522,5,NCAA Division II without football,1723,3298,5021,2,"Private nonprofit, 4-year or above",2,13,11,207009,182404,389413,206944,182339,389283,Basketball
62609,2018,193016,Mercy College,Dobbs Ferry,NY,10522,5,NCAA Division II without football,1729,3248,4977,2,"Private nonprofit, 4-year or above",2,11,11,215611,215933,431544,181069,187927,368996,Basketball
105266,2019,193016,Mercy College,Dobbs Ferry,NY,10522,5,NCAA Division II without football,1864,4335,6199,2,"Private nonprofit, 4-year or above",2,12,14,205189,211502,416691,201526,209618,411144,Basketball
13114,2015,213987,Mercyhurst University,Erie,PA,16546,4,NCAA Division II with football,1048,1354,2402,2,"Private nonprofit, 4-year or above",2,19,14,813292,630019,1443311,813292,630019,1443311,Basketball
30571,2016,213987,Mercyhurst University,Erie,PA,16546,4,NCAA Division II with football,1070,1332,2402,2,"Private nonprofit, 4-year or above",2,15,14,759862,695960,1455822,759862,695960,1455822,Basketball
48075,2017,213987,Mercyhurst University,Erie,PA,16546,4,NCAA Division II with football,1013,1358,2371,2,"Private nonprofit, 4-year or above",2,18,13,822559,642325,1464884,822559,642325,1464884,Basketball
65830,2018,213987,Mercyhurst University,Erie,PA,16546,4,NCAA Division II with football,966,1346,2312,2,"Private nonprofit, 4-year or above",2,17,18,892555,757295,1649850,892555,757295,1649850,Basketball
116051,2019,213987,Mercyhurst University,Erie,PA,16546,4,NCAA Division II with football,935,1357,2292,2,"Private nonprofit, 4-year or above",2,18,18,888143,845981,1734124,888143,845981,1734124,Basketball
6710,2015,166850,Merrimack College,North Andover,MA,1845,4,NCAA Division II with football,1451,1573,3024,2,"Private nonprofit, 4-year or above",2,15,17,880131,739507,1619638,880131,739507,1619638,Basketball
24096,2016,166850,Merrimack College,North Andover,MA,1845,4,NCAA Division II with football,1595,1700,3295,2,"Private nonprofit, 4-year or above",2,13,24,814731,760652,1575383,814731,760652,1575383,Basketball
41606,2017,166850,Merrimack College,North Andover,MA,1845,4,NCAA Division II with football,1610,1711,3321,2,"Private nonprofit, 4-year or above",2,14,24,894700,785547,1680247,894700,785547,1680247,Basketball
59303,2018,166850,Merrimack College,North Andover,MA,1845,4,NCAA Division II with football,1777,1793,3570,2,"Private nonprofit, 4-year or above",2,16,20,999430,953818,1953248,999430,953818,1953248,Basketball
93952,2019,166850,Merrimack College,North Andover,MA,1845,2,NCAA Division I-FCS,1853,2030,3883,2,"Private nonprofit, 4-year or above",2,15,20,1389403,1249722,2639125,1389403,1249722,2639125,Basketball
13129,2015,213996,Messiah College,Mechanicsburg,PA,17055,7,NCAA Division III without football,1055,1624,2679,2,"Private nonprofit, 4-year or above",2,17,18,183998,195548,379546,146353,142304,288657,Basketball
30586,2016,213996,Messiah College,Mechanicsburg,PA,17055,7,NCAA Division III without football,1050,1598,2648,2,"Private nonprofit, 4-year or above",2,18,18,148679,189538,338217,136580,151170,287750,Basketball
48090,2017,213996,Messiah College,Mechanicsburg,PA,17055,7,NCAA Division III without football,1061,1574,2635,2,"Private nonprofit, 4-year or above",2,15,12,137599,211676,349275,131638,148170,279808,Basketball
65845,2018,213996,Messiah College,Mechanicsburg,PA,17055,7,NCAA Division III without football,1019,1576,2595,2,"Private nonprofit, 4-year or above",2,18,11,152226,199291,351517,130991,151407,282398,Basketball
116089,2019,213996,Messiah College,Mechanicsburg,PA,17055,7,NCAA Division III without football,1008,1535,2543,2,"Private nonprofit, 4-year or above",2,14,12,148242,220413,368655,136386,122114,258500,Basketball
11030,2015,198969,Methodist University,Fayetteville,NC,283111420,6,NCAA Division III with football,1088,878,1966,2,"Private nonprofit, 4-year or above",2,27,19,132240,131856,264096,132240,127607,259847,Basketball
28469,2016,198969,Methodist University,Fayetteville,NC,28311,6,NCAA Division III with football,1060,873,1933,2,"Private nonprofit, 4-year or above",2,29,12,153896,127301,281197,153896,122145,276041,Basketball
45962,2017,198969,Methodist University,Fayetteville,NC,28311,6,NCAA Division III with football,918,829,1747,2,"Private nonprofit, 4-year or above",2,29,19,141855,117004,258859,140355,115554,255909,Basketball
63682,2018,198969,Methodist University,Fayetteville,NC,28311,6,NCAA Division III with football,833,741,1574,2,"Private nonprofit, 4-year or above",2,31,18,143628,121462,265090,142628,117886,260514,Basketball
108576,2019,198969,Methodist University,Fayetteville,NC,28311,6,NCAA Division III with football,801,694,1495,2,"Private nonprofit, 4-year or above",2,28,16,131204,114953,246157,131204,114953,246157,Basketball
2258,2015,127565,Metropolitan State University of Denver,DENVER,CO,802043362,5,NCAA Division II without football,5779,6386,12165,1,"Public, 4-year or above",2,14,13,853242,617507,1470749,851376,600023,1451399,Basketball
19627,2016,127565,Metropolitan State University of Denver,Denver,CO,80217,5,NCAA Division II without football,5794,6558,12352,1,"Public, 4-year or above",2,14,14,980731,601496,1582227,979937,599574,1579511,Basketball
37066,2017,127565,Metropolitan State University of Denver,Denver,CO,80217,5,NCAA Division II without football,6009,6565,12574,1,"Public, 4-year or above",2,16,13,715676,616378,1332054,712241,614979,1327220,Basketball
54702,2018,127565,Metropolitan State University of Denver,Denver,CO,80217,5,NCAA Division II without football,5921,6651,12572,1,"Public, 4-year or above",2,18,16,737774,670641,1408415,737191,670496,1407687,Basketball
78573,2019,127565,Metropolitan State University of Denver,Denver,CO,80204,5,NCAA Division II without football,5666,6402,12068,1,"Public, 4-year or above",2,14,13,770738,633851,1404589,741540,625318,1366858,Basketball
11699,2015,204024,Miami University-Oxford,Oxford,OH,45056,1,NCAA Division I-FBS,7688,7979,15667,1,"Public, 4-year or above",2,16,29,2329719,1569547,3899266,2329719,1569546,3899265,Basketball
29141,2016,204024,Miami University-Oxford,Oxford,OH,45056,1,NCAA Division I-FBS,7925,8184,16109,1,"Public, 4-year or above",2,14,28,2511964,1656068,4168032,2445194,1556068,4001262,Basketball
46643,2017,204024,Miami University-Oxford,Oxford,OH,45056,1,NCAA Division I-FBS,8118,8226,16344,1,"Public, 4-year or above",2,18,23,2399919,1849900,4249819,2399919,1849897,4249816,Basketball
64378,2018,204024,Miami University-Oxford,Oxford,OH,45056,1,NCAA Division I-FBS,8245,8245,16490,1,"Public, 4-year or above",2,15,26,2234349,1675889,3910238,2234349,1675889,3910238,Basketball
111125,2019,204024,Miami University-Oxford,Oxford,OH,45056,1,NCAA Division I-FBS,8264,8281,16545,1,"Public, 4-year or above",2,15,14,2322698,1622581,3945279,2322698,1622581,3945279,Basketball
7301,2015,171100,Michigan State University,East Lansing,MI,488241046,1,NCAA Division I-FBS,17376,18049,35425,1,"Public, 4-year or above",2,17,36,17639546,796433,18435979,10432557,4112768,14545325,Basketball
24704,2016,171100,Michigan State University,East Lansing,MI,48824,1,NCAA Division I-FBS,17245,18035,35280,1,"Public, 4-year or above",2,18,16,17548611,243743,17792354,10975215,4444099,15419314,Basketball
42201,2017,171100,Michigan State University,East Lansing,MI,48824,1,NCAA Division I-FBS,17314,17935,35249,1,"Public, 4-year or above",2,16,34,21882125,665469,22547594,11745452,4775137,16520589,Basketball
59903,2018,171100,Michigan State University,East Lansing,MI,48824,1,NCAA Division I-FBS,17360,18231,35591,1,"Public, 4-year or above",2,16,15,23808250,668938,24477188,14395851,4848780,19244631,Basketball
95773,2019,171100,Michigan State University,East Lansing,MI,48824,1,NCAA Division I-FBS,17461,18114,35575,1,"Public, 4-year or above",2,18,16,20211332,77137,20288469,12177385,4951926,17129311,Basketball
7315,2015,171128,Michigan Technological University,Houghton,MI,499311295,4,NCAA Division II with football,3904,1425,5329,1,"Public, 4-year or above",2,19,16,820052,646911,1466963,801837,646911,1448748,Basketball
24718,2016,171128,Michigan Technological University,Houghton,MI,49931,4,NCAA Division II with football,3987,1453,5440,1,"Public, 4-year or above",2,15,14,827545,699506,1527051,784912,661185,1446097,Basketball
42215,2017,171128,Michigan Technological University,Houghton,MI,49931,4,NCAA Division II with football,4025,1466,5491,1,"Public, 4-year or above",2,12,14,764194,625086,1389280,764194,625086,1389280,Basketball
59917,2018,171128,Michigan Technological University,Houghton,MI,49931,4,NCAA Division II with football,3964,1495,5459,1,"Public, 4-year or above",2,19,14,841711,771208,1612919,841711,681317,1523028,Basketball
95811,2019,171128,Michigan Technological University,Houghton,MI,49931,4,NCAA Division II with football,3844,1537,5381,1,"Public, 4-year or above",2,17,16,734651,645944,1380595,734651,645944,1380595,Basketball
14478,2015,220978,Middle Tennessee State University,Murfreesboro,TN,37132,1,NCAA Division I-FBS,7500,8641,16141,1,"Public, 4-year or above",2,20,13,2726526,1805818,4532344,2726526,1805818,4532344,Basketball
31943,2016,220978,Middle Tennessee State University,Murfreesboro,TN,37132,1,NCAA Division I-FBS,7332,8653,15985,1,"Public, 4-year or above",2,18,12,2992258,2028726,5020984,2992258,2028726,5020984,Basketball
49461,2017,220978,Middle Tennessee State University,Murfreesboro,TN,37132,1,NCAA Division I-FBS,7319,8459,15778,1,"Public, 4-year or above",2,18,14,3263120,2195771,5458891,3263120,2195771,5458891,Basketball
67230,2018,220978,Middle Tennessee State University,Murfreesboro,TN,37132,1,NCAA Division I-FBS,7141,8334,15475,1,"Public, 4-year or above",2,16,17,2982636,2189504,5172140,2982636,2189504,5172140,Basketball
120755,2019,220978,Middle Tennessee State University,Murfreesboro,TN,37132,1,NCAA Division I-FBS,7353,8336,15689,1,"Public, 4-year or above",2,16,15,3151735,2362364,5514099,3151735,2362364,5514099,Basketball
15499,2015,230959,Middlebury College,Middlebury,VT,5753,6,NCAA Division III with football,1184,1318,2502,2,"Private nonprofit, 4-year or above",2,13,14,166248,114963,281211,166248,114963,281211,Basketball
32967,2016,230959,Middlebury College,Middlebury,VT,5753,6,NCAA Division III with football,1204,1292,2496,2,"Private nonprofit, 4-year or above",2,13,12,186346,154896,341242,186346,154896,341242,Basketball
50499,2017,230959,Middlebury College,Middlebury,VT,5753,6,NCAA Division III with football,1218,1293,2511,2,"Private nonprofit, 4-year or above",2,15,15,214492,136048,350540,214492,136048,350540,Basketball
68260,2018,230959,Middlebury College,Middlebury,VT,5753,6,NCAA Division III with football,1198,1339,2537,2,"Private nonprofit, 4-year or above",2,15,14,169104,139499,308603,169104,139499,308603,Basketball
125028,2019,230959,Middlebury College,Middlebury,VT,5753,6,NCAA Division III with football,1197,1344,2541,2,"Private nonprofit, 4-year or above",2,15,13,169393,144497,313890,169393,144497,313890,Basketball
14935,2015,226833,Midwestern State University,Wichita Falls,TX,763082099,4,NCAA Division II with football,1745,2310,4055,1,"Public, 4-year or above",2,16,18,579208,450904,1030112,579208,450904,1030112,Basketball
32405,2016,226833,Midwestern State University,Wichita Falls,TX,76308,4,NCAA Division II with football,1746,2376,4122,1,"Public, 4-year or above",2,16,16,527544,416243,943787,527544,416243,943787,Basketball
49931,2017,226833,Midwestern State University,Wichita Falls,TX,76308,4,NCAA Division II with football,1776,2423,4199,1,"Public, 4-year or above",2,15,15,512580,432116,944696,512580,432116,944696,Basketball
67711,2018,226833,Midwestern State University,Wichita Falls,TX,76308,4,NCAA Division II with football,1686,2570,4256,1,"Public, 4-year or above",2,16,12,525685,450633,976318,525685,450633,976318,Basketball
122851,2019,226833,Midwestern State University,Wichita Falls,TX,76308,4,NCAA Division II with football,1581,2503,4084,1,"Public, 4-year or above",2,16,15,481833,458462,940295,481833,458462,940295,Basketball
183,2015,101675,Miles College,Fairfield,AL,350642621,4,NCAA Division II with football,910,893,1803,2,"Private nonprofit, 4-year or above",2,15,16,473670,392345,866015,471042,389546,860588,Basketball
17529,2016,101675,Miles College,Fairfield,AL,35064,4,NCAA Division II with football,894,877,1771,2,"Private nonprofit, 4-year or above",2,14,14,421502,396248,817750,403445,420920,824365,Basketball
34939,2017,101675,Miles College,Fairfield,AL,35064,4,NCAA Division II with football,797,758,1555,2,"Private nonprofit, 4-year or above",2,12,15,419898,435733,855631,419898,435733,855631,Basketball
52569,2018,101675,Miles College,Fairfield,AL,35064,4,NCAA Division II with football,708,760,1468,2,"Private nonprofit, 4-year or above",2,17,15,559559,459047,1018606,559559,459047,1018606,Basketball
71010,2019,101675,Miles College,Fairfield,AL,35064,4,NCAA Division II with football,701,687,1388,2,"Private nonprofit, 4-year or above",2,13,18,615291,561185,1176476,615291,561185,1176476,Basketball
13143,2015,214041,Millersville University of Pennsylvania,Millersville,PA,175510302,4,NCAA Division II with football,2732,3379,6111,1,"Public, 4-year or above",2,14,16,347155,436915,784070,347155,436915,784070,Basketball
30600,2016,214041,Millersville University of Pennsylvania,Millersville,PA,17551,4,NCAA Division II with football,2643,3267,5910,1,"Public, 4-year or above",2,15,13,347347,380648,727995,347347,380648,727995,Basketball
48104,2017,214041,Millersville University of Pennsylvania,Millersville,PA,17551,4,NCAA Division II with football,2463,3187,5650,1,"Public, 4-year or above",2,14,17,487578,460168,947746,487578,460168,947746,Basketball
65858,2018,214041,Millersville University of Pennsylvania,Millersville,PA,17551,4,NCAA Division II with football,2405,3129,5534,1,"Public, 4-year or above",2,16,15,508117,488883,997000,508117,488883,997000,Basketball
116101,2019,214041,Millersville University of Pennsylvania,Millersville,PA,17551,4,NCAA Division II with football,2350,3115,5465,1,"Public, 4-year or above",2,16,18,511193,504691,1015884,511193,504691,1015884,Basketball
3995,2015,147244,Millikin University,Decatur,IL,625222084,6,NCAA Division III with football,832,1131,1963,2,"Private nonprofit, 4-year or above",2,21,22,223928,196151,420079,218370,193032,411402,Basketball
21370,2016,147244,Millikin University,Decatur,IL,62522,6,NCAA Division III with football,774,1022,1796,2,"Private nonprofit, 4-year or above",2,26,25,236829,196319,433148,233154,192806,425960,Basketball
38836,2017,147244,Millikin University,Decatur,IL,62522,6,NCAA Division III with football,782,1021,1803,2,"Private nonprofit, 4-year or above",2,19,22,248702,219846,468548,246323,216552,462875,Basketball
56496,2018,147244,Millikin University,Decatur,IL,62522,6,NCAA Division III with football,800,1049,1849,2,"Private nonprofit, 4-year or above",2,20,15,238386,180878,419264,235614,178760,414374,Basketball
84790,2019,147244,Millikin University,Decatur,IL,62522,6,NCAA Division III with football,847,1022,1869,2,"Private nonprofit, 4-year or above",2,22,15,228334,158069,386403,228334,158069,386403,Basketball
7970,2015,175980,Millsaps College,Jackson,MS,392100001,6,NCAA Division III with football,378,371,749,2,"Private nonprofit, 4-year or above",2,16,19,193999,154463,348462,193999,154463,348462,Basketball
25385,2016,175980,Millsaps College,Jackson,MS,39210,6,NCAA Division III with football,401,386,787,2,"Private nonprofit, 4-year or above",2,16,17,247529,151436,398965,187494,151437,338931,Basketball
42884,2017,175980,Millsaps College,Jackson,MS,39210,6,NCAA Division III with football,402,394,796,2,"Private nonprofit, 4-year or above",2,22,20,277033,179401,456434,248515,179401,427916,Basketball
60589,2018,175980,Millsaps College,Jackson,MS,39210,6,NCAA Division III with football,380,410,790,2,"Private nonprofit, 4-year or above",2,24,22,148379,138573,286952,148734,152573,301307,Basketball
98111,2019,175980,Millsaps College,Jackson,MS,39210,6,NCAA Division III with football,347,421,768,2,"Private nonprofit, 4-year or above",2,16,17,160723,142546,303269,179299,139886,319185,Basketball
16555,2015,239318,Milwaukee School of Engineering,Milwaukee,WI,532023109,7,NCAA Division III without football,1859,656,2515,2,"Private nonprofit, 4-year or above",2,18,12,62680,47456,110136,62380,44756,107136,Basketball
34031,2016,239318,Milwaukee School of Engineering,Milwaukee,WI,53202,7,NCAA Division III without football,1842,683,2525,2,"Private nonprofit, 4-year or above",2,17,14,61714,78063,139777,57224,74863,132087,Basketball
51587,2017,239318,Milwaukee School of Engineering,Milwaukee,WI,53202,7,NCAA Division III without football,1829,679,2508,2,"Private nonprofit, 4-year or above",2,18,15,80515,81465,161980,79135,77455,156590,Basketball
69332,2018,239318,Milwaukee School of Engineering,Milwaukee,WI,53202,7,NCAA Division III without football,1840,651,2491,2,"Private nonprofit, 4-year or above",2,21,11,70995,74634,145629,69615,70624,140239,Basketball
128916,2019,239318,Milwaukee School of Engineering,Milwaukee,WI,53202,7,NCAA Division III without football,1819,659,2478,2,"Private nonprofit, 4-year or above",2,19,9,87950,98425,186375,87042,93501,180543,Basketball
7692,2015,174358,Minnesota State University Moorhead,Moorhead,MN,56563,4,NCAA Division II with football,1679,2590,4269,1,"Public, 4-year or above",2,15,13,566213,427515,993728,555551,420609,976160,Basketball
25106,2016,174358,Minnesota State University Moorhead,Moorhead,MN,56563,4,NCAA Division II with football,1713,2522,4235,1,"Public, 4-year or above",2,15,15,490242,438938,929180,477988,423177,901165,Basketball
42602,2017,174358,Minnesota State University Moorhead,Moorhead,MN,56563,4,NCAA Division II with football,1630,2481,4111,1,"Public, 4-year or above",2,15,14,584007,563826,1147833,567893,540984,1108877,Basketball
60309,2018,174358,Minnesota State University Moorhead,Moorhead,MN,56563,4,NCAA Division II with football,1526,2344,3870,1,"Public, 4-year or above",2,16,13,622958,576509,1199467,617604,572016,1189620,Basketball
97029,2019,174358,Minnesota State University Moorhead,Moorhead,MN,56563,4,NCAA Division II with football,1487,2270,3757,1,"Public, 4-year or above",2,14,13,545383,501373,1046756,542605,478413,1021018,Basketball
7633,2015,173920,Minnesota State University-Mankato,Mankato,MN,56001,4,NCAA Division II with football,5338,5534,10872,1,"Public, 4-year or above",2,16,14,595352,505935,1101287,595092,505930,1101022,Basketball
25047,2016,173920,Minnesota State University-Mankato,Mankato,MN,56001,4,NCAA Division II with football,5313,5557,10870,1,"Public, 4-year or above",2,14,18,628002,532196,1160198,628002,532195,1160197,Basketball
42543,2017,173920,Minnesota State University-Mankato,Mankato,MN,56001,4,NCAA Division II with football,5203,5497,10700,1,"Public, 4-year or above",2,14,15,628261,591418,1219679,628261,584895,1213156,Basketball
60250,2018,173920,Minnesota State University-Mankato,Mankato,MN,56001,4,NCAA Division II with football,5027,5388,10415,1,"Public, 4-year or above",2,14,15,653029,519926,1172955,652428,519860,1172288,Basketball
96886,2019,173920,Minnesota State University-Mankato,Mankato,MN,56001,4,NCAA Division II with football,4974,5342,10316,1,"Public, 4-year or above",2,14,17,683190,567815,1251005,683190,567006,1250196,Basketball
11337,2015,200253,Minot State University,Minot,ND,58707,4,NCAA Division II with football,763,1252,2015,1,"Public, 4-year or above",2,17,17,471266,465118,936384,471266,465118,936384,Basketball
28776,2016,200253,Minot State University,Minot,ND,58707,4,NCAA Division II with football,779,1240,2019,1,"Public, 4-year or above",2,16,17,457307,485673,942980,457307,485673,942980,Basketball
46279,2017,200253,Minot State University,Minot,ND,58707,4,NCAA Division II with football,773,1178,1951,1,"Public, 4-year or above",2,18,17,477244,394337,871581,479070,377895,856965,Basketball
63999,2018,200253,Minot State University,Minot,ND,58707,4,NCAA Division II with football,772,1205,1977,1,"Public, 4-year or above",2,16,14,519788,434324,954112,519788,434324,954112,Basketball
109728,2019,200253,Minot State University,Minot,ND,58707,4,NCAA Division II with football,754,1167,1921,1,"Public, 4-year or above",2,18,16,482919,418907,901826,482919,418907,901826,Basketball
13156,2015,214069,Misericordia University,Dallas,PA,186121098,6,NCAA Division III with football,627,1165,1792,2,"Private nonprofit, 4-year or above",2,22,16,77215,96950,174165,72555,93887,166442,Basketball
30613,2016,214069,Misericordia University,Dallas,PA,18612,6,NCAA Division III with football,589,1052,1641,2,"Private nonprofit, 4-year or above",2,30,15,105429,87817,193246,100576,84051,184627,Basketball
48117,2017,214069,Misericordia University,Dallas,PA,18612,6,NCAA Division III with football,594,1066,1660,2,"Private nonprofit, 4-year or above",2,25,18,107137,94164,201301,104112,92630,196742,Basketball
65871,2018,214069,Misericordia University,Dallas,PA,18612,6,NCAA Division III with football,537,1077,1614,2,"Private nonprofit, 4-year or above",2,26,13,104885,101090,205975,102330,98478,200808,Basketball
116114,2019,214069,Misericordia University,Dallas,PA,18612,6,NCAA Division III with football,556,1028,1584,2,"Private nonprofit, 4-year or above",2,26,15,101463,92609,194072,98771,89354,188125,Basketball
8002,2015,176053,Mississippi College,Clinton,MS,39058,4,NCAA Division II with football,1063,1598,2661,2,"Private nonprofit, 4-year or above",2,20,14,526048,439636,965684,505052,409592,914644,Basketball
25419,2016,176053,Mississippi College,Clinton,MS,39058,4,NCAA Division II with football,1081,1634,2715,2,"Private nonprofit, 4-year or above",2,15,15,550735,502843,1053578,514012,485128,999140,Basketball
42921,2017,176053,Mississippi College,Clinton,MS,39058,4,NCAA Division II with football,1060,1726,2786,2,"Private nonprofit, 4-year or above",2,20,15,592222,550170,1142392,588318,535407,1123725,Basketball
60628,2018,176053,Mississippi College,Clinton,MS,39058,4,NCAA Division II with football,1049,1716,2765,2,"Private nonprofit, 4-year or above",2,22,13,616888,557969,1174857,566771,546981,1113752,Basketball
98215,2019,176053,Mississippi College,Clinton,MS,39058,4,NCAA Division II with football,1001,1508,2509,2,"Private nonprofit, 4-year or above",2,23,12,626744,557512,1184256,548380,514052,1062432,Basketball
8018,2015,176080,Mississippi State University,Mississippi State,MS,39762,1,NCAA Division I-FBS,7827,7650,15477,1,"Public, 4-year or above",2,16,15,7390683,513391,7904074,6111629,3997118,10108747,Basketball
25435,2016,176080,Mississippi State University,Mississippi State,MS,39762,1,NCAA Division I-FBS,7985,8149,16134,1,"Public, 4-year or above",2,17,14,7572191,4731482,12303673,6563856,4731482,11295338,Basketball
42937,2017,176080,Mississippi State University,Mississippi State,MS,39762,1,NCAA Division I-FBS,8131,8220,16351,1,"Public, 4-year or above",2,17,16,7066124,5500367,12566491,6835070,5500367,12335437,Basketball
60644,2018,176080,Mississippi State University,Mississippi State,MS,39762,1,NCAA Division I-FBS,8145,8323,16468,1,"Public, 4-year or above",2,17,31,8030614,6115465,14146079,7443131,6115465,13558596,Basketball
98291,2019,176080,Mississippi State University,Mississippi State,MS,39762,1,NCAA Division I-FBS,8345,8472,16817,1,"Public, 4-year or above",2,20,15,7373585,5406474,12780059,7373585,5406474,12780059,Basketball
7994,2015,176044,Mississippi Valley State University,Itta Bena,MS,389411400,2,NCAA Division I-FCS,723,964,1687,1,"Public, 4-year or above",2,21,16,749117,308457,1057574,505795,308457,814252,Basketball
25411,2016,176044,Mississippi Valley State University,Itta Bena,MS,38941,2,NCAA Division I-FCS,727,1004,1731,1,"Public, 4-year or above",2,19,16,897175,411686,1308861,492545,411686,904231,Basketball
42913,2017,176044,Mississippi Valley State University,Itta Bena,MS,38941,2,NCAA Division I-FCS,690,968,1658,1,"Public, 4-year or above",2,18,12,856095,403943,1260038,481831,403943,885774,Basketball
60620,2018,176044,Mississippi Valley State University,Itta Bena,MS,38941,2,NCAA Division I-FCS,648,867,1515,1,"Public, 4-year or above",2,15,12,733665,394267,1127932,576526,394267,970793,Basketball
98206,2019,176044,Mississippi Valley State University,Itta Bena,MS,38941,2,NCAA Division I-FCS,589,826,1415,1,"Public, 4-year or above",2,15,14,869700,431197,1300897,489689,431197,920886,Basketball
8244,2015,178341,Missouri Southern State University,Joplin,MO,648011595,4,NCAA Division II with football,1753,2376,4129,1,"Public, 4-year or above",2,16,15,540873,567819,1108692,478256,508953,987209,Basketball
25675,2016,178341,Missouri Southern State University,Joplin,MO,64801,4,NCAA Division II with football,1823,2548,4371,1,"Public, 4-year or above",2,13,14,591813,486491,1078304,516306,403598,919904,Basketball
43163,2017,178341,Missouri Southern State University,Joplin,MO,64801,4,NCAA Division II with football,1704,2584,4288,1,"Public, 4-year or above",2,15,14,642014,521040,1163054,584791,460965,1045756,Basketball
60881,2018,178341,Missouri Southern State University,Joplin,MO,64801,4,NCAA Division II with football,1598,2515,4113,1,"Public, 4-year or above",2,13,17,675244,598038,1273282,594865,538408,1133273,Basketball
99247,2019,178341,Missouri Southern State University,Joplin,MO,64801,4,NCAA Division II with football,1472,2312,3784,1,"Public, 4-year or above",2,28,24,756613,567499,1324112,651487,489455,1140942,Basketball
8401,2015,179566,Missouri State University-Springfield,Springfield,MO,65897,2,NCAA Division I-FCS,6039,8439,14478,1,"Public, 4-year or above",2,15,21,2279917,1690251,3970168,2279917,1690251,3970168,Basketball
25835,2016,179566,Missouri State University-Springfield,Springfield,MO,65897,2,NCAA Division I-FCS,6272,8736,15008,1,"Public, 4-year or above",2,15,13,2506636,1566309,4072945,2506636,1566309,4072945,Basketball
43325,2017,179566,Missouri State University-Springfield,Springfield,MO,65897,2,NCAA Division I-FCS,6365,8911,15276,1,"Public, 4-year or above",2,16,27,3070453,1647408,4717861,3070453,1647408,4717861,Basketball
61044,2018,179566,Missouri State University-Springfield,Springfield,MO,65897,2,NCAA Division I-FCS,6173,8685,14858,1,"Public, 4-year or above",2,16,18,2808838,2053071,4861909,2808838,2053071,4861909,Basketball
99907,2019,179566,Missouri State University-Springfield,Springfield,MO,65897,2,NCAA Division I-FCS,5754,8185,13939,1,"Public, 4-year or above",2,16,31,2810739,1816022,4626761,2810739,1816022,4626761,Basketball
8293,2015,178411,Missouri University of Science and Technology,Rolla,MO,65409,4,NCAA Division II with football,4693,1404,6097,1,"Public, 4-year or above",2,14,12,516378,499918,1016296,516378,495692,1012070,Basketball
25725,2016,178411,Missouri University of Science and Technology,Rolla,MO,65409,4,NCAA Division II with football,4760,1441,6201,1,"Public, 4-year or above",2,15,13,581968,553468,1135436,579554,553469,1133023,Basketball
43214,2017,178411,Missouri University of Science and Technology,Rolla,MO,65409,4,NCAA Division II with football,4653,1461,6114,1,"Public, 4-year or above",2,12,13,554215,490148,1044363,554215,490148,1044363,Basketball
60933,2018,178411,Missouri University of Science and Technology,Rolla,MO,65409,4,NCAA Division II with football,4580,1463,6043,1,"Public, 4-year or above",2,13,14,605416,572857,1178273,605416,572857,1178273,Basketball
99385,2019,178411,Missouri University of Science and Technology,Rolla,MO,65409,4,NCAA Division II with football,4308,1355,5663,1,"Public, 4-year or above",2,16,13,572372,515476,1087848,572372,515475,1087847,Basketball
8266,2015,178387,Missouri Western State University,Saint Joseph,MO,64507,4,NCAA Division II with football,1481,2129,3610,1,"Public, 4-year or above",2,13,14,529157,515969,1045126,523278,516169,1039447,Basketball
25698,2016,178387,Missouri Western State University,Saint Joseph,MO,64507,4,NCAA Division II with football,1379,2025,3404,1,"Public, 4-year or above",2,12,12,593469,579512,1172981,571238,579012,1150250,Basketball
43186,2017,178387,Missouri Western State University,Saint Joseph,MO,64507,4,NCAA Division II with football,1408,2066,3474,1,"Public, 4-year or above",2,15,14,547987,543557,1091544,547987,543557,1091544,Basketball
60905,2018,178387,Missouri Western State University,Saint Joseph,MO,64507,4,NCAA Division II with football,1411,2133,3544,1,"Public, 4-year or above",2,17,16,593193,631185,1224378,593193,631185,1224378,Basketball
99272,2019,178387,Missouri Western State University,Saint Joseph,MO,64507,4,NCAA Division II with football,1315,2056,3371,1,"Public, 4-year or above",2,17,15,524249,563030,1087279,526861,562652,1089513,Basketball
2409,2015,129774,Mitchell College,New London,CT,6320,7,NCAA Division III without football,351,264,615,2,"Private nonprofit, 4-year or above",2,14,16,57816,50434,108250,57816,50434,108250,Basketball
19780,2016,129774,Mitchell College,New London,CT,6320,7,NCAA Division III without football,311,226,537,2,"Private nonprofit, 4-year or above",2,17,16,75407,50419,125826,74610,51301,125911,Basketball
37219,2017,129774,Mitchell College,New London,CT,6320,7,NCAA Division III without football,335,240,575,2,"Private nonprofit, 4-year or above",2,16,11,73662,65513,139175,72003,63603,135606,Basketball
54855,2018,129774,Mitchell College,New London,CT,6320,7,NCAA Division III without football,317,236,553,2,"Private nonprofit, 4-year or above",2,21,12,88726,77370,166096,89493,77620,167113,Basketball
78989,2019,129774,Mitchell College,New London,CT,6320,7,NCAA Division III without football,331,247,578,2,"Private nonprofit, 4-year or above",2,25,14,95954,84616,180570,93052,81557,174609,Basketball
10006,2015,193292,Molloy College,Rockville Centre,NY,115715002,5,NCAA Division II without football,733,2013,2746,2,"Private nonprofit, 4-year or above",2,12,12,273903,298068,571971,268551,292809,561360,Basketball
27426,2016,193292,Molloy College,Rockville Centre,NY,11571,5,NCAA Division II without football,786,2114,2900,2,"Private nonprofit, 4-year or above",2,13,11,359128,297698,656826,358604,288605,647209,Basketball
44913,2017,193292,Molloy College,Rockville Centre,NY,11571,5,NCAA Division II without football,769,2029,2798,2,"Private nonprofit, 4-year or above",2,13,12,275258,266409,541667,294942,262041,556983,Basketball
62627,2018,193292,Molloy College,Rockville Centre,NY,11571,5,NCAA Division II without football,817,1945,2762,2,"Private nonprofit, 4-year or above",2,15,12,341461,276361,617822,328859,267588,596447,Basketball
105342,2019,193292,Molloy College,Rockville Centre,NY,11571,5,NCAA Division II without football,821,1956,2777,2,"Private nonprofit, 4-year or above",2,15,16,352929,334303,687232,338048,313039,651087,Basketball
4008,2015,147341,Monmouth College,Monmouth,IL,614621998,6,NCAA Division III with football,556,610,1166,2,"Private nonprofit, 4-year or above",2,24,20,80236,45124,125360,80236,45124,125360,Basketball
21383,2016,147341,Monmouth College,Monmouth,IL,61462,6,NCAA Division III with football,541,583,1124,2,"Private nonprofit, 4-year or above",2,18,10,91173,77301,168474,91173,77301,168474,Basketball
38849,2017,147341,Monmouth College,Monmouth,IL,61462,6,NCAA Division III with football,499,509,1008,2,"Private nonprofit, 4-year or above",2,18,10,76938,82615,159553,76938,82615,159553,Basketball
56510,2018,147341,Monmouth College,Monmouth,IL,61462,6,NCAA Division III with football,456,440,896,2,"Private nonprofit, 4-year or above",2,24,15,105075,77414,182489,105075,77414,182489,Basketball
84827,2019,147341,Monmouth College,Monmouth,IL,61462,6,NCAA Division III with football,448,449,897,2,"Private nonprofit, 4-year or above",2,25,15,91463,74255,165718,91463,74255,165718,Basketball
9079,2015,185572,Monmouth University,West Long Branch,NJ,77641898,2,NCAA Division I-FCS,1854,2586,4440,2,"Private nonprofit, 4-year or above",2,17,13,2054441,1470632,3525073,2054441,1470632,3525073,Basketball
26504,2016,185572,Monmouth University,West Long Branch,NJ,7764,2,NCAA Division I-FCS,1919,2565,4484,2,"Private nonprofit, 4-year or above",2,16,15,2690690,1654679,4345369,2690690,1654679,4345369,Basketball
43998,2017,185572,Monmouth University,West Long Branch,NJ,7764,2,NCAA Division I-FCS,1888,2613,4501,2,"Private nonprofit, 4-year or above",2,15,13,2617464,1670134,4287598,2617464,1670134,4287598,Basketball
61720,2018,185572,Monmouth University,West Long Branch,NJ,7764,2,NCAA Division I-FCS,1880,2567,4447,2,"Private nonprofit, 4-year or above",2,16,14,2795919,1853587,4649506,2795919,1853587,4649506,Basketball
102354,2019,185572,Monmouth University,West Long Branch,NJ,7764,2,NCAA Division I-FCS,1756,2545,4301,2,"Private nonprofit, 4-year or above",2,14,15,3103037,1899385,5002422,3103037,1899385,5002422,Basketball
8510,2015,180461,Montana State University,Bozeman,MT,59717,2,NCAA Division I-FCS,6391,5147,11538,1,"Public, 4-year or above",2,19,16,1494003,1133141,2627144,1679625,1403877,3083502,Basketball
25943,2016,180461,Montana State University,Bozeman,MT,59717,2,NCAA Division I-FCS,6708,5449,12157,1,"Public, 4-year or above",2,18,22,1883577,1280835,3164412,2017363,1518807,3536170,Basketball
43433,2017,180461,Montana State University,Bozeman,MT,597172420,2,NCAA Division I-FCS,6749,5552,12301,1,"Public, 4-year or above",2,15,23,1767166,1429908,3197074,1900780,1653209,3553989,Basketball
61149,2018,180461,Montana State University,Bozeman,MT,597172420,2,NCAA Division I-FCS,6747,5680,12427,1,"Public, 4-year or above",2,13,20,1833808,1299991,3133799,2094896,1542102,3636998,Basketball
100346,2019,180461,Montana State University,Bozeman,MT,597172420,2,NCAA Division I-FCS,6619,5656,12275,1,"Public, 4-year or above",2,15,19,1809316,1323942,3133258,1790002,1801231,3591233,Basketball
100256,2019,180179,Montana State University Billings,Billings,MT,59101,5,NCAA Division II without football,864,1312,2176,1,"Public, 4-year or above",2,13,16,548907,546062,1094969,607258,568276,1175534,Basketball
8484,2015,180179,Montana State University-Billings,Billings,MT,591010298,5,NCAA Division II without football,1095,1571,2666,1,"Public, 4-year or above",2,13,12,542100,473554,1015654,542100,473554,1015654,Basketball
25917,2016,180179,Montana State University-Billings,Billings,MT,59101,5,NCAA Division II without football,1069,1401,2470,1,"Public, 4-year or above",2,13,14,442180,471210,913390,382712,471210,853922,Basketball
43407,2017,180179,Montana State University-Billings,Billings,MT,59101,5,NCAA Division II without football,986,1378,2364,1,"Public, 4-year or above",2,12,13,654526,576745,1231271,639728,590764,1230492,Basketball
61124,2018,180179,Montana State University-Billings,Billings,MT,59101,5,NCAA Division II without football,906,1364,2270,1,"Public, 4-year or above",2,15,12,648209,486534,1134743,642067,481958,1124025,Basketball
9091,2015,185590,Montclair State University,Montclair,NJ,70431624,6,NCAA Division III with football,5441,8892,14333,1,"Public, 4-year or above",2,16,14,149337,176690,326027,151592,170869,322461,Basketball
26516,2016,185590,Montclair State University,Montclair,NJ,7043,6,NCAA Division III with football,5680,9177,14857,1,"Public, 4-year or above",2,15,14,184623,169221,353844,173519,166145,339664,Basketball
44010,2017,185590,Montclair State University,Montclair,NJ,7043,6,NCAA Division III with football,5756,9076,14832,1,"Public, 4-year or above",2,18,10,181599,183146,364745,178033,180406,358439,Basketball
61732,2018,185590,Montclair State University,Montclair,NJ,7043,6,NCAA Division III with football,5785,9229,15014,1,"Public, 4-year or above",2,18,13,191599,199275,390874,195291,192728,388019,Basketball
102392,2019,185590,Montclair State University,Montclair,NJ,7043,6,NCAA Division III with football,5654,9091,14745,1,"Public, 4-year or above",2,18,15,219422,254047,473469,228307,241442,469749,Basketball
6216,2015,163426,Montgomery College,Rockville,MD,20850,7,NCAA Division III without football,4073,3445,7518,4,"Public, 2-year",2,14,12,55532,52563,108095,55532,52563,108095,Basketball
13172,2015,214157,Moravian College,Bethlehem,PA,180186650,6,NCAA Division III with football,778,906,1684,2,"Private nonprofit, 4-year or above",2,17,17,168832,212583,381415,139930,166609,306539,Basketball
30630,2016,214157,Moravian College,Bethlehem,PA,18018,6,NCAA Division III with football,771,1022,1793,2,"Private nonprofit, 4-year or above",2,17,17,166074,257635,423709,165245,257635,422880,Basketball
48134,2017,214157,Moravian College,Bethlehem,PA,18018,6,NCAA Division III with football,765,1117,1882,2,"Private nonprofit, 4-year or above",2,16,17,195755,170018,365773,196502,160119,356621,Basketball
65888,2018,214157,Moravian College,Bethlehem,PA,18018,6,NCAA Division III with football,775,1142,1917,2,"Private nonprofit, 4-year or above",2,14,16,189475,188029,377504,191433,190161,381594,Basketball
116132,2019,214157,Moravian College,Bethlehem,PA,18018,6,NCAA Division III with football,762,1150,1912,2,"Private nonprofit, 4-year or above",2,13,18,160166,212940,373106,163533,178851,342384,Basketball
5621,2015,157386,Morehead State University,Morehead,KY,40351,2,NCAA Division I-FCS,2522,3570,6092,1,"Public, 4-year or above",2,15,13,1495716,1003196,2498912,1495716,1003196,2498912,Basketball
23001,2016,157386,Morehead State University,Morehead,KY,40351,2,NCAA Division I-FCS,2378,3414,5792,1,"Public, 4-year or above",2,14,17,1291001,1001156,2292157,1291001,1001156,2292157,Basketball
40497,2017,157386,Morehead State University,Morehead,KY,40351,2,NCAA Division I-FCS,2318,3304,5622,1,"Public, 4-year or above",2,14,14,1271859,1118101,2389960,1271859,1118101,2389960,Basketball
58179,2018,157386,Morehead State University,Morehead,KY,40351,2,NCAA Division I-FCS,2215,3320,5535,1,"Public, 4-year or above",2,14,15,1361968,1153611,2515579,1361968,1153611,2515579,Basketball
90268,2019,157386,Morehead State University,Morehead,KY,40351,2,NCAA Division I-FCS,2050,3167,5217,1,"Public, 4-year or above",2,13,13,1156439,987225,2143664,1156439,987225,2143664,Basketball
6221,2015,163453,Morgan State University,Baltimore,MD,212510001,2,NCAA Division I-FCS,2585,3004,5589,1,"Public, 4-year or above",2,16,15,1673875,1033685,2707560,1363395,977454,2340849,Basketball
23603,2016,163453,Morgan State University,Baltimore,MD,21251,2,NCAA Division I-FCS,2809,2929,5738,1,"Public, 4-year or above",2,13,16,1948862,913733,2862595,1474776,884302,2359078,Basketball
41106,2017,163453,Morgan State University,Baltimore,MD,21251,2,NCAA Division I-FCS,2753,3071,5824,1,"Public, 4-year or above",2,15,15,1994485,1222029,3216514,1516486,1127656,2644142,Basketball
58799,2018,163453,Morgan State University,Baltimore,MD,21251,2,NCAA Division I-FCS,2626,3203,5829,1,"Public, 4-year or above",2,15,15,1517680,1034188,2551868,1517680,1034188,2551868,Basketball
92492,2019,163453,Morgan State University,Baltimore,MD,21251,2,NCAA Division I-FCS,2455,3301,5756,1,"Public, 4-year or above",2,23,18,2004471,1166355,3170826,1562297,1053481,2615778,Basketball
10432,2015,196051,Morrisville State College,Morrisville,NY,13408,6,NCAA Division III with football,1290,1200,2490,1,"Public, 4-year or above",2,17,11,145660,122375,268035,139605,119330,258935,Basketball
27857,2016,196051,Morrisville State College,Morrisville,NY,13408,6,NCAA Division III with football,1318,1269,2587,1,"Public, 4-year or above",2,16,11,160900,130620,291520,150350,127070,277420,Basketball
45351,2017,196051,Morrisville State College,Morrisville,NY,13408,6,NCAA Division III with football,1287,1290,2577,1,"Public, 4-year or above",2,13,11,169064,144254,313318,166414,142609,309023,Basketball
63061,2018,196051,Morrisville State College,Morrisville,NY,13408,6,NCAA Division III with football,1264,1195,2459,1,"Public, 4-year or above",2,13,13,188828,151279,340107,179101,137591,316692,Basketball
13183,2015,214166,Mount Aloysius College,Cresson,PA,166301999,7,NCAA Division III without football,359,810,1169,2,"Private nonprofit, 4-year or above",2,16,11,64048,66585,130633,64048,66585,130633,Basketball
30641,2016,214166,Mount Aloysius College,Cresson,PA,16630,7,NCAA Division III without football,334,742,1076,2,"Private nonprofit, 4-year or above",2,13,12,61902,71537,133439,61902,71537,133439,Basketball
48145,2017,214166,Mount Aloysius College,Cresson,PA,16630,7,NCAA Division III without football,313,677,990,2,"Private nonprofit, 4-year or above",2,14,11,75783,54018,129801,75783,54018,129801,Basketball
65899,2018,214166,Mount Aloysius College,Cresson,PA,16630,7,NCAA Division III without football,310,665,975,2,"Private nonprofit, 4-year or above",2,13,8,73470,57998,131468,73470,57998,131468,Basketball
116170,2019,214166,Mount Aloysius College,Cresson,PA,16630,7,NCAA Division III without football,281,659,940,2,"Private nonprofit, 4-year or above",2,15,11,64940,47974,112914,64940,47974,112914,Basketball
6723,2015,166948,Mount Ida College,Newton,MA,2459,6,NCAA Division III with football,408,833,1241,2,"Private nonprofit, 4-year or above",2,16,12,146722,115046,261768,146722,115046,261768,Basketball
24109,2016,166948,Mount Ida College,Newton,MA,2459,6,NCAA Division III with football,397,897,1294,2,"Private nonprofit, 4-year or above",2,19,18,112638,103669,216307,112638,103669,216307,Basketball
11731,2015,204200,Mount Saint Joseph University,Cincinnati,OH,452331670,6,NCAA Division III with football,531,563,1094,2,"Private nonprofit, 4-year or above",2,15,15,158963,127060,286023,158963,127060,286023,Basketball
29175,2016,204200,Mount Saint Joseph University,Cincinnati,OH,45233,6,NCAA Division III with football,480,516,996,2,"Private nonprofit, 4-year or above",2,18,12,158487,113021,271508,158487,113021,271508,Basketball
46676,2017,204200,Mount Saint Joseph University,Cincinnati,OH,45233,6,NCAA Division III with football,460,539,999,2,"Private nonprofit, 4-year or above",2,21,17,165159,136319,301478,165159,136319,301478,Basketball
64411,2018,204200,Mount Saint Joseph University,Cincinnati,OH,45233,6,NCAA Division III with football,475,529,1004,2,"Private nonprofit, 4-year or above",2,17,14,174903,153176,328079,174903,153176,328079,Basketball
111239,2019,204200,Mount Saint Joseph University,Cincinnati,OH,45233,6,NCAA Division III with football,454,552,1006,2,"Private nonprofit, 4-year or above",2,16,12,151811,176568,328379,151811,176568,328379,Basketball
10034,2015,193353,Mount Saint Mary College,Newburgh,NY,12550,7,NCAA Division III without football,539,1241,1780,2,"Private nonprofit, 4-year or above",2,17,14,123390,119472,242862,116046,118464,234510,Basketball
27453,2016,193353,Mount Saint Mary College,Newburgh,NY,12550,7,NCAA Division III without football,506,1242,1748,2,"Private nonprofit, 4-year or above",2,17,13,124598,107324,231922,119685,107047,226732,Basketball
44941,2017,193353,Mount Saint Mary College,Newburgh,NY,12550,7,NCAA Division III without football,530,1206,1736,2,"Private nonprofit, 4-year or above",2,18,15,133636,125380,259016,122150,119982,242132,Basketball
62654,2018,193353,Mount Saint Mary College,Newburgh,NY,12550,7,NCAA Division III without football,515,1159,1674,2,"Private nonprofit, 4-year or above",2,14,16,140695,121317,262012,132753,115860,248613,Basketball
105426,2019,193353,Mount Saint Mary College,Newburgh,NY,12550,7,NCAA Division III without football,459,1137,1596,2,"Private nonprofit, 4-year or above",2,15,13,144618,119582,264200,138677,116432,255109,Basketball
6229,2015,163462,Mount St Mary's University,Emmitsburg,MD,217277799,3,NCAA Division I without football,777,912,1689,2,"Private nonprofit, 4-year or above",2,14,15,1687798,1052657,2740455,1687798,1052657,2740455,Basketball
23611,2016,163462,Mount St Mary's University,Emmitsburg,MD,21727,3,NCAA Division I without football,744,883,1627,2,"Private nonprofit, 4-year or above",2,15,14,1987585,1026520,3014105,1987585,1026520,3014105,Basketball
41114,2017,163462,Mount St. Mary's University,Emmitsburg,MD,21727,3,NCAA Division I without football,795,891,1686,2,"Private nonprofit, 4-year or above",2,16,15,1879730,1070939,2950669,1879730,1070939,2950669,Basketball
58807,2018,163462,Mount St. Mary's University,Emmitsburg,MD,21727,3,NCAA Division I without football,834,892,1726,2,"Private nonprofit, 4-year or above",2,16,15,1815414,1161269,2976683,1815414,1161269,2976683,Basketball
92530,2019,163462,Mount St. Mary's University,Emmitsburg,MD,21727,3,NCAA Division I without football,864,870,1734,2,"Private nonprofit, 4-year or above",2,15,13,1712527,1039284,2751811,1712527,1039284,2751811,Basketball
13192,2015,214175,Muhlenberg College,Allentown,PA,18104,6,NCAA Division III with football,909,1369,2278,2,"Private nonprofit, 4-year or above",2,18,14,178175,116168,294343,162847,112641,275488,Basketball
30650,2016,214175,Muhlenberg College,Allentown,PA,18104,6,NCAA Division III with football,915,1397,2312,2,"Private nonprofit, 4-year or above",2,16,20,114667,100439,215106,93090,100426,193516,Basketball
48154,2017,214175,Muhlenberg College,Allentown,PA,18104,6,NCAA Division III with football,920,1358,2278,2,"Private nonprofit, 4-year or above",2,14,18,106983,154060,261043,117850,149347,267197,Basketball
65908,2018,214175,Muhlenberg College,Allentown,PA,18104,6,NCAA Division III with football,878,1363,2241,2,"Private nonprofit, 4-year or above",2,14,21,175510,295522,471032,138935,300225,439160,Basketball
116180,2019,214175,Muhlenberg College,Allentown,PA,18104,6,NCAA Division III with football,857,1333,2190,2,"Private nonprofit, 4-year or above",2,18,16,130880,150016,280896,121502,131689,253191,Basketball
5631,2015,157401,Murray State University,Murray,KY,420713318,2,NCAA Division I-FCS,2985,4072,7057,1,"Public, 4-year or above",2,13,15,3807149,1225121,5032270,2218712,1100787,3319499,Basketball
23011,2016,157401,Murray State University,Murray,KY,42071,2,NCAA Division I-FCS,2963,3953,6916,1,"Public, 4-year or above",2,12,16,3114154,1152431,4266585,1957966,1099606,3057572,Basketball
40507,2017,157401,Murray State University,Murray,KY,42071,2,NCAA Division I-FCS,2714,3804,6518,1,"Public, 4-year or above",2,13,14,2245249,1028418,3273667,2123603,1028418,3152021,Basketball
58189,2018,157401,Murray State University,Murray,KY,42071,2,NCAA Division I-FCS,2517,3670,6187,1,"Public, 4-year or above",2,13,15,3896362,1316900,5213262,2398909,1131187,3530096,Basketball
90306,2019,157401,Murray State University,Murray,KY,42071,2,NCAA Division I-FCS,2426,3701,6127,1,"Public, 4-year or above",2,13,13,3982343,1262237,5244580,2555342,1126555,3681897,Basketball
11742,2015,204264,Muskingum University,New Concord,OH,43762,6,NCAA Division III with football,680,714,1394,2,"Private nonprofit, 4-year or above",2,35,18,107638,87534,195172,107349,87493,194842,Basketball
29185,2016,204264,Muskingum University,New Concord,OH,43762,6,NCAA Division III with football,645,647,1292,2,"Private nonprofit, 4-year or above",2,26,19,130637,111934,242571,130637,111934,242571,Basketball
46687,2017,204264,Muskingum University,New Concord,OH,43762,6,NCAA Division III with football,650,700,1350,2,"Private nonprofit, 4-year or above",2,28,21,172856,130060,302916,153209,128633,281842,Basketball
64422,2018,204264,Muskingum University,New Concord,OH,43762,6,NCAA Division III with football,642,703,1345,2,"Private nonprofit, 4-year or above",2,22,20,198954,171073,370027,174450,162000,336450,Basketball
111250,2019,204264,Muskingum University,New Concord,OH,43762,6,NCAA Division III with football,632,723,1355,2,"Private nonprofit, 4-year or above",2,24,12,154728,127645,282373,145815,125835,271650,Basketball
10063,2015,193584,Nazareth College,Rochester,NY,146183790,7,NCAA Division III without football,576,1395,1971,2,"Private nonprofit, 4-year or above",2,20,18,126309,101016,227325,114627,93649,208276,Basketball
27482,2016,193584,Nazareth College,Rochester,NY,14618,7,NCAA Division III without football,558,1481,2039,2,"Private nonprofit, 4-year or above",2,14,16,157004,114244,271248,129787,97352,227139,Basketball
44970,2017,193584,Nazareth College,Rochester,NY,14618,7,NCAA Division III without football,543,1552,2095,2,"Private nonprofit, 4-year or above",2,16,18,155795,113233,269028,132566,100125,232691,Basketball
62685,2018,193584,Nazareth College,Rochester,NY,14618,7,NCAA Division III without football,561,1615,2176,2,"Private nonprofit, 4-year or above",2,13,16,210407,142633,353040,132246,105722,237968,Basketball
105481,2019,193584,Nazareth College,Rochester,NY,14618,7,NCAA Division III without football,580,1597,2177,2,"Private nonprofit, 4-year or above",2,15,18,180604,122403,303007,155239,108410,263649,Basketball
8654,2015,181446,Nebraska Wesleyan University,Lincoln,NE,685042794,6,NCAA Division III with football,641,846,1487,2,"Private nonprofit, 4-year or above",2,33,16,158611,85690,244301,158611,75277,233888,Basketball
26086,2016,181446,Nebraska Wesleyan University,Lincoln,NE,68504,6,NCAA Division III with football,712,857,1569,2,"Private nonprofit, 4-year or above",2,33,21,152904,96598,249502,143257,96598,239855,Basketball
43581,2017,181446,Nebraska Wesleyan University,Lincoln,NE,68504,6,NCAA Division III with football,655,891,1546,2,"Private nonprofit, 4-year or above",2,24,22,168081,85483,253564,167386,84150,251536,Basketball
61298,2018,181446,Nebraska Wesleyan University,Lincoln,NE,68504,6,NCAA Division III with football,701,968,1669,2,"Private nonprofit, 4-year or above",2,34,14,164353,84903,249256,164353,84417,248770,Basketball
100861,2019,181446,Nebraska Wesleyan University,Lincoln,NE,68504,6,NCAA Division III with football,720,972,1692,2,"Private nonprofit, 4-year or above",2,34,12,255131,92600,347731,218012,98093,316105,Basketball
13204,2015,214272,Neumann University,Aston,PA,190141298,7,NCAA Division III without football,654,1148,1802,2,"Private nonprofit, 4-year or above",2,13,14,76391,73412,149803,76391,73412,149803,Basketball
30662,2016,214272,Neumann University,Aston,PA,19014,7,NCAA Division III without football,561,1045,1606,2,"Private nonprofit, 4-year or above",2,12,12,71297,60388,131685,71297,60388,131685,Basketball
48166,2017,214272,Neumann University,Aston,PA,19014,7,NCAA Division III without football,509,953,1462,2,"Private nonprofit, 4-year or above",2,16,15,82434,67301,149735,82434,67301,149735,Basketball
65920,2018,214272,Neumann University,Aston,PA,19014,7,NCAA Division III without football,480,951,1431,2,"Private nonprofit, 4-year or above",2,14,12,82218,73396,155614,82218,73396,155614,Basketball
116218,2019,214272,Neumann University,Aston,PA,19014,7,NCAA Division III without football,461,923,1384,2,"Private nonprofit, 4-year or above",2,14,13,77044,87597,164641,77044,87597,164641,Basketball
8812,2015,182980,New England College,Henniker,NH,3242,7,NCAA Division III without football,736,1121,1857,2,"Private nonprofit, 4-year or above",2,16,18,109908,125004,234912,109908,125004,234912,Basketball
26237,2016,182980,New England College,Henniker,NH,3242,7,NCAA Division III without football,720,1021,1741,2,"Private nonprofit, 4-year or above",2,15,15,123705,141813,265518,123705,141813,265518,Basketball
43733,2017,182980,New England College,Henniker,NH,3242,7,NCAA Division III without football,722,1071,1793,2,"Private nonprofit, 4-year or above",2,17,14,141590,151282,292872,141590,151282,292872,Basketball
61449,2018,182980,New England College,Henniker,NH,3242,7,NCAA Division III without football,700,959,1659,2,"Private nonprofit, 4-year or above",2,15,20,207673,165850,373523,207673,165850,373523,Basketball
101374,2019,182980,New England College,Henniker,NH,3242,7,NCAA Division III without football,737,1072,1809,2,"Private nonprofit, 4-year or above",2,18,18,191822,148294,340116,191822,148294,340116,Basketball
9048,2015,185129,New Jersey City University,Jersey City,NJ,7305,7,NCAA Division III without football,2005,2795,4800,1,"Public, 4-year or above",2,15,15,185199,183017,368216,185199,183017,368216,Basketball
26473,2016,185129,New Jersey City University,Jersey City,NJ,7305,7,NCAA Division III without football,2153,2959,5112,1,"Public, 4-year or above",2,16,16,114563,127423,241986,114563,127423,241986,Basketball
43966,2017,185129,New Jersey City University,Jersey City,NJ,7305,7,NCAA Division III without football,2165,3006,5171,1,"Public, 4-year or above",2,18,15,203449,138183,341632,203449,138183,341632,Basketball
61686,2018,185129,New Jersey City University,Jersey City,NJ,7305,7,NCAA Division III without football,2100,2939,5039,1,"Public, 4-year or above",2,16,15,194538,188001,382539,194538,188001,382539,Basketball
102290,2019,185129,New Jersey City University,Jersey City,NJ,7305,7,NCAA Division III without football,2104,2829,4933,1,"Public, 4-year or above",2,15,16,12421,11523,23944,208247,188253,396500,Basketball
9103,2015,185828,New Jersey Institute of Technology,Newark,NJ,7102,3,NCAA Division I without football,4801,1298,6099,1,"Public, 4-year or above",2,16,15,1823046,1527189,3350235,1823046,1526619,3349665,Basketball
26528,2016,185828,New Jersey Institute of Technology,Newark,NJ,7102,3,NCAA Division I without football,4758,1394,6152,1,"Public, 4-year or above",2,14,15,1723391,1496509,3219900,1723391,1496509,3219900,Basketball
44022,2017,185828,New Jersey Institute of Technology,Newark,NJ,7102,3,NCAA Division I without football,4857,1492,6349,1,"Public, 4-year or above",2,13,16,1719551,1661412,3380963,1701490,1658258,3359748,Basketball
61745,2018,185828,New Jersey Institute of Technology,Newark,NJ,7102,3,NCAA Division I without football,5183,1611,6794,1,"Public, 4-year or above",2,14,15,1857284,1524632,3381916,1857283,1517583,3374866,Basketball
102429,2019,185828,New Jersey Institute of Technology,Newark,NJ,7102,3,NCAA Division I without football,5138,1714,6852,1,"Public, 4-year or above",2,14,14,1789831,1436394,3226225,1773540,1430871,3204411,Basketball
9296,2015,187897,New Mexico Highlands University,Las Vegas,NM,87701,4,NCAA Division II with football,656,815,1471,1,"Public, 4-year or above",2,17,16,337438,239611,577049,337438,239611,577049,Basketball
26717,2016,187897,New Mexico Highlands University,Las Vegas,NM,87701,4,NCAA Division II with football,643,819,1462,1,"Public, 4-year or above",2,19,13,394048,306936,700984,394048,306936,700984,Basketball
44212,2017,187897,New Mexico Highlands University,Las Vegas,NM,87701,4,NCAA Division II with football,564,746,1310,1,"Public, 4-year or above",2,17,13,424352,281598,705950,424352,281598,705950,Basketball
61934,2018,187897,New Mexico Highlands University,Las Vegas,NM,87701,4,NCAA Division II with football,531,701,1232,1,"Public, 4-year or above",2,16,12,433160,276167,709327,433160,276167,709327,Basketball
102952,2019,187897,New Mexico Highlands University,Las Vegas,NM,87701,4,NCAA Division II with football,509,673,1182,1,"Public, 4-year or above",2,18,13,406233,254939,661172,406233,254939,661172,Basketball
9329,2015,188030,New Mexico State University-Main Campus,Las Cruces,NM,880038001,1,NCAA Division I-FBS,4899,5399,10298,1,"Public, 4-year or above",2,14,15,3003045,1563961,4567006,3003045,1563961,4567006,Basketball
26750,2016,188030,New Mexico State University-Main Campus,Las Cruces,NM,88003,1,NCAA Division I-FBS,4609,5216,9825,1,"Public, 4-year or above",2,19,17,2391115,1358879,3749994,2391115,1358879,3749994,Basketball
44245,2017,188030,New Mexico State University-Main Campus,Las Cruces,NM,88003,1,NCAA Division I-FBS,4394,5267,9661,1,"Public, 4-year or above",2,20,20,2485019,1596948,4081967,2485019,1596948,4081967,Basketball
61967,2018,188030,New Mexico State University-Main Campus,Las Cruces,NM,88003,1,NCAA Division I-FBS,4329,5355,9684,1,"Public, 4-year or above",2,20,16,3077862,1665773,4743635,3077862,1665773,4743635,Basketball
103076,2019,188030,New Mexico State University-Main Campus,Las Cruces,NM,88003,1,NCAA Division I-FBS,4228,5480,9708,1,"Public, 4-year or above",2,20,13,3286270,1623904,4910174,3286270,1623904,4910174,Basketball
10116,2015,194091,New York Institute of Technology,Old Westbury,NY,115688000,5,NCAA Division II without football,2218,1263,3481,2,"Private nonprofit, 4-year or above",2,15,14,321238,431388,752626,321238,431388,752626,Basketball
27536,2016,194091,New York Institute of Technology,Old Westbury,NY,115688000,5,NCAA Division II without football,2033,1135,3168,2,"Private nonprofit, 4-year or above",2,18,12,454005,509430,963435,454005,509430,963435,Basketball
45025,2017,194091,New York Institute of Technology,Old Westbury,NY,11568,5,NCAA Division II without football,2048,1181,3229,2,"Private nonprofit, 4-year or above",2,14,14,554284,503915,1058199,554284,503915,1058199,Basketball
62732,2018,194091,New York Institute of Technology,Old Westbury,NY,11568,5,NCAA Division II without football,1990,1258,3248,2,"Private nonprofit, 4-year or above",2,16,16,612555,542099,1154654,606159,562229,1168388,Basketball
105647,2019,194091,New York Institute of Technology,Old Westbury,NY,11568,5,NCAA Division II without football,2039,1316,3355,2,"Private nonprofit, 4-year or above",2,16,18,590473,538523,1128996,645461,622350,1267811,Basketball
10082,2015,193900,New York University,New York,NY,100121091,7,NCAA Division III without football,10447,13805,24252,2,"Private nonprofit, 4-year or above",2,17,18,625786,675420,1301206,548233,598656,1146889,Basketball
27502,2016,193900,New York University,New York,NY,10012,7,NCAA Division III without football,10544,14158,24702,2,"Private nonprofit, 4-year or above",2,16,15,666472,697588,1364060,634139,665256,1299395,Basketball
44991,2017,193900,New York University,New York,NY,10012,7,NCAA Division III without football,10745,14430,25175,2,"Private nonprofit, 4-year or above",2,18,21,838953,746961,1585914,806014,714022,1520036,Basketball
62698,2018,193900,New York University,New York,NY,10012,7,NCAA Division III without football,10838,14682,25520,2,"Private nonprofit, 4-year or above",2,19,16,713571,776743,1490314,697646,760818,1458464,Basketball
105495,2019,193900,New York University,New York,NY,10012,7,NCAA Division III without football,10901,14795,25696,2,"Private nonprofit, 4-year or above",2,17,20,728474,759192,1487666,691000,726017,1417017,Basketball
14054,2015,218414,Newberry College,Newberry,SC,29108,4,NCAA Division II with football,558,473,1031,2,"Private nonprofit, 4-year or above",2,23,15,436214,455409,891623,436213,455409,891622,Basketball
31510,2016,218414,Newberry College,Newberry,SC,29108,4,NCAA Division II with football,565,487,1052,2,"Private nonprofit, 4-year or above",2,25,17,419507,445378,864885,419507,445378,864885,Basketball
49023,2017,218414,Newberry College,Newberry,SC,29108,4,NCAA Division II with football,650,508,1158,2,"Private nonprofit, 4-year or above",2,30,19,485984,495895,981879,485984,495895,981879,Basketball
66783,2018,218414,Newberry College,Newberry,SC,29108,4,NCAA Division II with football,684,506,1190,2,"Private nonprofit, 4-year or above",2,28,21,458320,467377,925697,458320,467377,925697,Basketball
118963,2019,218414,Newberry College,Newberry,SC,29108,4,NCAA Division II with football,705,520,1225,2,"Private nonprofit, 4-year or above",2,26,21,395674,417390,813064,416873,462702,879575,Basketball
6734,2015,167251,Newbury College,Brookline,MA,2445,7,NCAA Division III without football,350,428,778,2,"Private nonprofit, 4-year or above",2,17,12,104759,111431,216190,104759,111431,216190,Basketball
24120,2016,167251,Newbury College,Brookline,MA,2445,7,NCAA Division III without football,290,385,675,2,"Private nonprofit, 4-year or above",2,16,10,86872,70092,156964,86872,70092,156964,Basketball
41620,2017,167251,Newbury College,Brookline,MA,2445,7,NCAA Division III without football,242,303,545,2,"Private nonprofit, 4-year or above",2,13,10,76870,80477,157347,76870,80477,157347,Basketball
5306,2015,155335,Newman University,Wichita,KS,672132097,5,NCAA Division II without football,342,649,991,2,"Private nonprofit, 4-year or above",2,17,14,501603,485858,987461,501603,485858,987461,Basketball
22670,2016,155335,Newman University,Wichita,KS,67213,5,NCAA Division II without football,325,643,968,2,"Private nonprofit, 4-year or above",2,19,14,505662,524162,1029824,505662,524162,1029824,Basketball
40153,2017,155335,Newman University,Wichita,KS,67213,5,NCAA Division II without football,334,673,1007,2,"Private nonprofit, 4-year or above",2,19,16,563686,621975,1185661,563686,621975,1185661,Basketball
57826,2018,155335,Newman University,Wichita,KS,67213,5,NCAA Division II without football,337,655,992,2,"Private nonprofit, 4-year or above",2,19,13,620182,579927,1200109,620182,579927,1200109,Basketball
89289,2019,155335,Newman University,Wichita,KS,67213,5,NCAA Division II without football,323,584,907,2,"Private nonprofit, 4-year or above",2,20,14,611838,607055,1218893,611838,607055,1218893,Basketball
10100,2015,193973,Niagara University,Niagara University,NY,14109,3,NCAA Division I without football,1119,1711,2830,2,"Private nonprofit, 4-year or above",2,15,12,1622963,1296409,2919372,1622963,1296409,2919372,Basketball
27520,2016,193973,Niagara University,Niagara University,NY,14109,3,NCAA Division I without football,1110,1803,2913,2,"Private nonprofit, 4-year or above",2,14,15,1796129,1540060,3336189,1796129,1540060,3336189,Basketball
45009,2017,193973,Niagara University,Niagara University,NY,14109,3,NCAA Division I without football,1067,1716,2783,2,"Private nonprofit, 4-year or above",2,13,13,2020153,1490632,3510785,2020153,1490632,3510785,Basketball
62716,2018,193973,Niagara University,Niagara University,NY,14109,3,NCAA Division I without football,979,1654,2633,2,"Private nonprofit, 4-year or above",2,14,13,1683937,1478052,3161989,1683937,1478052,3161989,Basketball
105571,2019,193973,Niagara University,Niagara University,NY,14109,3,NCAA Division I without football,962,1687,2649,2,"Private nonprofit, 4-year or above",2,14,11,1669441,1422554,3091995,1669441,1422554,3091995,Basketball
5814,2015,159966,Nicholls State University,Thibodaux,LA,70310,2,NCAA Division I-FCS,1701,2875,4576,1,"Public, 4-year or above",2,21,19,704139,783760,1487899,697767,661420,1359187,Basketball
23198,2016,159966,Nicholls State University,Thibodaux,LA,70301,2,NCAA Division I-FCS,1673,2912,4585,1,"Public, 4-year or above",2,15,14,843975,787866,1631841,797660,680526,1478186,Basketball
40696,2017,159966,Nicholls State University,Thibodaux,LA,70310,2,NCAA Division I-FCS,1713,2946,4659,1,"Public, 4-year or above",2,14,14,849161,770685,1619846,831561,739914,1571475,Basketball
58380,2018,159966,Nicholls State University,Thibodaux,LA,70301,2,NCAA Division I-FCS,1797,3094,4891,1,"Public, 4-year or above",2,18,14,821452,774491,1595943,798687,733322,1532009,Basketball
91006,2019,159966,Nicholls State University,Thibodaux,LA,70301,2,NCAA Division I-FCS,1814,3157,4971,1,"Public, 4-year or above",2,16,14,901963,837307,1739270,847383,737886,1585269,Basketball
6743,2015,167260,Nichols College,Dudley,MA,15715000,6,NCAA Division III with football,742,410,1152,2,"Private nonprofit, 4-year or above",2,25,14,86208,157667,243875,84777,151749,236526,Basketball
24129,2016,167260,Nichols College,Dudley,MA,1571,6,NCAA Division III with football,716,443,1159,2,"Private nonprofit, 4-year or above",2,28,11,196944,133715,330659,193843,130323,324166,Basketball
41629,2017,167260,Nichols College,Dudley,MA,1571,6,NCAA Division III with football,787,445,1232,2,"Private nonprofit, 4-year or above",2,26,14,212041,132141,344182,208066,130766,338832,Basketball
59319,2018,167260,Nichols College,Dudley,MA,1571,6,NCAA Division III with football,772,450,1222,2,"Private nonprofit, 4-year or above",2,18,14,168444,158913,327357,160701,154823,315524,Basketball
93990,2019,167260,Nichols College,Dudley,MA,1571,6,NCAA Division III with football,779,438,1217,2,"Private nonprofit, 4-year or above",2,18,14,153499,116261,269760,153499,116261,269760,Basketball
15762,2015,232937,Norfolk State University,Norfolk,VA,235048000,2,NCAA Division I-FCS,1451,2287,3738,1,"Public, 4-year or above",2,15,15,1170179,989859,2160038,1170179,989859,2160038,Basketball
33236,2016,232937,Norfolk State University,Norfolk,VA,23504,2,NCAA Division I-FCS,1493,2507,4000,1,"Public, 4-year or above",2,13,17,1512993,1090159,2603152,1512993,1090159,2603152,Basketball
50779,2017,232937,Norfolk State University,Norfolk,VA,23504,2,NCAA Division I-FCS,1477,2533,4010,1,"Public, 4-year or above",2,14,15,1432489,1146784,2579273,1432489,1146784,2579273,Basketball
68525,2018,232937,Norfolk State University,Norfolk,VA,23504,2,NCAA Division I-FCS,1462,2671,4133,1,"Public, 4-year or above",2,14,13,1477761,1142452,2620213,1477761,1142452,2620213,Basketball
125828,2019,232937,Norfolk State University,Norfolk,VA,23504,2,NCAA Division I-FCS,1568,3002,4570,1,"Public, 4-year or above",2,14,15,1563011,1215690,2778701,1563011,1215690,2778701,Basketball
11060,2015,199102,North Carolina A & T State University,Greensboro,NC,27411,2,NCAA Division I-FCS,3769,4607,8376,1,"Public, 4-year or above",2,20,15,1355182,1000045,2355227,1355182,997822,2353004,Basketball
28499,2016,199102,North Carolina A & T State University,Greensboro,NC,27411,2,NCAA Division I-FCS,3827,4830,8657,1,"Public, 4-year or above",2,20,16,1245098,1157586,2402684,1245023,1157511,2402534,Basketball
45992,2017,199102,North Carolina A & T State University,Greensboro,NC,27411,2,NCAA Division I-FCS,3982,5281,9263,1,"Public, 4-year or above",2,12,14,1357037,1270578,2627615,1357037,1270578,2627615,Basketball
63712,2018,199102,North Carolina A & T State University,Greensboro,NC,27411,2,NCAA Division I-FCS,4053,5460,9513,1,"Public, 4-year or above",2,18,14,1409516,1447460,2856976,1409516,1447460,2856976,Basketball
108690,2019,199102,North Carolina A & T State University,Greensboro,NC,27411,2,NCAA Division I-FCS,4057,5869,9926,1,"Public, 4-year or above",2,17,16,1636852,1367391,3004243,1659795,1380339,3040134,Basketball
11109,2015,199157,North Carolina Central University,Durham,NC,27707,2,NCAA Division I-FCS,1754,3367,5121,1,"Public, 4-year or above",2,17,14,1752803,983346,2736149,1752803,983346,2736149,Basketball
28549,2016,199157,North Carolina Central University,Durham,NC,27707,2,NCAA Division I-FCS,1827,3411,5238,1,"Public, 4-year or above",2,19,15,931046,1097107,2028153,1847936,1097107,2945043,Basketball
46042,2017,199157,North Carolina Central University,Durham,NC,27707,1,NCAA Division I-FBS,1805,3471,5276,1,"Public, 4-year or above",2,17,17,1661345,1195664,2857009,1661345,1195664,2857009,Basketball
63762,2018,199157,North Carolina Central University,Durham,NC,27707,2,NCAA Division I-FCS,1706,3531,5237,1,"Public, 4-year or above",2,13,15,1710811,1409305,3120116,1710811,1409305,3120116,Basketball
108880,2019,199157,North Carolina Central University,Durham,NC,27707,2,NCAA Division I-FCS,1547,3319,4866,1,"Public, 4-year or above",2,16,24,1824994,1492765,3317759,1824994,1492765,3317759,Basketball
11117,2015,199193,North Carolina State University at Raleigh,Raleigh,NC,276957001,1,NCAA Division I-FBS,11411,9483,20894,1,"Public, 4-year or above",2,13,16,13634015,849502,14483517,8714435,3179570,11894005,Basketball
28557,2016,199193,North Carolina State University at Raleigh,Raleigh,NC,27695,1,NCAA Division I-FBS,11323,9495,20818,1,"Public, 4-year or above",2,17,14,14611434,1056295,15667729,9638081,3262796,12900877,Basketball
46050,2017,199193,North Carolina State University at Raleigh,Raleigh,NC,27695,1,NCAA Division I-FBS,11506,9734,21240,1,"Public, 4-year or above",2,15,14,16100635,1027356,17127991,9902049,3371110,13273159,Basketball
63770,2018,199193,North Carolina State University at Raleigh,Raleigh,NC,27695,1,NCAA Division I-FBS,11695,10438,22133,1,"Public, 4-year or above",2,14,13,16533014,1026044,17559058,10295048,3522567,13817615,Basketball
108888,2019,199193,North Carolina State University at Raleigh,Raleigh,NC,27695,1,NCAA Division I-FBS,11777,10845,22622,1,"Public, 4-year or above",2,15,14,15361204,1074986,16436190,9787691,3820872,13608563,Basketball
11130,2015,199209,North Carolina Wesleyan College,Rocky Mount,NC,27804,6,NCAA Division III with football,751,972,1723,2,"Private nonprofit, 4-year or above",2,21,14,203926,124063,327989,149001,99554,248555,Basketball
28570,2016,199209,North Carolina Wesleyan College,Rocky Mount,NC,27804,6,NCAA Division III with football,757,1026,1783,2,"Private nonprofit, 4-year or above",2,15,19,157726,107018,264744,148886,101031,249917,Basketball
46063,2017,199209,North Carolina Wesleyan College,Rocky Mount,NC,27804,6,NCAA Division III with football,762,992,1754,2,"Private nonprofit, 4-year or above",2,22,19,196132,115563,311695,193631,115563,309194,Basketball
63783,2018,199209,North Carolina Wesleyan College,Rocky Mount,NC,27804,6,NCAA Division III with football,777,899,1676,2,"Private nonprofit, 4-year or above",2,19,14,219929,116890,336819,219929,116890,336819,Basketball
108926,2019,199209,North Carolina Wesleyan College,Rocky Mount,NC,27804,6,NCAA Division III with football,705,895,1600,2,"Private nonprofit, 4-year or above",2,16,12,180740,109485,290225,180740,109485,290225,Basketball
4039,2015,147660,North Central College,Naperville,IL,60540,6,NCAA Division III with football,1186,1388,2574,2,"Private nonprofit, 4-year or above",2,18,16,239416,187589,427005,235545,172222,407767,Basketball
21415,2016,147660,North Central College,Naperville,IL,60540,6,NCAA Division III with football,1178,1356,2534,2,"Private nonprofit, 4-year or above",2,16,22,283115,207094,490209,272628,185482,458110,Basketball
38881,2017,147660,North Central College,Naperville,IL,60540,6,NCAA Division III with football,1194,1431,2625,2,"Private nonprofit, 4-year or above",2,22,18,309233,195186,504419,280510,181397,461907,Basketball
56542,2018,147660,North Central College,Naperville,IL,60540,6,NCAA Division III with football,1196,1393,2589,2,"Private nonprofit, 4-year or above",2,24,18,318817,170388,489205,282220,158801,441021,Basketball
84955,2019,147660,North Central College,Naperville,IL,60540,6,NCAA Division III with football,1176,1354,2530,2,"Private nonprofit, 4-year or above",2,25,19,279280,204373,483653,257842,178551,436393,Basketball
7703,2015,174437,North Central University,Minneapolis,MN,554041391,7,NCAA Division III without football,418,551,969,2,"Private nonprofit, 4-year or above",2,20,11,70680,49572,120252,70679,49572,120251,Basketball
25117,2016,174437,North Central University,Minneapolis,MN,55404,7,NCAA Division III without football,367,502,869,2,"Private nonprofit, 4-year or above",2,16,12,41893,42334,84227,41893,42334,84227,Basketball
42613,2017,174437,North Central University,Minneapolis,MN,55404,7,NCAA Division III without football,383,487,870,2,"Private nonprofit, 4-year or above",2,18,14,64190,56106,120296,64190,56106,120296,Basketball
60320,2018,174437,North Central University,Minneapolis,MN,55404,7,NCAA Division III without football,408,490,898,2,"Private nonprofit, 4-year or above",2,18,17,54302,70048,124350,54302,70048,124350,Basketball
97067,2019,174437,North Central University,Minneapolis,MN,55404,7,NCAA Division III without football,397,525,922,2,"Private nonprofit, 4-year or above",2,14,15,88334,76812,165146,88334,76812,165146,Basketball
11367,2015,200332,North Dakota State University-Main Campus,Fargo,ND,581086050,2,NCAA Division I-FCS,5950,4699,10649,1,"Public, 4-year or above",2,15,11,1417450,1178137,2595587,1417450,1178137,2595587,Basketball
28805,2016,200332,North Dakota State University-Main Campus,Fargo,ND,58108,2,NCAA Division I-FCS,5942,4689,10631,1,"Public, 4-year or above",2,16,13,1541048,1356305,2897353,1541048,1356305,2897353,Basketball
46307,2017,200332,North Dakota State University-Main Campus,Fargo,ND,58108,2,NCAA Division I-FCS,5941,4796,10737,1,"Public, 4-year or above",2,14,14,1611189,1389623,3000812,1611189,1389623,3000812,Basketball
64027,2018,200332,North Dakota State University-Main Campus,Fargo,ND,58108,2,NCAA Division I-FCS,5735,4463,10198,1,"Public, 4-year or above",2,14,14,1720634,1439776,3160410,1720634,1439776,3160410,Basketball
109879,2019,200332,North Dakota State University-Main Campus,Fargo,ND,58108,2,NCAA Division I-FCS,5284,4314,9598,1,"Public, 4-year or above",2,15,16,1757396,1580034,3337430,1757396,1580034,3337430,Basketball
14066,2015,218441,North Greenville University,Tigerville,SC,296881892,4,NCAA Division II with football,1091,970,2061,2,"Private nonprofit, 4-year or above",2,27,16,409527,381407,790934,378709,373948,752657,Basketball
31523,2016,218441,North Greenville University,Tigerville,SC,29688,4,NCAA Division II with football,1001,924,1925,2,"Private nonprofit, 4-year or above",2,28,16,441202,424826,866028,437193,386277,823470,Basketball
49035,2017,218441,North Greenville University,Tigerville,SC,29688,4,NCAA Division II with football,1046,1033,2079,2,"Private nonprofit, 4-year or above",2,15,17,475668,439311,914979,423874,392290,816164,Basketball
66797,2018,218441,North Greenville University,Tigerville,SC,29688,4,NCAA Division II with football,951,975,1926,2,"Private nonprofit, 4-year or above",2,27,16,548892,351043,899935,400132,331898,732030,Basketball
118975,2019,218441,North Greenville University,Tigerville,SC,29688,4,NCAA Division II with football,839,919,1758,2,"Private nonprofit, 4-year or above",2,18,14,418679,427009,845688,388270,359928,748198,Basketball
4053,2015,147679,North Park University,Chicago,IL,606254895,6,NCAA Division III with football,699,1168,1867,2,"Private nonprofit, 4-year or above",2,26,21,217308,186132,403440,217308,186132,403440,Basketball
21430,2016,147679,North Park University,Chicago,IL,60625,6,NCAA Division III with football,710,1174,1884,2,"Private nonprofit, 4-year or above",2,25,15,211211,193837,405048,211211,193837,405048,Basketball
38897,2017,147679,North Park University,Chicago,IL,60625,6,NCAA Division III with football,681,1131,1812,2,"Private nonprofit, 4-year or above",2,28,17,212655,195383,408038,212655,195383,408038,Basketball
56558,2018,147679,North Park University,Chicago,IL,60625,6,NCAA Division III with football,691,1090,1781,2,"Private nonprofit, 4-year or above",2,22,15,223193,189986,413179,223193,189986,413179,Basketball
84971,2019,147679,North Park University,Chicago,IL,60625,6,NCAA Division III with football,669,1054,1723,2,"Private nonprofit, 4-year or above",2,29,19,192255,213007,405262,192255,213007,405262,Basketball
12112,2015,207263,Northeastern State University,Tahlequah,OK,744642399,4,NCAA Division II with football,2015,2949,4964,1,"Public, 4-year or above",2,16,13,339743,346865,686608,339743,346865,686608,Basketball
29551,2016,207263,Northeastern State University,Tahlequah,OK,74464,4,NCAA Division II with football,2024,2819,4843,1,"Public, 4-year or above",2,21,11,358661,343336,701997,358661,343336,701997,Basketball
47057,2017,207263,Northeastern State University,Tahlequah,OK,74464,4,NCAA Division II with football,1979,2768,4747,1,"Public, 4-year or above",2,19,13,533145,410675,943820,533145,410675,943820,Basketball
64798,2018,207263,Northeastern State University,Tahlequah,OK,74464,4,NCAA Division II with football,1907,2723,4630,1,"Public, 4-year or above",2,16,13,559018,450143,1009161,559018,450143,1009161,Basketball
112526,2019,207263,Northeastern State University,Tahlequah,OK,74464,4,NCAA Division II with football,1724,2610,4334,1,"Public, 4-year or above",2,16,16,524735,414238,938973,524735,414238,938973,Basketball
6763,2015,167358,Northeastern University,Boston,MA,21155005,3,NCAA Division I without football,6763,6857,13620,2,"Private nonprofit, 4-year or above",2,13,14,2913795,1901868,4815663,2913795,1901868,4815663,Basketball
24151,2016,167358,Northeastern University,Boston,MA,2115,3,NCAA Division I without football,6592,6753,13345,2,"Private nonprofit, 4-year or above",2,11,13,2740955,2020455,4761410,2740955,2020455,4761410,Basketball
41651,2017,167358,Northeastern University,Boston,MA,2115,3,NCAA Division I without football,6654,7012,13666,2,"Private nonprofit, 4-year or above",2,13,15,3241890,1985465,5227355,3241890,1985465,5227355,Basketball
59341,2018,167358,Northeastern University,Boston,MA,2115,3,NCAA Division I without football,6687,7073,13760,2,"Private nonprofit, 4-year or above",2,12,14,3207255,2153155,5360410,3207255,2153155,5360410,Basketball
94066,2019,167358,Northeastern University,Boston,MA,2115,3,NCAA Division I without football,6812,7222,14034,2,"Private nonprofit, 4-year or above",2,13,15,3268339,2236288,5504627,3268339,2236288,5504627,Basketball
408,2015,105330,Northern Arizona University,Flagstaff,AZ,860114092,2,NCAA Division I-FCS,8485,11872,20357,1,"Public, 4-year or above",2,18,13,1611995,1210358,2822353,1611995,1210358,2822353,Basketball
17752,2016,105330,Northern Arizona University,Flagstaff,AZ,86011,2,NCAA Division I-FCS,8891,12599,21490,1,"Public, 4-year or above",2,20,15,1686631,1472663,3159294,1686631,1472663,3159294,Basketball
35168,2017,105330,Northern Arizona University,Flagstaff,AZ,86011,2,NCAA Division I-FCS,8935,13055,21990,1,"Public, 4-year or above",2,17,17,1670866,1360102,3030968,1670866,1360102,3030968,Basketball
52795,2018,105330,Northern Arizona University,Flagstaff,AZ,86011,2,NCAA Division I-FCS,8498,13387,21885,1,"Public, 4-year or above",2,16,15,1805164,1447056,3252220,1805164,1447056,3252220,Basketball
72010,2019,105330,Northern Arizona University,Flagstaff,AZ,86011,2,NCAA Division I-FCS,8283,13447,21730,1,"Public, 4-year or above",2,16,16,1551799,1486311,3038110,1551799,1486311,3038110,Basketball
4063,2015,147703,Northern Illinois University,Dekalb,IL,601152828,1,NCAA Division I-FBS,6689,6473,13162,1,"Public, 4-year or above",2,16,23,1880733,1323787,3204520,1880733,1323787,3204520,Basketball
21440,2016,147703,Northern Illinois University,Dekalb,IL,60115,1,NCAA Division I-FBS,6188,6135,12323,1,"Public, 4-year or above",2,16,19,2004332,1479356,3483688,2004332,1479356,3483688,Basketball
38907,2017,147703,Northern Illinois University,Dekalb,IL,60115,1,NCAA Division I-FBS,5835,5951,11786,1,"Public, 4-year or above",2,16,15,1903995,1427275,3331270,1903995,1427275,3331270,Basketball
56568,2018,147703,Northern Illinois University,Dekalb,IL,60115,1,NCAA Division I-FBS,5511,5673,11184,1,"Public, 4-year or above",2,16,13,1775696,1392495,3168191,1775696,1392495,3168191,Basketball
85009,2019,147703,Northern Illinois University,Dekalb,IL,60115,1,NCAA Division I-FBS,5071,5494,10565,1,"Public, 4-year or above",2,15,16,1703100,1385230,3088330,1703100,1385230,3088330,Basketball
5642,2015,157447,Northern Kentucky University,Highland Heights,KY,41099,3,NCAA Division I without football,4188,5029,9217,1,"Public, 4-year or above",2,15,19,1623294,1338757,2962051,1623294,1338757,2962051,Basketball
23022,2016,157447,Northern Kentucky University,Highland Heights,KY,41099,3,NCAA Division I without football,4037,5082,9119,1,"Public, 4-year or above",2,16,18,1829151,1291466,3120617,1829151,1291466,3120617,Basketball
40518,2017,157447,Northern Kentucky University,Highland Heights,KY,41099,3,NCAA Division I without football,3927,4965,8892,1,"Public, 4-year or above",2,14,27,1965242,1418161,3383403,1965242,1418161,3383403,Basketball
58200,2018,157447,Northern Kentucky University,Highland Heights,KY,41099,3,NCAA Division I without football,3604,4871,8475,1,"Public, 4-year or above",2,15,24,2470374,1328541,3798915,2470374,1328541,3798915,Basketball
90319,2019,157447,Northern Kentucky University,Highland Heights,KY,41099,3,NCAA Division I without football,3447,4715,8162,1,"Public, 4-year or above",2,15,19,2536043,1338630,3874673,2536043,1338630,3874673,Basketball
7339,2015,171456,Northern Michigan University,Marquette,MI,49855,4,NCAA Division II with football,2975,3626,6601,1,"Public, 4-year or above",2,16,14,595558,592517,1188075,595558,592517,1188075,Basketball
24746,2016,171456,Northern Michigan University,Marquette,MI,49855,4,NCAA Division II with football,2874,3380,6254,1,"Public, 4-year or above",2,15,16,610956,607277,1218233,605355,594289,1199644,Basketball
42244,2017,171456,Northern Michigan University,Marquette,MI,49855,4,NCAA Division II with football,2837,3349,6186,1,"Public, 4-year or above",2,17,17,698037,639802,1337839,688386,619422,1307808,Basketball
59949,2018,171456,Northern Michigan University,Marquette,MI,49855,4,NCAA Division II with football,2778,3391,6169,1,"Public, 4-year or above",2,16,17,703878,708466,1412344,691735,687557,1379292,Basketball
95935,2019,171456,Northern Michigan University,Marquette,MI,49855,4,NCAA Division II with football,2761,3419,6180,1,"Public, 4-year or above",2,16,17,736278,669352,1405630,727564,701547,1429111,Basketball
14219,2015,219259,Northern State University,Aberdeen,SD,574017198,4,NCAA Division II with football,573,692,1265,1,"Public, 4-year or above",2,15,19,746848,475830,1222678,598905,449389,1048294,Basketball
31679,2016,219259,Northern State University,Aberdeen,SD,57401,4,NCAA Division II with football,588,730,1318,1,"Public, 4-year or above",2,17,21,711060,584469,1295529,670283,491595,1161878,Basketball
49196,2017,219259,Northern State University,Aberdeen,SD,57401,4,NCAA Division II with football,564,686,1250,1,"Public, 4-year or above",2,16,20,720897,620000,1340897,680869,571436,1252305,Basketball
66962,2018,219259,Northern State University,Aberdeen,SD,57401,4,NCAA Division II with football,558,688,1246,1,"Public, 4-year or above",2,15,20,775282,687318,1462600,668479,555598,1224077,Basketball
119659,2019,219259,Northern State University,Aberdeen,SD,57401,4,NCAA Division II with football,521,654,1175,1,"Public, 4-year or above",2,15,17,492123,427336,919459,596007,539836,1135843,Basketball
124990,2019,230913,Northern Vermont University,Johnson,VT,5656,7,NCAA Division III without football,641,797,1438,1,"Public, 4-year or above",2,31,22,141820,142602,284422,141820,139785,281605,Basketball
16567,2015,239512,Northland College,Ashland,WI,548063999,7,NCAA Division III without football,264,249,513,2,"Private nonprofit, 4-year or above",2,15,14,109072,103991,213063,109072,103991,213063,Basketball
34043,2016,239512,Northland College,Ashland,WI,54806,7,NCAA Division III without football,270,287,557,2,"Private nonprofit, 4-year or above",2,19,14,120704,125440,246144,120704,125440,246144,Basketball
51599,2017,239512,Northland College,Ashland,WI,54806,7,NCAA Division III without football,277,317,594,2,"Private nonprofit, 4-year or above",2,15,14,153789,121069,274858,153789,121069,274858,Basketball
69345,2018,239512,Northland College,Ashland,WI,54806,7,NCAA Division III without football,258,299,557,2,"Private nonprofit, 4-year or above",2,15,13,145762,140269,286031,145762,140269,286031,Basketball
128989,2019,239512,Northland College,Ashland,WI,54806,7,NCAA Division III without football,274,302,576,2,"Private nonprofit, 4-year or above",2,22,16,141330,148030,289360,141330,148030,289360,Basketball
8322,2015,178624,Northwest Missouri State University,Maryville,MO,644686001,4,NCAA Division II with football,2106,2832,4938,1,"Public, 4-year or above",2,12,15,884060,733546,1617606,884060,733546,1617606,Basketball
25753,2016,178624,Northwest Missouri State University,Maryville,MO,64468,4,NCAA Division II with football,2074,2807,4881,1,"Public, 4-year or above",2,14,11,1273300,922110,2195410,1273300,922110,2195410,Basketball
43243,2017,178624,Northwest Missouri State University,Maryville,MO,64468,4,NCAA Division II with football,2014,2754,4768,1,"Public, 4-year or above",2,15,14,854370,609330,1463700,854370,609330,1463700,Basketball
60962,2018,178624,Northwest Missouri State University,Maryville,MO,64468,4,NCAA Division II with football,2100,2799,4899,1,"Public, 4-year or above",2,13,14,867129,639527,1506656,867129,639527,1506656,Basketball
99509,2019,178624,Northwest Missouri State University,Maryville,MO,64468,4,NCAA Division II with football,2094,2832,4926,1,"Public, 4-year or above",2,12,17,914217,692438,1606655,914217,692438,1606655,Basketball
3577,2015,142461,Northwest Nazarene University,Nampa,ID,836865897,5,NCAA Division II without football,458,707,1165,2,"Private nonprofit, 4-year or above",2,15,15,678344,618547,1296891,678344,618547,1296891,Basketball
20947,2016,142461,Northwest Nazarene University,Nampa,ID,83686,5,NCAA Division II without football,454,669,1123,2,"Private nonprofit, 4-year or above",2,15,14,610662,612432,1223094,610662,612432,1223094,Basketball
38403,2017,142461,Northwest Nazarene University,Nampa,ID,83686,5,NCAA Division II without football,453,670,1123,2,"Private nonprofit, 4-year or above",2,15,14,650194,619674,1269868,650194,619674,1269868,Basketball
56056,2018,142461,Northwest Nazarene University,Nampa,ID,83686,5,NCAA Division II without football,466,621,1087,2,"Private nonprofit, 4-year or above",2,16,14,701720,609760,1311480,701720,609760,1311480,Basketball
83105,2019,142461,Northwest Nazarene University,Nampa,ID,83686,5,NCAA Division II without football,447,614,1061,2,"Private nonprofit, 4-year or above",2,16,13,717031,613071,1330102,717031,613071,1330102,Basketball
12132,2015,207306,Northwestern Oklahoma State University,Alva,OK,737172799,4,NCAA Division II with football,649,739,1388,1,"Public, 4-year or above",2,25,17,349358,307520,656878,338955,298453,637408,Basketball
29571,2016,207306,Northwestern Oklahoma State University,Alva,OK,73717,4,NCAA Division II with football,627,796,1423,1,"Public, 4-year or above",2,17,19,331601,290751,622352,330613,286703,617316,Basketball
47077,2017,207306,Northwestern Oklahoma State University,Alva,OK,73717,4,NCAA Division II with football,573,755,1328,1,"Public, 4-year or above",2,24,18,343205,300494,643699,340205,298694,638899,Basketball
64818,2018,207306,Northwestern Oklahoma State University,Alva,OK,73717,4,NCAA Division II with football,609,821,1430,1,"Public, 4-year or above",2,22,18,349123,409327,758450,331800,365642,697442,Basketball
112577,2019,207306,Northwestern Oklahoma State University,Alva,OK,73717,4,NCAA Division II with football,566,809,1375,1,"Public, 4-year or above",2,20,17,356539,324921,681460,346214,321102,667316,Basketball
5834,2015,160038,Northwestern State University of Louisiana,Natchitoches,LA,714970002,2,NCAA Division I-FCS,1738,3278,5016,1,"Public, 4-year or above",2,23,14,1023827,863250,1887077,1023827,863250,1887077,Basketball
23218,2016,160038,Northwestern State University of Louisiana,Natchitoches,LA,71497,2,NCAA Division I-FCS,1736,3446,5182,1,"Public, 4-year or above",2,26,16,1166539,899933,2066472,1166539,899933,2066472,Basketball
40716,2017,160038,Northwestern State University of Louisiana,Natchitoches,LA,71497,2,NCAA Division I-FCS,1798,3598,5396,1,"Public, 4-year or above",2,30,15,1171687,929495,2101182,1171687,929495,2101182,Basketball
58400,2018,160038,Northwestern State University of Louisiana,Natchitoches,LA,71497,2,NCAA Division I-FCS,1933,4249,6182,1,"Public, 4-year or above",2,26,14,1132840,944780,2077620,1132840,944780,2077620,Basketball
91054,2019,160038,Northwestern State University of Louisiana,Natchitoches,LA,71497,2,NCAA Division I-FCS,1844,4352,6196,1,"Public, 4-year or above",2,25,16,1043963,993274,2037237,1043963,993273,2037236,Basketball
4074,2015,147767,Northwestern University,Evanston,IL,60208,1,NCAA Division I-FBS,4124,4092,8216,2,"Private nonprofit, 4-year or above",2,14,18,14140342,201528,14341870,6771619,3588279,10359898,Basketball
21451,2016,147767,Northwestern University,Evanston,IL,60208,1,NCAA Division I-FBS,4123,4126,8249,2,"Private nonprofit, 4-year or above",2,14,18,14581162,74209,14655371,8549357,3982353,12531710,Basketball
38918,2017,147767,Northwestern University,Evanston,IL,60208,1,NCAA Division I-FBS,4047,4120,8167,2,"Private nonprofit, 4-year or above",2,14,13,19562252,72195,19634447,9049494,3720380,12769874,Basketball
56579,2018,147767,Northwestern University,Evanston,IL,60208,1,NCAA Division I-FBS,3999,4131,8130,2,"Private nonprofit, 4-year or above",2,14,14,12669660,227757,12897417,10646711,4059092,14705803,Basketball
85047,2019,147767,Northwestern University,Evanston,IL,60208,1,NCAA Division I-FBS,4028,4216,8244,2,"Private nonprofit, 4-year or above",2,15,15,9116097,224755,9340852,9688631,4680384,14369015,Basketball
24759,2016,171492,Northwood University,Midland,MI,48640,4,NCAA Division II with football,1160,787,1947,2,"Private nonprofit, 4-year or above",2,23,26,789397,776460,1565857,789397,776460,1565857,Basketball
42257,2017,171492,Northwood University,Midland,MI,48640,4,NCAA Division II with football,1055,719,1774,2,"Private nonprofit, 4-year or above",2,18,15,802270,781833,1584103,802270,781833,1584103,Basketball
59962,2018,171492,Northwood University,Midland,MI,48640,4,NCAA Division II with football,1013,669,1682,2,"Private nonprofit, 4-year or above",2,16,16,810602,853641,1664243,810602,853641,1664243,Basketball
95948,2019,171492,Northwood University,Midland,MI,48640,4,NCAA Division II with football,945,592,1537,2,"Private nonprofit, 4-year or above",2,18,16,791034,794594,1585628,791034,794594,1585628,Basketball
7351,2015,171492,Northwood University-Michigan,Midland,MI,486402398,4,NCAA Division II with football,1094,734,1828,2,"Private nonprofit, 4-year or above",2,37,27,788930,765351,1554281,788930,765351,1554281,Basketball
15516,2015,230995,Norwich University,Northfield,VT,56631035,6,NCAA Division III with football,1698,565,2263,2,"Private nonprofit, 4-year or above",2,17,14,168670,142677,311347,168670,142677,311347,Basketball
32984,2016,230995,Norwich University,Northfield,VT,5663,6,NCAA Division III with football,1839,606,2445,2,"Private nonprofit, 4-year or above",2,18,17,167007,140981,307988,167007,140981,307988,Basketball
50516,2017,230995,Norwich University,Northfield,VT,5663,6,NCAA Division III with football,1839,673,2512,2,"Private nonprofit, 4-year or above",2,16,18,185014,141661,326675,185014,141661,326675,Basketball
68277,2018,230995,Norwich University,Northfield,VT,5663,6,NCAA Division III with football,1855,695,2550,2,"Private nonprofit, 4-year or above",2,19,17,203944,165669,369613,203944,165669,369613,Basketball
125066,2019,230995,Norwich University,Northfield,VT,5663,6,NCAA Division III with football,1883,719,2602,2,"Private nonprofit, 4-year or above",2,16,17,208451,170188,378639,208451,170188,378639,Basketball
11755,2015,204468,Notre Dame College,Cleveland,OH,441214293,4,NCAA Division II with football,726,640,1366,2,"Private nonprofit, 4-year or above",2,13,14,519213,402596,921809,519213,402596,921809,Basketball
29198,2016,204468,Notre Dame College,Cleveland,OH,44121,4,NCAA Division II with football,672,575,1247,2,"Private nonprofit, 4-year or above",2,13,20,471225,354288,825513,471225,354288,825513,Basketball
46700,2017,204468,Notre Dame College,Cleveland,OH,44121,4,NCAA Division II with football,650,559,1209,2,"Private nonprofit, 4-year or above",2,30,24,483357,410506,893863,483357,410506,893863,Basketball
64435,2018,204468,Notre Dame College,Cleveland,OH,44121,4,NCAA Division II with football,609,542,1151,2,"Private nonprofit, 4-year or above",2,40,19,501378,356416,857794,501378,356416,857794,Basketball
111288,2019,204468,Notre Dame College,Cleveland,OH,44121,4,NCAA Division II with football,579,538,1117,2,"Private nonprofit, 4-year or above",2,33,24,413687,350852,764539,413687,350852,764539,Basketball
1573,2015,120184,Notre Dame de Namur University,Belmont,CA,940021908,5,NCAA Division II without football,266,522,788,2,"Private nonprofit, 4-year or above",2,16,18,270867,238534,509401,270867,238534,509401,Basketball
18934,2016,120184,Notre Dame de Namur University,Belmont,CA,94002,5,NCAA Division II without football,255,485,740,2,"Private nonprofit, 4-year or above",2,13,14,262526,245542,508068,262526,245542,508068,Basketball
36367,2017,120184,Notre Dame de Namur University,Belmont,CA,94002,5,NCAA Division II without football,244,474,718,2,"Private nonprofit, 4-year or above",2,15,16,338401,282501,620902,338401,282501,620902,Basketball
53996,2018,120184,Notre Dame de Namur University,Belmont,CA,94002,5,NCAA Division II without football,239,430,669,2,"Private nonprofit, 4-year or above",2,16,14,429813,265568,695381,429813,265568,695381,Basketball
76141,2019,120184,Notre Dame de Namur University,Belmont,CA,94002,5,NCAA Division II without football,224,366,590,2,"Private nonprofit, 4-year or above",2,15,15,431101,388491,819592,431101,388491,819592,Basketball
6236,2015,163578,Notre Dame of Maryland University,Baltimore,MD,212102476,7,NCAA Division III without football,0,516,516,2,"Private nonprofit, 4-year or above",2,0,12,NA,28646,28646,NA,28646,28646,Basketball
23618,2016,163578,Notre Dame of Maryland University,Baltimore,MD,21210,7,NCAA Division III without football,2,513,515,2,"Private nonprofit, 4-year or above",2,0,9,NA,28965,28965,NA,28965,28965,Basketball
41122,2017,163578,Notre Dame of Maryland University,Baltimore,MD,21210,7,NCAA Division III without football,9,519,528,2,"Private nonprofit, 4-year or above",2,0,14,NA,30834,30834,NA,30834,30834,Basketball
58817,2018,163578,Notre Dame of Maryland University,Baltimore,MD,21210,7,NCAA Division III without football,9,585,594,2,"Private nonprofit, 4-year or above",2,0,15,NA,33975,33975,NA,33975,33975,Basketball
92567,2019,163578,Notre Dame of Maryland University,Baltimore,MD,21210,7,NCAA Division III without football,8,525,533,2,"Private nonprofit, 4-year or above",2,0,10,NA,34274,34274,NA,34274,34274,Basketball
2950,2015,136215,Nova Southeastern University,Fort Lauderdale,FL,333147796,5,NCAA Division II without football,1062,2132,3194,2,"Private nonprofit, 4-year or above",2,15,16,615247,674280,1289527,615247,674280,1289527,Basketball
20324,2016,136215,Nova Southeastern University,Fort Lauderdale,FL,33314,5,NCAA Division II without football,1019,2032,3051,2,"Private nonprofit, 4-year or above",2,14,14,636509,617659,1254168,636509,617659,1254168,Basketball
37773,2017,136215,Nova Southeastern University,Fort Lauderdale,FL,33314,5,NCAA Division II without football,1053,2098,3151,2,"Private nonprofit, 4-year or above",2,14,15,732852,736266,1469118,732852,736266,1469118,Basketball
55423,2018,136215,Nova Southeastern University,Fort Lauderdale,FL,33314,5,NCAA Division II without football,1189,2494,3683,2,"Private nonprofit, 4-year or above",2,15,17,792518,780809,1573327,792518,780809,1573327,Basketball
80794,2019,136215,Nova Southeastern University,Fort Lauderdale,FL,33314,5,NCAA Division II without football,1400,3216,4616,2,"Private nonprofit, 4-year or above",2,16,13,786532,751384,1537916,786532,751384,1537916,Basketball
10124,2015,194161,Nyack College,Nyack,NY,109603698,5,NCAA Division II without football,521,779,1300,2,"Private nonprofit, 4-year or above",2,13,12,454595,373944,828539,454595,373944,828539,Basketball
27544,2016,194161,Nyack College,Nyack,NY,10960,5,NCAA Division II without football,445,733,1178,2,"Private nonprofit, 4-year or above",2,14,14,490582,376252,866834,490582,376252,866834,Basketball
45033,2017,194161,Nyack College,Nyack,NY,10960,5,NCAA Division II without football,476,655,1131,2,"Private nonprofit, 4-year or above",2,16,14,459108,334512,793620,459108,334512,793620,Basketball
62740,2018,194161,Nyack College,Nyack,NY,10960,5,NCAA Division II without football,457,633,1090,2,"Private nonprofit, 4-year or above",2,16,16,378400,330700,709100,378400,330700,709100,Basketball
105685,2019,194161,Nyack College,New York,NY,10004,5,NCAA Division II without football,367,473,840,2,"Private nonprofit, 4-year or above",2,17,17,364518,335887,700405,364518,335887,700405,Basketball
4589,2015,152099,Oakland City University,Oakland City,IN,476601099,5,NCAA Division II without football,241,261,502,2,"Private nonprofit, 4-year or above",2,13,15,165886,160575,326461,144508,154961,299469,Basketball
21964,2016,152099,Oakland City University,Oakland City,IN,47660,5,NCAA Division II without football,205,245,450,2,"Private nonprofit, 4-year or above",2,13,13,173003,167615,340618,157393,167615,325008,Basketball
39443,2017,152099,Oakland City University,Oakland City,IN,47660,5,NCAA Division II without football,199,252,451,2,"Private nonprofit, 4-year or above",2,13,13,193513,174143,367656,177486,172839,350325,Basketball
57104,2018,152099,Oakland City University,Oakland City,IN,47660,5,NCAA Division II without football,226,249,475,2,"Private nonprofit, 4-year or above",2,13,11,216566,135075,351641,198016,112969,310985,Basketball
86949,2019,152099,Oakland City University,Oakland City,IN,47660,5,NCAA Division II without football,230,272,502,2,"Private nonprofit, 4-year or above",2,10,9,155218,136644,291862,130507,125175,255682,Basketball
7365,2015,171571,Oakland University,Rochester Hills,MI,483094401,3,NCAA Division I without football,5321,7515,12836,1,"Public, 4-year or above",2,12,15,2292638,1272839,3565477,2111833,1306536,3418369,Basketball
24773,2016,171571,Oakland University,Rochester,MI,483094451,3,NCAA Division I without football,5438,7479,12917,1,"Public, 4-year or above",2,16,15,2110672,1434181,3544853,2110672,1434181,3544853,Basketball
42271,2017,171571,Oakland University,Rochester,MI,483094451,3,NCAA Division I without football,5362,7150,12512,1,"Public, 4-year or above",2,16,14,2480203,1498512,3978715,2336615,1490117,3826732,Basketball
59976,2018,171571,Oakland University,Rochester,MI,483094451,3,NCAA Division I without football,5330,7280,12610,1,"Public, 4-year or above",2,14,15,2184404,1191636,3376040,1940265,1280547,3220812,Basketball
96024,2019,171571,Oakland University,Rochester,MI,483094451,3,NCAA Division I without football,5267,7151,12418,1,"Public, 4-year or above",2,15,15,2421540,1506266,3927806,2298347,1569072,3867419,Basketball
11776,2015,204501,Oberlin College,Oberlin,OH,44074,6,NCAA Division III with football,1284,1611,2895,2,"Private nonprofit, 4-year or above",2,16,14,223279,172887,396166,193470,172220,365690,Basketball
29221,2016,204501,Oberlin College,Oberlin,OH,44074,6,NCAA Division III with football,1243,1626,2869,2,"Private nonprofit, 4-year or above",2,16,19,189942,139827,329769,175131,138859,313990,Basketball
46722,2017,204501,Oberlin College,Oberlin,OH,44074,6,NCAA Division III with football,1183,1607,2790,2,"Private nonprofit, 4-year or above",2,15,16,182320,172936,355256,180820,165076,345896,Basketball
64456,2018,204501,Oberlin College,Oberlin,OH,44074,6,NCAA Division III with football,1178,1580,2758,2,"Private nonprofit, 4-year or above",2,17,13,148730,120191,268921,168002,135072,303074,Basketball
111364,2019,204501,Oberlin College,Oberlin,OH,44074,6,NCAA Division III with football,1170,1652,2822,2,"Private nonprofit, 4-year or above",2,19,13,136675,137675,274350,140729,114383,255112,Basketball
1582,2015,120254,Occidental College,Los Angeles,CA,900413392,6,NCAA Division III with football,857,1121,1978,2,"Private nonprofit, 4-year or above",2,13,13,201893,164987,366880,177334,156173,333507,Basketball
18942,2016,120254,Occidental College,Los Angeles,CA,90041,6,NCAA Division III with football,849,1094,1943,2,"Private nonprofit, 4-year or above",2,13,14,179240,179108,358348,163891,174499,338390,Basketball
36375,2017,120254,Occidental College,Los Angeles,CA,90041,6,NCAA Division III with football,834,1108,1942,2,"Private nonprofit, 4-year or above",2,15,15,154880,152852,307732,154880,152852,307732,Basketball
54004,2018,120254,Occidental College,Los Angeles,CA,90041,6,NCAA Division III with football,796,1097,1893,2,"Private nonprofit, 4-year or above",2,17,14,189412,161728,351140,178684,159490,338174,Basketball
76178,2019,120254,Occidental College,Los Angeles,CA,90041,6,NCAA Division III with football,840,1112,1952,2,"Private nonprofit, 4-year or above",2,17,11,239348,165855,405203,205643,159367,365010,Basketball
3376,2015,140696,Oglethorpe University,Atlanta,GA,303192797,7,NCAA Division III without football,433,622,1055,2,"Private nonprofit, 4-year or above",2,17,23,165666,164586,330252,165666,164586,330252,Basketball
20741,2016,140696,Oglethorpe University,Atlanta,GA,30319,7,NCAA Division III without football,482,630,1112,2,"Private nonprofit, 4-year or above",2,22,21,185646,142171,327817,185646,142171,327817,Basketball
38201,2017,140696,Oglethorpe University,Atlanta,GA,30319,7,NCAA Division III without football,470,689,1159,2,"Private nonprofit, 4-year or above",2,25,22,161579,164056,325635,161579,164056,325635,Basketball
55854,2018,140696,Oglethorpe University,Atlanta,GA,30319,7,NCAA Division III without football,506,688,1194,2,"Private nonprofit, 4-year or above",2,22,22,208905,173730,382635,208905,173730,382635,Basketball
82484,2019,140696,Oglethorpe University,Atlanta,GA,30319,7,NCAA Division III without football,537,770,1307,2,"Private nonprofit, 4-year or above",2,21,21,176451,216453,392904,176451,216453,392904,Basketball
11787,2015,204617,Ohio Dominican University,Columbus,OH,43219,4,NCAA Division II with football,533,580,1113,2,"Private nonprofit, 4-year or above",2,16,15,480003,529472,1009475,432102,478730,910832,Basketball
29232,2016,204617,Ohio Dominican University,Columbus,OH,43219,4,NCAA Division II with football,476,522,998,2,"Private nonprofit, 4-year or above",2,16,16,559888,584707,1144595,514839,520750,1035589,Basketball
46733,2017,204617,Ohio Dominican University,Columbus,OH,43219,4,NCAA Division II with football,441,479,920,2,"Private nonprofit, 4-year or above",2,16,16,591919,550862,1142781,553504,481692,1035196,Basketball
64468,2018,204617,Ohio Dominican University,Columbus,OH,43219,4,NCAA Division II with football,453,474,927,2,"Private nonprofit, 4-year or above",2,17,15,560220,524098,1084318,498816,491692,990508,Basketball
111402,2019,204617,Ohio Dominican University,Columbus,OH,43219,4,NCAA Division II with football,430,471,901,2,"Private nonprofit, 4-year or above",2,17,15,539237,479718,1018955,443695,418721,862416,Basketball
11795,2015,204635,Ohio Northern University,Ada,OH,458101599,6,NCAA Division III with football,1157,925,2082,2,"Private nonprofit, 4-year or above",2,32,19,280624,183486,464110,280624,183486,464110,Basketball
29240,2016,204635,Ohio Northern University,Ada,OH,45810,6,NCAA Division III with football,1144,903,2047,2,"Private nonprofit, 4-year or above",2,24,23,269587,256471,526058,269587,256471,526058,Basketball
46741,2017,204635,Ohio Northern University,Ada,OH,45810,6,NCAA Division III with football,1162,917,2079,2,"Private nonprofit, 4-year or above",2,30,20,252100,206273,458373,252100,206273,458373,Basketball
64476,2018,204635,Ohio Northern University,Ada,OH,45810,6,NCAA Division III with football,1162,943,2105,2,"Private nonprofit, 4-year or above",2,20,20,228760,268794,497554,228760,268794,497554,Basketball
111413,2019,204635,Ohio Northern University,Ada,OH,45810,6,NCAA Division III with football,1122,956,2078,2,"Private nonprofit, 4-year or above",2,19,16,225023,154268,379291,225023,154268,379291,Basketball
11809,2015,204796,Ohio State University-Main Campus,Columbus,OH,43210,1,NCAA Division I-FBS,21316,19582,40898,1,"Public, 4-year or above",2,13,37,19872727,1077796,20950523,9142079,5034790,14176869,Basketball
29254,2016,204796,Ohio State University-Main Campus,Columbus,OH,43210,1,NCAA Division I-FBS,21559,20107,41666,1,"Public, 4-year or above",2,13,26,18250063,974803,19224866,9293589,4648585,13942174,Basketball
46755,2017,204796,Ohio State University-Main Campus,Columbus,OH,43210,1,NCAA Division I-FBS,21626,20198,41824,1,"Public, 4-year or above",2,14,26,24056371,1363355,25419726,20653121,5501545,26154666,Basketball
64490,2018,204796,Ohio State University-Main Campus,Columbus,OH,43210,1,NCAA Division I-FBS,21881,20765,42646,1,"Public, 4-year or above",2,14,32,24953122,794802,25747924,10996364,4954594,15950958,Basketball
111450,2019,204796,Ohio State University-Main Campus,Columbus,OH,43210,1,NCAA Division I-FBS,21770,20816,42586,1,"Public, 4-year or above",2,15,32,22020260,790523,22810783,10549049,5128196,15677245,Basketball
11830,2015,204857,Ohio University-Main Campus,Athens,OH,457012979,1,NCAA Division I-FBS,8293,9062,17355,1,"Public, 4-year or above",2,15,16,2687743,1741771,4429514,3101150,1812785,4913935,Basketball
29275,2016,204857,Ohio University-Main Campus,Athens,OH,45701,1,NCAA Division I-FBS,8296,9498,17794,1,"Public, 4-year or above",2,17,16,2596895,1584857,4181752,2944019,1821075,4765094,Basketball
46776,2017,204857,Ohio University-Main Campus,Athens,OH,45701,1,NCAA Division I-FBS,8230,9380,17610,1,"Public, 4-year or above",2,16,13,2925475,1486797,4412272,2988633,1677893,4666526,Basketball
64511,2018,204857,Ohio University-Main Campus,Athens,OH,45701,1,NCAA Division I-FBS,7723,9245,16968,1,"Public, 4-year or above",2,16,15,3337404,1702432,5039836,3337404,1702432,5039836,Basketball
111488,2019,204857,Ohio University-Main Campus,Athens,OH,45701,1,NCAA Division I-FBS,7223,8915,16138,1,"Public, 4-year or above",2,13,15,2824782,1693273,4518055,2824782,1693273,4518055,Basketball
16332,2015,237640,Ohio Valley University,Vienna,WV,261058000,5,NCAA Division II without football,210,183,393,2,"Private nonprofit, 4-year or above",2,20,17,310971,253062,564033,310971,253062,564033,Basketball
33805,2016,237640,Ohio Valley University,Vienna,WV,26105,5,NCAA Division II without football,209,181,390,2,"Private nonprofit, 4-year or above",2,20,16,348356,277916,626272,348356,277916,626272,Basketball
51360,2017,237640,Ohio Valley University,Vienna,WV,26105,5,NCAA Division II without football,218,195,413,2,"Private nonprofit, 4-year or above",2,18,14,348041,361560,709601,348041,361560,709601,Basketball
69108,2018,237640,Ohio Valley University,Vienna,WV,26105,5,NCAA Division II without football,195,179,374,2,"Private nonprofit, 4-year or above",2,14,16,350890,311863,662753,381253,312385,693638,Basketball
128166,2019,237640,Ohio Valley University,Vienna,WV,26105,5,NCAA Division II without football,151,120,271,2,"Private nonprofit, 4-year or above",2,17,13,357802,296583,654385,347394,294459,641853,Basketball
11842,2015,204909,Ohio Wesleyan University,Delaware,OH,430152370,6,NCAA Division III with football,787,868,1655,2,"Private nonprofit, 4-year or above",2,20,9,125897,122248,248145,125897,109235,235132,Basketball
29287,2016,204909,Ohio Wesleyan University,Delaware,OH,43015,6,NCAA Division III with football,777,844,1621,2,"Private nonprofit, 4-year or above",2,20,15,188783,158922,347705,188783,158922,347705,Basketball
46788,2017,204909,Ohio Wesleyan University,Delaware,OH,43015,6,NCAA Division III with football,724,820,1544,2,"Private nonprofit, 4-year or above",2,19,19,207410,170406,377816,207410,170406,377816,Basketball
64523,2018,204909,Ohio Wesleyan University,Delaware,OH,43015,6,NCAA Division III with football,707,840,1547,2,"Private nonprofit, 4-year or above",2,20,17,214280,155651,369931,214280,155651,369931,Basketball
111526,2019,204909,Ohio Wesleyan University,Delaware,OH,43015,6,NCAA Division III with football,654,831,1485,2,"Private nonprofit, 4-year or above",2,18,14,180850,149652,330502,180850,149652,330502,Basketball
12168,2015,207403,Oklahoma Baptist University,Shawnee,OK,74804,4,NCAA Division II with football,705,1088,1793,2,"Private nonprofit, 4-year or above",2,16,15,497882,473014,970896,497882,473014,970896,Basketball
29607,2016,207403,Oklahoma Baptist University,Shawnee,OK,74804,4,NCAA Division II with football,721,1131,1852,2,"Private nonprofit, 4-year or above",2,17,16,499662,494040,993702,499662,494040,993702,Basketball
47112,2017,207403,Oklahoma Baptist University,Shawnee,OK,74804,4,NCAA Division II with football,731,1088,1819,2,"Private nonprofit, 4-year or above",2,16,16,526715,520279,1046994,526715,520279,1046994,Basketball
64857,2018,207403,Oklahoma Baptist University,Shawnee,OK,74804,4,NCAA Division II with football,712,1066,1778,2,"Private nonprofit, 4-year or above",2,16,16,581649,447460,1029109,581649,447460,1029109,Basketball
112729,2019,207403,Oklahoma Baptist University,Shawnee,OK,74804,4,NCAA Division II with football,662,1006,1668,2,"Private nonprofit, 4-year or above",2,16,15,545104,500269,1045373,545104,500269,1045373,Basketball
12141,2015,207324,Oklahoma Christian University,Edmond,OK,730131100,5,NCAA Division II without football,934,893,1827,2,"Private nonprofit, 4-year or above",2,16,17,595982,554649,1150631,541307,505374,1046681,Basketball
29580,2016,207324,Oklahoma Christian University,Edmond,OK,73013,5,NCAA Division II without football,896,882,1778,2,"Private nonprofit, 4-year or above",2,27,14,621146,534152,1155298,615973,469368,1085341,Basketball
47086,2017,207324,Oklahoma Christian University,Edmond,OK,73013,5,NCAA Division II without football,931,898,1829,2,"Private nonprofit, 4-year or above",2,30,16,704524,527055,1231579,636209,520875,1157084,Basketball
64828,2018,207324,Oklahoma Christian University,Edmond,OK,73013,5,NCAA Division II without football,862,877,1739,2,"Private nonprofit, 4-year or above",2,19,18,703287,508274,1211561,617135,509344,1126479,Basketball
112615,2019,207324,Oklahoma Christian University,Edmond,OK,73013,5,NCAA Division II without football,809,845,1654,2,"Private nonprofit, 4-year or above",2,13,14,679194,568190,1247384,575847,537427,1113274,Basketball
12149,2015,207351,Oklahoma Panhandle State University,Goodwell,OK,739390430,4,NCAA Division II with football,472,423,895,1,"Public, 4-year or above",2,15,15,338379,263865,602244,338468,265432,603900,Basketball
29588,2016,207351,Oklahoma Panhandle State University,Goodwell,OK,73939,4,NCAA Division II with football,474,411,885,1,"Public, 4-year or above",2,16,15,295969,288742,584711,334287,321252,655539,Basketball
12158,2015,207388,Oklahoma State University-Main Campus,Stillwater,OK,740781015,1,NCAA Division I-FBS,9362,8875,18237,1,"Public, 4-year or above",2,16,12,11001125,536030,11537155,7478661,2887815,10366476,Basketball
29597,2016,207388,Oklahoma State University-Main Campus,Stillwater,OK,74078,1,NCAA Division I-FBS,9286,9044,18330,1,"Public, 4-year or above",2,15,17,11720028,537336,12257364,6012456,3087144,9099600,Basketball
47102,2017,207388,Oklahoma State University-Main Campus,Stillwater,OK,74078,1,NCAA Division I-FBS,9227,8923,18150,1,"Public, 4-year or above",2,14,26,12438667,636779,13075446,6087462,3122784,9210246,Basketball
64847,2018,207388,Oklahoma State University-Main Campus,Stillwater,OK,74078,1,NCAA Division I-FBS,8939,8720,17659,1,"Public, 4-year or above",2,14,24,12659706,537099,13196805,6700510,3173869,9874379,Basketball
112691,2019,207388,Oklahoma State University-Main Campus,Stillwater,OK,74078,1,NCAA Division I-FBS,8707,8531,17238,1,"Public, 4-year or above",2,15,29,11184901,503498,11688399,7050752,3229800,10280552,Basketball
15776,2015,232982,Old Dominion University,Norfolk,VA,23529,1,NCAA Division I-FBS,7176,8143,15319,1,"Public, 4-year or above",2,16,20,3583117,2247328,5830445,3583117,2247328,5830445,Basketball
33250,2016,232982,Old Dominion University,Norfolk,VA,23529,1,NCAA Division I-FBS,7030,8143,15173,1,"Public, 4-year or above",2,15,22,3628513,2697171,6325684,3628513,2697171,6325684,Basketball
50793,2017,232982,Old Dominion University,Norfolk,VA,23529,1,NCAA Division I-FBS,6805,8216,15021,1,"Public, 4-year or above",2,16,21,3348329,2275576,5623905,3348329,2275576,5623905,Basketball
68538,2018,232982,Old Dominion University,Norfolk,VA,23529,1,NCAA Division I-FBS,6747,8234,14981,1,"Public, 4-year or above",2,14,21,3953002,2597298,6550300,3953002,2597298,6550300,Basketball
125843,2019,232982,Old Dominion University,Norfolk,VA,23529,1,NCAA Division I-FBS,6584,8096,14680,1,"Public, 4-year or above",2,15,20,3520745,2587440,6108185,3520745,2587440,6108185,Basketball
7375,2015,171599,Olivet College,Olivet,MI,49076,6,NCAA Division III with football,528,346,874,2,"Private nonprofit, 4-year or above",2,36,15,179106,146410,325516,179106,146410,325516,Basketball
24782,2016,171599,Olivet College,Olivet,MI,49076,6,NCAA Division III with football,566,382,948,2,"Private nonprofit, 4-year or above",2,28,21,194337,114358,308695,188488,120926,309414,Basketball
42280,2017,171599,Olivet College,Olivet,MI,49076,6,NCAA Division III with football,601,397,998,2,"Private nonprofit, 4-year or above",2,29,19,216438,152069,368507,216438,152069,368507,Basketball
59985,2018,171599,Olivet College,Olivet,MI,49076,6,NCAA Division III with football,537,396,933,2,"Private nonprofit, 4-year or above",2,30,18,324278,162768,487046,241915,159698,401613,Basketball
96062,2019,171599,Olivet College,Olivet,MI,49076,6,NCAA Division III with football,554,405,959,2,"Private nonprofit, 4-year or above",2,30,11,242771,122267,365038,200046,114912,314958,Basketball
12200,2015,207582,Oral Roberts University,Tulsa,OK,74171,3,NCAA Division I without football,1078,1432,2510,2,"Private nonprofit, 4-year or above",2,17,14,3129121,1531551,4660672,2741483,1479447,4220930,Basketball
29640,2016,207582,Oral Roberts University,Tulsa,OK,74171,3,NCAA Division I without football,1049,1552,2601,2,"Private nonprofit, 4-year or above",2,15,16,2620054,1656739,4276793,2357003,1609969,3966972,Basketball
47145,2017,207582,Oral Roberts University,Tulsa,OK,74171,3,NCAA Division I without football,1141,1719,2860,2,"Private nonprofit, 4-year or above",2,17,14,2767146,1570438,4337584,2126124,1493293,3619417,Basketball
64890,2018,207582,Oral Roberts University,Tulsa,OK,74171,3,NCAA Division I without football,1137,1710,2847,2,"Private nonprofit, 4-year or above",2,16,16,2300880,1546477,3847357,2085974,1518547,3604521,Basketball
112843,2019,207582,Oral Roberts University,Tulsa,OK,74171,3,NCAA Division I without football,1087,1622,2709,2,"Private nonprofit, 4-year or above",2,15,14,2387907,1458199,3846106,2074328,1313915,3388243,Basketball
12386,2015,209542,Oregon State University,Corvallis,OR,97331,1,NCAA Division I-FBS,9721,8359,18080,1,"Public, 4-year or above",2,16,25,5834462,3387338,9221800,5498174,3387338,8885512,Basketball
29833,2016,209542,Oregon State University,Corvallis,OR,97331,1,NCAA Division I-FBS,9951,8444,18395,1,"Public, 4-year or above",2,15,21,6321026,3519817,9840843,6321026,3519817,9840843,Basketball
47327,2017,209542,Oregon State University,Corvallis,OR,97331,1,NCAA Division I-FBS,9948,8446,18394,1,"Public, 4-year or above",2,16,30,6950454,3799664,10750118,5407239,3799664,9206903,Basketball
65073,2018,209542,Oregon State University,Corvallis,OR,97331,1,NCAA Division I-FBS,9795,8395,18190,1,"Public, 4-year or above",2,15,24,6326806,4736990,11063796,6203088,4736990,10940078,Basketball
113669,2019,209542,Oregon State University,Corvallis,OR,97331,1,NCAA Division I-FBS,9742,8446,18188,1,"Public, 4-year or above",2,16,30,6613500,1237413,7850913,6401055,4637662,11038717,Basketball
11854,2015,204936,Otterbein University,Westerville,OH,43081,6,NCAA Division III with football,819,1277,2096,2,"Private nonprofit, 4-year or above",2,24,14,192506,206803,399309,192506,206803,399309,Basketball
29299,2016,204936,Otterbein University,Westerville,OH,43081,6,NCAA Division III with football,884,1363,2247,2,"Private nonprofit, 4-year or above",2,24,18,195619,219208,414827,195619,219208,414827,Basketball
46800,2017,204936,Otterbein University,Westerville,OH,43081,6,NCAA Division III with football,860,1393,2253,2,"Private nonprofit, 4-year or above",2,21,21,153239,182836,336075,153239,182836,336075,Basketball
64537,2018,204936,Otterbein University,Westerville,OH,43081,6,NCAA Division III with football,865,1383,2248,2,"Private nonprofit, 4-year or above",2,15,17,165780,180109,345889,136972,161979,298951,Basketball
111564,2019,204936,Otterbein University,Westerville,OH,43081,6,NCAA Division III with football,909,1398,2307,2,"Private nonprofit, 4-year or above",2,19,19,177451,171817,349268,161761,171438,333199,Basketball
588,2015,107512,Ouachita Baptist University,Arkadelphia,AR,719980001,4,NCAA Division II with football,688,757,1445,2,"Private nonprofit, 4-year or above",2,12,13,477951,454122,932073,476923,454122,931045,Basketball
17934,2016,107512,Ouachita Baptist University,Arkadelphia,AR,71998,4,NCAA Division II with football,679,782,1461,2,"Private nonprofit, 4-year or above",2,15,13,478941,426793,905734,477726,424042,901768,Basketball
35363,2017,107512,Ouachita Baptist University,Arkadelphia,AR,71998,4,NCAA Division II with football,671,825,1496,2,"Private nonprofit, 4-year or above",2,14,16,462680,462550,925230,460694,461075,921769,Basketball
52983,2018,107512,Ouachita Baptist University,Arkadelphia,AR,71998,4,NCAA Division II with football,684,842,1526,2,"Private nonprofit, 4-year or above",2,15,13,486054,410032,896086,488733,409205,897938,Basketball
72850,2019,107512,Ouachita Baptist University,Arkadelphia,AR,71998,4,NCAA Division II with football,637,867,1504,2,"Private nonprofit, 4-year or above",2,13,9,557040,381969,939009,560274,369176,929450,Basketball
105771,2019,194310,Pace University,New York,NY,10038,4,NCAA Division II with football,2878,4916,7794,2,"Private nonprofit, 4-year or above",2,17,16,641534,665203,1306737,625735,648128,1273863,Basketball
10149,2015,194310,Pace University-New York,New York,NY,100381598,4,NCAA Division II with football,2956,4574,7530,2,"Private nonprofit, 4-year or above",2,13,14,693419,778133,1471552,684742,777003,1461745,Basketball
27570,2016,194310,Pace University-New York,New York,NY,10038,4,NCAA Division II with football,2957,4697,7654,2,"Private nonprofit, 4-year or above",2,13,15,807755,795338,1603093,801979,773208,1575187,Basketball
45057,2017,194310,Pace University-New York,New York,NY,10038,4,NCAA Division II with football,2986,4849,7835,2,"Private nonprofit, 4-year or above",2,14,13,759106,708160,1467266,743416,708160,1451576,Basketball
62764,2018,194310,Pace University-New York,New York,NY,10038,4,NCAA Division II with football,2979,4914,7893,2,"Private nonprofit, 4-year or above",2,14,18,671445,698364,1369809,670990,681931,1352921,Basketball
16084,2015,236230,Pacific Lutheran University,Tacoma,WA,984470003,6,NCAA Division III with football,1034,1717,2751,2,"Private nonprofit, 4-year or above",2,17,16,177253,152480,329733,175120,143165,318285,Basketball
33558,2016,236230,Pacific Lutheran University,Tacoma,WA,98447,6,NCAA Division III with football,987,1703,2690,2,"Private nonprofit, 4-year or above",2,17,13,214230,191598,405828,202784,178031,380815,Basketball
51113,2017,236230,Pacific Lutheran University,Tacoma,WA,98447,6,NCAA Division III with football,963,1665,2628,2,"Private nonprofit, 4-year or above",2,20,17,234403,207681,442084,233939,193011,426950,Basketball
68860,2018,236230,Pacific Lutheran University,Tacoma,WA,98447,6,NCAA Division III with football,969,1738,2707,2,"Private nonprofit, 4-year or above",2,17,15,258866,215119,473985,216765,214031,430796,Basketball
127225,2019,236230,Pacific Lutheran University,Tacoma,WA,98447,6,NCAA Division III with football,951,1672,2623,2,"Private nonprofit, 4-year or above",2,17,12,206104,169108,375212,205911,167722,373633,Basketball
12410,2015,209612,Pacific University,Forest Grove,OR,97116,6,NCAA Division III with football,752,1112,1864,2,"Private nonprofit, 4-year or above",2,30,27,244179,225906,470085,244179,225906,470085,Basketball
29857,2016,209612,Pacific University,Forest Grove,OR,97116,6,NCAA Division III with football,755,1060,1815,2,"Private nonprofit, 4-year or above",2,33,29,250184,232994,483178,250184,232994,483178,Basketball
47351,2017,209612,Pacific University,Forest Grove,OR,97116,6,NCAA Division III with football,728,1050,1778,2,"Private nonprofit, 4-year or above",2,29,24,237550,202590,440140,237550,202590,440140,Basketball
65097,2018,209612,Pacific University,Forest Grove,OR,97116,6,NCAA Division III with football,683,1099,1782,2,"Private nonprofit, 4-year or above",2,26,14,270938,228306,499244,270938,228306,499244,Basketball
113745,2019,209612,Pacific University,Forest Grove,OR,97116,6,NCAA Division III with football,642,1082,1724,2,"Private nonprofit, 4-year or above",2,43,25,273090,224784,497874,273090,224784,497874,Basketball
3384,2015,140720,Paine College,Augusta,GA,309013182,5,NCAA Division II without football,206,301,507,2,"Private nonprofit, 4-year or above",2,12,14,244196,280281,524477,244196,280281,524477,Basketball
20749,2016,140720,Paine College,Augusta,GA,30901,5,NCAA Division II without football,180,209,389,2,"Private nonprofit, 4-year or above",2,10,12,215228,217061,432289,215228,217061,432289,Basketball
38209,2017,140720,Paine College,Augusta,GA,30901,5,NCAA Division II without football,158,170,328,2,"Private nonprofit, 4-year or above",2,12,11,224027,222143,446170,224027,222143,446170,Basketball
55862,2018,140720,Paine College,Augusta,GA,30901,5,NCAA Division II without football,187,242,429,2,"Private nonprofit, 4-year or above",2,14,13,220468,226262,446730,220468,226262,446730,Basketball
82522,2019,140720,Paine College,Augusta,GA,30901,5,NCAA Division II without football,178,217,395,2,"Private nonprofit, 4-year or above",2,14,13,206840,244117,450957,206840,244117,450957,Basketball
2963,2015,136330,Palm Beach Atlantic University,West Palm Beach,FL,33401,5,NCAA Division II without football,838,1580,2418,2,"Private nonprofit, 4-year or above",2,15,16,435899,417824,853723,404128,405193,809321,Basketball
20337,2016,136330,Palm Beach Atlantic University,West Palm Beach,FL,33401,5,NCAA Division II without football,775,1520,2295,2,"Private nonprofit, 4-year or above",2,16,16,527631,441804,969435,485574,402609,888183,Basketball
37786,2017,136330,Palm Beach Atlantic University,West Palm Beach,FL,33401,5,NCAA Division II without football,822,1524,2346,2,"Private nonprofit, 4-year or above",2,15,15,558277,475632,1033909,537836,457686,995522,Basketball
55436,2018,136330,Palm Beach Atlantic University,West Palm Beach,FL,33401,5,NCAA Division II without football,801,1461,2262,2,"Private nonprofit, 4-year or above",2,15,14,454790,391324,846114,449418,387552,836970,Basketball
80870,2019,136330,Palm Beach Atlantic University,West Palm Beach,FL,334164708,5,NCAA Division II without football,781,1483,2264,2,"Private nonprofit, 4-year or above",2,15,16,496754,459956,956710,472654,452726,925380,Basketball
17085,2015,366252,Pennsylvania College of Technology,Williamsport,PA,177015799,7,NCAA Division III without football,3188,1427,4615,1,"Public, 4-year or above",2,10,8,44416,32077,76493,44416,32077,76493,Basketball
34489,2016,366252,Pennsylvania College of Technology,Williamsport,PA,17701,7,NCAA Division III without football,3136,1446,4582,1,"Public, 4-year or above",2,18,12,100785,99673,200458,100785,99673,200458,Basketball
52092,2017,366252,Pennsylvania College of Technology,Williamsport,PA,17701,7,NCAA Division III without football,3124,1442,4566,1,"Public, 4-year or above",2,16,12,88570,103660,192230,88570,103660,192230,Basketball
69848,2018,366252,Pennsylvania College of Technology,Williamsport,PA,17701,7,NCAA Division III without football,2995,1379,4374,1,"Public, 4-year or above",2,17,15,127452,97167,224619,127452,97167,224619,Basketball
130509,2019,366252,Pennsylvania College of Technology,Williamsport,PA,17701,7,NCAA Division III without football,2836,1265,4101,1,"Public, 4-year or above",2,25,12,135852,112301,248153,135852,112301,248153,Basketball
13320,2015,214777,Pennsylvania State University-Main Campus,University Park,PA,168021503,1,NCAA Division I-FBS,20986,18308,39294,1,"Public, 4-year or above",2,14,28,11228157,1110674,12338831,5658177,4592081,10250258,Basketball
30779,2016,214777,Pennsylvania State University-Main Campus,University Park,PA,16802,1,NCAA Division I-FBS,21204,18679,39883,1,"Public, 4-year or above",2,14,28,11376448,1009123,12385571,5900115,4616726,10516841,Basketball
48286,2017,214777,Pennsylvania State University-Main Campus,University Park,PA,16802,1,NCAA Division I-FBS,21053,18630,39683,1,"Public, 4-year or above",2,14,28,10949652,847407,11797059,7180241,4864624,12044865,Basketball
66037,2018,214777,Pennsylvania State University-Main Campus,University Park,PA,16802,1,NCAA Division I-FBS,20781,18486,39267,1,"Public, 4-year or above",2,18,32,11344446,1063835,12408281,7343831,6159827,13503658,Basketball
116726,2019,214777,Pennsylvania State University-Main Campus,University Park,PA,16802,1,NCAA Division I-FBS,35954,30325,66279,1,"Public, 4-year or above",2,15,31,10527187,1141826,11669013,7458301,4608735,12067036,Basketball
13349,2015,214801,Pennsylvania State University-Penn State Abington,Abington,PA,190013918,7,NCAA Division III without football,1569,1497,3066,1,"Public, 4-year or above",2,15,8,74282,38210,112492,74282,38210,112492,Basketball
30809,2016,214801,Pennsylvania State University-Penn State Abington,Abington,PA,19001,7,NCAA Division III without football,1552,1486,3038,1,"Public, 4-year or above",2,15,9,71751,72567,144318,71751,72567,144318,Basketball
48316,2017,214801,Pennsylvania State University-Penn State Abington,Abington,PA,19001,7,NCAA Division III without football,1656,1596,3252,1,"Public, 4-year or above",2,15,10,97578,107871,205449,97578,107871,205449,Basketball
66068,2018,214801,Pennsylvania State University-Penn State Abington,Abington,PA,19001,7,NCAA Division III without football,1700,1574,3274,1,"Public, 4-year or above",2,12,15,129458,130830,260288,129458,130830,260288,Basketball
116817,2019,214801,Pennsylvania State University-Penn State Abington,Abington,PA,19001,7,NCAA Division III without football,1700,1574,3274,1,"Public, 4-year or above",2,15,14,119115,106419,225534,119115,106419,225534,Basketball
13261,2015,214689,Pennsylvania State University-Penn State Altoona,Altoona,PA,166013777,7,NCAA Division III without football,2048,1599,3647,1,"Public, 4-year or above",2,13,13,57282,27421,84703,57282,27421,84703,Basketball
30719,2016,214689,Pennsylvania State University-Penn State Altoona,Altoona,PA,16601,7,NCAA Division III without football,1818,1503,3321,1,"Public, 4-year or above",2,11,11,71200,29461,100661,71200,29461,100661,Basketball
48223,2017,214689,Pennsylvania State University-Penn State Altoona,Altoona,PA,16601,7,NCAA Division III without football,1849,1516,3365,1,"Public, 4-year or above",2,17,11,108892,29743,138635,108892,29743,138635,Basketball
65977,2018,214689,Pennsylvania State University-Penn State Altoona,Altoona,PA,16601,7,NCAA Division III without football,1713,1411,3124,1,"Public, 4-year or above",2,19,10,98457,44346,142803,98457,44346,142803,Basketball
116454,2019,214689,Pennsylvania State University-Penn State Altoona,Altoona,PA,16601,7,NCAA Division III without football,1713,1411,3124,1,"Public, 4-year or above",2,19,12,99700,54046,153746,99700,54046,153746,Basketball
13277,2015,214704,Pennsylvania State University-Penn State Berks,Reading,PA,196106009,7,NCAA Division III without football,1459,1112,2571,1,"Public, 4-year or above",2,14,9,43851,40474,84325,43851,40474,84325,Basketball
30733,2016,214704,Pennsylvania State University-Penn State Berks,Reading,PA,196106009,7,NCAA Division III without football,1454,1072,2526,1,"Public, 4-year or above",2,14,10,39772,34724,74496,39772,34724,74496,Basketball
48237,2017,214704,Pennsylvania State University-Penn State Berks,Reading,PA,196106009,7,NCAA Division III without football,1418,980,2398,1,"Public, 4-year or above",2,15,12,28537,35564,64101,28537,35564,64101,Basketball
65991,2018,214704,Pennsylvania State University-Penn State Berks,Reading,PA,196106009,7,NCAA Division III without football,1369,903,2272,1,"Public, 4-year or above",2,13,13,48269,44395,92664,48269,44395,92664,Basketball
116530,2019,214704,Pennsylvania State University-Penn State Berks,Reading,PA,196106009,7,NCAA Division III without football,1369,903,2272,1,"Public, 4-year or above",2,18,14,42708,46007,88715,42708,46007,88715,Basketball
13226,2015,214591,Pennsylvania State University-Penn State Erie-Behrend College,Erie,PA,165630001,7,NCAA Division III without football,2534,1386,3920,1,"Public, 4-year or above",2,13,13,95875,81840,177715,95875,81840,177715,Basketball
30683,2016,214591,Pennsylvania State University-Penn State Erie-Behrend College,Erie,PA,16563,7,NCAA Division III without football,2739,1408,4147,1,"Public, 4-year or above",2,13,13,116514,85190,201704,116514,85190,201704,Basketball
48187,2017,214591,Pennsylvania State University-Penn State Erie-Behrend College,Erie,PA,16563,7,NCAA Division III without football,2728,1383,4111,1,"Public, 4-year or above",2,18,11,132205,88089,220294,132205,88089,220294,Basketball
65940,2018,214591,Pennsylvania State University-Penn State Erie-Behrend College,Erie,PA,16563,7,NCAA Division III without football,2612,1345,3957,1,"Public, 4-year or above",2,25,14,148813,82349,231162,139270,108684,247954,Basketball
116263,2019,214591,Pennsylvania State University-Penn State Erie-Behrend College,Erie,PA,16563,7,NCAA Division III without football,2612,1345,3957,1,"Public, 4-year or above",2,20,12,132794,108874,241668,139404,107175,246579,Basketball
13285,2015,214713,Pennsylvania State University-Penn State Harrisburg,Middletown,PA,170574846,7,NCAA Division III without football,2099,1297,3396,1,"Public, 4-year or above",2,19,17,144737,104881,249618,141651,103986,245637,Basketball
30741,2016,214713,Pennsylvania State University-Penn State Harrisburg,Middletown,PA,17057,7,NCAA Division III without football,2304,1465,3769,1,"Public, 4-year or above",2,18,17,127417,109418,236835,127417,104792,232209,Basketball
48245,2017,214713,Pennsylvania State University-Penn State Harrisburg,Middletown,PA,17057,7,NCAA Division III without football,2417,1517,3934,1,"Public, 4-year or above",2,18,14,149116,110273,259389,149116,110273,259389,Basketball
65999,2018,214713,Pennsylvania State University-Penn State Harrisburg,Middletown,PA,17057,7,NCAA Division III without football,2385,1520,3905,1,"Public, 4-year or above",2,13,19,127676,85031,212707,119048,82732,201780,Basketball
116568,2019,214713,Pennsylvania State University-Penn State Harrisburg,Middletown,PA,17057,7,NCAA Division III without football,2385,1520,3905,1,"Public, 4-year or above",2,15,15,91169,64035,155204,97353,87326,184679,Basketball
1670,2015,121150,Pepperdine University,Malibu,CA,90263,3,NCAA Division I without football,1295,1924,3219,2,"Private nonprofit, 4-year or above",2,16,18,2561072,1912851,4473923,2561072,1912851,4473923,Basketball
19031,2016,121150,Pepperdine University,Malibu,CA,902634150,3,NCAA Division I without football,1305,1915,3220,2,"Private nonprofit, 4-year or above",2,17,15,2830636,1873651,4704287,2830636,1873651,4704287,Basketball
36466,2017,121150,Pepperdine University,Malibu,CA,90263,3,NCAA Division I without football,1325,1974,3299,2,"Private nonprofit, 4-year or above",2,17,14,3746526,2082189,5828715,3746526,2082189,5828715,Basketball
54095,2018,121150,Pepperdine University,Malibu,CA,90263,3,NCAA Division I without football,1323,2010,3333,2,"Private nonprofit, 4-year or above",2,17,17,3975688,2267778,6243466,3975688,2267778,6243466,Basketball
76456,2019,121150,Pepperdine University,Malibu,CA,90263,3,NCAA Division I without football,1368,1952,3320,2,"Private nonprofit, 4-year or above",2,18,15,4291529,2390233,6681762,4291529,2390233,6681762,Basketball
11166,2015,199306,Pfeiffer University,Misenheimer,NC,28109,5,NCAA Division II without football,354,460,814,2,"Private nonprofit, 4-year or above",2,32,17,418148,389433,807581,409254,389433,798687,Basketball
28607,2016,199306,Pfeiffer University,Misenheimer,NC,28109,5,NCAA Division II without football,348,391,739,2,"Private nonprofit, 4-year or above",2,40,16,425175,285226,710401,405334,366616,771950,Basketball
46103,2017,199306,Pfeiffer University,Misenheimer,NC,28109,7,NCAA Division III without football,359,374,733,2,"Private nonprofit, 4-year or above",2,31,15,186315,364846,551161,190713,260337,451050,Basketball
63824,2018,199306,Pfeiffer University,Misenheimer,NC,28109,7,NCAA Division III without football,361,484,845,2,"Private nonprofit, 4-year or above",2,31,20,158477,176445,334922,151593,118181,269774,Basketball
109025,2019,199306,Pfeiffer University,Misenheimer,NC,28109,7,NCAA Division III without football,351,486,837,2,"Private nonprofit, 4-year or above",2,39,22,114462,113396,227858,154317,113492,267809,Basketball
13388,2015,215099,Philadelphia University,Philadelphia,PA,191445497,5,NCAA Division II without football,814,1558,2372,2,"Private nonprofit, 4-year or above",2,11,15,383978,372872,756850,493875,466920,960795,Basketball
30847,2016,215099,Philadelphia University,Philadelphia,PA,19144,5,NCAA Division II without football,768,1549,2317,2,"Private nonprofit, 4-year or above",2,12,14,467075,467230,934305,467075,467230,934305,Basketball
3391,2015,140818,Piedmont College,Demorest,GA,305350010,7,NCAA Division III without football,386,747,1133,2,"Private nonprofit, 4-year or above",2,17,16,148494,154847,303341,148616,160485,309101,Basketball
20756,2016,140818,Piedmont College,Demorest,GA,30535,7,NCAA Division III without football,438,739,1177,2,"Private nonprofit, 4-year or above",2,17,20,192032,193902,385934,185849,189440,375289,Basketball
38216,2017,140818,Piedmont College,Demorest,GA,30535,7,NCAA Division III without football,409,751,1160,2,"Private nonprofit, 4-year or above",2,17,15,183002,184262,367264,171114,177527,348641,Basketball
55869,2018,140818,Piedmont College,Demorest,GA,30535,7,NCAA Division III without football,400,745,1145,2,"Private nonprofit, 4-year or above",2,16,15,195898,199734,395632,178582,193166,371748,Basketball
82560,2019,140818,Piedmont College,Demorest,GA,30535,7,NCAA Division III without football,415,730,1145,2,"Private nonprofit, 4-year or above",2,18,22,208783,228477,437260,205418,228477,433895,Basketball
6785,2015,167455,Pine Manor College,Chestnut Hill,MA,2467,7,NCAA Division III without football,191,247,438,2,"Private nonprofit, 4-year or above",2,17,10,55627,39963,95590,55627,39963,95590,Basketball
24175,2016,167455,Pine Manor College,Chestnut Hill,MA,2467,7,NCAA Division III without football,107,173,280,2,"Private nonprofit, 4-year or above",2,14,8,50366,36606,86972,50366,36606,86972,Basketball
41677,2017,167455,Pine Manor College,Chestnut Hill,MA,2467,7,NCAA Division III without football,107,146,253,2,"Private nonprofit, 4-year or above",2,18,11,54597,55393,109990,54597,55393,109990,Basketball
59367,2018,167455,Pine Manor College,Chestnut Hill,MA,2467,7,NCAA Division III without football,128,114,242,2,"Private nonprofit, 4-year or above",2,15,7,57514,56299,113813,57514,56299,113813,Basketball
94153,2019,167455,Pine Manor College,Chestnut Hill,MA,2467,7,NCAA Division III without football,137,107,244,2,"Private nonprofit, 4-year or above",2,13,8,51332,88643,139975,51332,88643,139975,Basketball
5380,2015,155681,Pittsburg State University,Pittsburg,KS,66762,4,NCAA Division II with football,2837,2520,5357,1,"Public, 4-year or above",2,15,16,567758,509334,1077092,529284,480566,1009850,Basketball
22748,2016,155681,Pittsburg State University,Pittsburg,KS,66762,4,NCAA Division II with football,2776,2471,5247,1,"Public, 4-year or above",2,16,15,613552,525635,1139187,613552,525635,1139187,Basketball
40236,2017,155681,Pittsburg State University,Pittsburg,KS,66762,4,NCAA Division II with football,2671,2364,5035,1,"Public, 4-year or above",2,18,13,788551,587877,1376428,788551,587877,1376428,Basketball
57909,2018,155681,Pittsburg State University,Pittsburg,KS,66762,4,NCAA Division II with football,2497,2295,4792,1,"Public, 4-year or above",2,15,13,624073,518018,1142091,624073,518018,1142091,Basketball
89555,2019,155681,Pittsburg State University,Pittsburg,KS,66762,4,NCAA Division II with football,2353,2233,4586,1,"Public, 4-year or above",2,15,15,802647,543492,1346139,802647,543492,1346139,Basketball
8853,2015,183080,Plymouth State University,Plymouth,NH,32641595,6,NCAA Division III with football,1923,1890,3813,1,"Public, 4-year or above",2,22,18,70377,69440,139817,70377,69440,139817,Basketball
26280,2016,183080,Plymouth State University,Plymouth,NH,3264,6,NCAA Division III with football,1954,1970,3924,1,"Public, 4-year or above",2,20,19,74447,74930,149377,74447,74930,149377,Basketball
43777,2017,183080,Plymouth State University,Plymouth,NH,3264,6,NCAA Division III with football,1964,1994,3958,1,"Public, 4-year or above",2,15,14,78995,70913,149908,78995,70913,149908,Basketball
61494,2018,183080,Plymouth State University,Plymouth,NH,3264,6,NCAA Division III with football,1982,2008,3990,1,"Public, 4-year or above",2,19,16,78454,75505,153959,82264,74713,156977,Basketball
101500,2019,183080,Plymouth State University,Plymouth,NH,3264,6,NCAA Division III with football,1843,1816,3659,1,"Public, 4-year or above",2,21,15,82437,80260,162697,94605,79968,174573,Basketball
1680,2015,121309,Point Loma Nazarene University,San Diego,CA,921062899,5,NCAA Division II without football,928,1659,2587,2,"Private nonprofit, 4-year or above",2,14,13,714010,562661,1276671,697699,562614,1260313,Basketball
19041,2016,121309,Point Loma Nazarene University,San Diego,CA,92106,5,NCAA Division II without football,919,1615,2534,2,"Private nonprofit, 4-year or above",2,16,14,766357,633897,1400254,724293,633897,1358190,Basketball
36476,2017,121309,Point Loma Nazarene University,San Diego,CA,92106,5,NCAA Division II without football,941,1630,2571,2,"Private nonprofit, 4-year or above",2,16,16,825452,610070,1435522,825452,610070,1435522,Basketball
54107,2018,121309,Point Loma Nazarene University,San Diego,CA,92106,5,NCAA Division II without football,943,1652,2595,2,"Private nonprofit, 4-year or above",2,16,13,896483,664262,1560745,874316,656314,1530630,Basketball
76494,2019,121309,Point Loma Nazarene University,San Diego,CA,92106,5,NCAA Division II without football,925,1686,2611,2,"Private nonprofit, 4-year or above",2,13,13,792381,660873,1453254,787617,643234,1430851,Basketball
1687,2015,121345,Pomona College,Claremont,CA,917116319,6,NCAA Division III with football,816,824,1640,2,"Private nonprofit, 4-year or above",2,18,14,180774,114511,295285,180774,113011,293785,Basketball
19048,2016,121345,Pomona College,Claremont,CA,91711,6,NCAA Division III with football,772,775,1547,2,"Private nonprofit, 4-year or above",2,15,11,219831,108901,328732,219831,108901,328732,Basketball
36483,2017,121345,Pomona College,Claremont,CA,91711,6,NCAA Division III with football,790,777,1567,2,"Private nonprofit, 4-year or above",2,16,11,220718,126167,346885,220718,126020,346738,Basketball
54114,2018,121345,Pomona College,Claremont,CA,91711,6,NCAA Division III with football,752,797,1549,2,"Private nonprofit, 4-year or above",2,15,13,218050,138880,356930,217150,138126,355276,Basketball
76532,2019,121345,Pomona College,Claremont,CA,91711,6,NCAA Division III with football,768,842,1610,2,"Private nonprofit, 4-year or above",2,13,14,281774,121761,403535,235574,116665,352239,Basketball
12426,2015,209807,Portland State University,Portland,OR,97201,2,NCAA Division I-FCS,6636,7460,14096,1,"Public, 4-year or above",2,17,15,1284182,1172315,2456497,1284182,1172315,2456497,Basketball
29873,2016,209807,Portland State University,Portland,OR,97201,2,NCAA Division I-FCS,6309,7389,13698,1,"Public, 4-year or above",2,15,17,1327806,1225858,2553664,1327806,1225858,2553664,Basketball
47367,2017,209807,Portland State University,Portland,OR,97201,2,NCAA Division I-FCS,6213,7427,13640,1,"Public, 4-year or above",2,15,13,1320231,1005485,2325716,1320231,1005485,2325716,Basketball
65113,2018,209807,Portland State University,Portland,OR,97201,2,NCAA Division I-FCS,6228,7756,13984,1,"Public, 4-year or above",2,15,15,1809651,1358033,3167684,1809651,1358033,3167684,Basketball
113821,2019,209807,Portland State University,Portland,OR,97201,2,NCAA Division I-FCS,5974,7562,13536,1,"Public, 4-year or above",2,16,13,1414241,1091795,2506036,1414241,1091795,2506036,Basketball
2427,2015,130183,Post University,Waterbury,CT,6723,5,NCAA Division II without football,1030,1581,2611,3,"Private for-profit, 4-year or above",2,17,16,500475,362665,863140,500475,362665,863140,Basketball
19797,2016,130183,Post University,Waterbury,CT,6723,5,NCAA Division II without football,991,1566,2557,3,"Private for-profit, 4-year or above",2,16,17,456030,270643,726673,453990,270643,724633,Basketball
37237,2017,130183,Post University,Waterbury,CT,6723,5,NCAA Division II without football,1006,1604,2610,3,"Private for-profit, 4-year or above",2,16,18,432165,272148,704313,424839,272123,696962,Basketball
54873,2018,130183,Post University,Waterbury,CT,6708,5,NCAA Division II without football,899,1656,2555,3,"Private for-profit, 4-year or above",2,18,20,455019,284900,739919,454721,283026,737747,Basketball
79037,2019,130183,Post University,Waterbury,CT,6708,5,NCAA Division II without football,811,1478,2289,3,"Private for-profit, 4-year or above",2,30,20,423905,283804,707709,421949,281594,703543,Basketball
15006,2015,227526,Prairie View A & M University,Prairie View,TX,77446,2,NCAA Division I-FCS,2524,3781,6305,1,"Public, 4-year or above",2,20,13,910637,877171,1787808,910637,877171,1787808,Basketball
32474,2016,227526,Prairie View A & M University,Prairie View,TX,77446,2,NCAA Division I-FCS,2746,4071,6817,1,"Public, 4-year or above",2,20,15,930482,959167,1889649,930482,959167,1889649,Basketball
50001,2017,227526,Prairie View A & M University,Prairie View,TX,77446,2,NCAA Division I-FCS,2840,4501,7341,1,"Public, 4-year or above",2,14,13,1131873,1033527,2165400,1131873,1033527,2165400,Basketball
67780,2018,227526,Prairie View A & M University,Prairie View,TX,77446,2,NCAA Division I-FCS,2830,5123,7953,1,"Public, 4-year or above",2,17,15,1184538,1020121,2204659,1184538,1020121,2204659,Basketball
123211,2019,227526,Prairie View A & M University,Prairie View,TX,77446,2,NCAA Division I-FCS,2559,4942,7501,1,"Public, 4-year or above",2,18,14,1199860,988646,2188506,1199860,988646,2188506,Basketball
105847,2019,194578,Pratt Institute-Main,Brooklyn,NY,11205,7,NCAA Division III without football,1023,2526,3549,2,"Private nonprofit, 4-year or above",2,13,11,70753,30386,101139,70753,30386,101139,Basketball
14076,2015,218539,Presbyterian College,Clinton,SC,29325,2,NCAA Division I-FCS,453,497,950,2,"Private nonprofit, 4-year or above",2,16,12,1215955,828571,2044526,1215955,828571,2044526,Basketball
31533,2016,218539,Presbyterian College,Clinton,SC,29325,2,NCAA Division I-FCS,459,484,943,2,"Private nonprofit, 4-year or above",2,16,12,1362625,872613,2235238,1362625,872613,2235238,Basketball
49045,2017,218539,Presbyterian College,Clinton,SC,29325,2,NCAA Division I-FCS,472,470,942,2,"Private nonprofit, 4-year or above",2,17,15,1139541,902422,2041963,1139541,902422,2041963,Basketball
66807,2018,218539,Presbyterian College,Clinton,SC,29325,2,NCAA Division I-FCS,478,487,965,2,"Private nonprofit, 4-year or above",2,15,16,1330762,945492,2276254,1330762,945492,2276254,Basketball
118985,2019,218539,Presbyterian College,Clinton,SC,29325,2,NCAA Division I-FCS,501,521,1022,2,"Private nonprofit, 4-year or above",2,15,16,1346659,1067021,2413680,1346659,1067021,2413680,Basketball
9124,2015,186131,Princeton University,Princeton,NJ,85440070,2,NCAA Division I-FCS,2717,2543,5260,2,"Private nonprofit, 4-year or above",2,16,17,1117914,1170976,2288890,1117914,1170976,2288890,Basketball
26548,2016,186131,Princeton University,Princeton,NJ,8544,2,NCAA Division I-FCS,2707,2529,5236,2,"Private nonprofit, 4-year or above",2,23,16,1579073,1369574,2948647,1579073,1369574,2948647,Basketball
44043,2017,186131,Princeton University,Princeton,NJ,8544,2,NCAA Division I-FCS,2688,2558,5246,2,"Private nonprofit, 4-year or above",2,17,14,1404423,1350398,2754821,1404423,1350398,2754821,Basketball
61765,2018,186131,Princeton University,Princeton,NJ,8544,2,NCAA Division I-FCS,2707,2594,5301,2,"Private nonprofit, 4-year or above",2,18,14,1342776,1312083,2654859,1342776,1312083,2654859,Basketball
102515,2019,186131,Princeton University,Princeton,NJ,8544,2,NCAA Division I-FCS,2670,2638,5308,2,"Private nonprofit, 4-year or above",2,17,16,1572141,1146607,2718748,1572141,1146607,2718748,Basketball
13818,2015,217402,Providence College,Providence,RI,29180001,3,NCAA Division I without football,1654,2087,3741,2,"Private nonprofit, 4-year or above",2,14,12,7907240,2594058,10501298,7907240,2594058,10501298,Basketball
31272,2016,217402,Providence College,Providence,RI,2918,3,NCAA Division I without football,1675,2093,3768,2,"Private nonprofit, 4-year or above",2,14,26,9081267,2784056,11865323,9081267,2784056,11865323,Basketball
48783,2017,217402,Providence College,Providence,RI,2918,3,NCAA Division I without football,1726,2091,3817,2,"Private nonprofit, 4-year or above",2,14,12,10768267,2889111,13657378,10768267,2889111,13657378,Basketball
66538,2018,217402,Providence College,Providence,RI,2918,3,NCAA Division I without football,1777,2124,3901,2,"Private nonprofit, 4-year or above",2,13,13,11117186,3109357,14226543,11117186,3109357,14226543,Basketball
118154,2019,217402,Providence College,Providence,RI,2918,3,NCAA Division I without football,1802,2085,3887,2,"Private nonprofit, 4-year or above",2,16,14,12448442,3257497,15705939,12448442,3257497,15705939,Basketball
86376,2019,151102,Purdue University Fort Wayne,Fort Wayne,IN,46805,3,NCAA Division I without football,2568,2782,5350,1,"Public, 4-year or above",2,15,19,1683099,986400,2669499,1683099,986400,2669499,Basketball
52372,2017,490805,Purdue University Northwest,Hammond,IN,46323,5,NCAA Division II without football,2967,3017,5984,1,"Public, 4-year or above",2,17,11,358977,332502,691479,358977,332502,691479,Basketball
70142,2018,490805,Purdue University Northwest,Hammond,IN,46323,5,NCAA Division II without football,2869,2886,5755,1,"Public, 4-year or above",2,17,12,420102,403966,824068,420102,403966,824068,Basketball
132280,2019,490805,Purdue University Northwest,Hammond,IN,46323,5,NCAA Division II without football,2653,2798,5451,1,"Public, 4-year or above",2,17,11,429053,357617,786670,429053,357617,786670,Basketball
21972,2016,152248,Purdue University-Calumet Campus,Hammond,IN,46323,5,NCAA Division II without football,2256,2089,4345,1,"Public, 4-year or above",2,17,11,250752,264103,514855,250782,264103,514885,Basketball
17040,2015,243780,Purdue University-Main Campus,West Lafayette,IN,479072040,1,NCAA Division I-FBS,16595,12060,28655,1,"Public, 4-year or above",2,16,13,10375722,723687,11099409,7243691,3513474,10757165,Basketball
34444,2016,243780,Purdue University-Main Campus,West Lafayette,IN,47907,1,NCAA Division I-FBS,17069,12232,29301,1,"Public, 4-year or above",2,14,12,10171629,628183,10799812,8099562,3724142,11823704,Basketball
52046,2017,243780,Purdue University-Main Campus,West Lafayette,IN,47907,1,NCAA Division I-FBS,17529,12740,30269,1,"Public, 4-year or above",2,14,13,9891222,697902,10589124,8410571,4092120,12502691,Basketball
69802,2018,243780,Purdue University-Main Campus,West Lafayette,IN,47907,1,NCAA Division I-FBS,18331,13508,31839,1,"Public, 4-year or above",2,13,14,18017191,6843854,24861045,9604624,4242993,13847617,Basketball
130289,2019,243780,Purdue University-Main Campus,West Lafayette,IN,47907,1,NCAA Division I-FBS,18755,13848,32603,1,"Public, 4-year or above",2,15,15,15155248,6513061,21668309,8286755,4426155,12712910,Basketball
11180,2015,199412,Queens University of Charlotte,Charlotte,NC,282740001,5,NCAA Division II without football,417,925,1342,2,"Private nonprofit, 4-year or above",2,21,16,662258,486401,1148659,662258,486401,1148659,Basketball
28619,2016,199412,Queens University of Charlotte,Charlotte,NC,28274,5,NCAA Division II without football,388,906,1294,2,"Private nonprofit, 4-year or above",2,16,14,771018,504258,1275276,771018,504258,1275276,Basketball
46119,2017,199412,Queens University of Charlotte,Charlotte,NC,28274,5,NCAA Division II without football,483,952,1435,2,"Private nonprofit, 4-year or above",2,17,16,779935,557810,1337745,779935,557810,1337745,Basketball
63840,2018,199412,Queens University of Charlotte,Charlotte,NC,28274,5,NCAA Division II without football,522,1023,1545,2,"Private nonprofit, 4-year or above",2,16,16,829491,653899,1483390,829491,653899,1483390,Basketball
109076,2019,199412,Queens University of Charlotte,Charlotte,NC,28274,5,NCAA Division II without football,525,1029,1554,2,"Private nonprofit, 4-year or above",2,18,15,1037208,719816,1757024,1037208,719816,1757024,Basketball
4120,2015,148131,Quincy University,Quincy,IL,623012699,4,NCAA Division II with football,478,545,1023,2,"Private nonprofit, 4-year or above",2,19,17,665831,573390,1239221,659241,568759,1228000,Basketball
21496,2016,148131,Quincy University,Quincy,IL,62301,4,NCAA Division II with football,490,545,1035,2,"Private nonprofit, 4-year or above",2,18,16,653683,494335,1148018,661168,476965,1138133,Basketball
38961,2017,148131,Quincy University,Quincy,IL,62301,4,NCAA Division II with football,460,410,870,2,"Private nonprofit, 4-year or above",2,30,17,593250,457849,1051099,601494,439464,1040958,Basketball
56621,2018,148131,Quincy University,Quincy,IL,62301,4,NCAA Division II with football,483,403,886,2,"Private nonprofit, 4-year or above",2,42,15,655692,457080,1112772,657510,456132,1113642,Basketball
85237,2019,148131,Quincy University,Quincy,IL,62301,4,NCAA Division II with football,462,472,934,2,"Private nonprofit, 4-year or above",2,27,17,640118,521796,1161914,670888,522962,1193850,Basketball
2438,2015,130226,Quinnipiac University,Hamden,CT,6518,3,NCAA Division I without football,2636,4067,6703,2,"Private nonprofit, 4-year or above",2,16,15,2516824,2287254,4804078,2516824,2287254,4804078,Basketball
19808,2016,130226,Quinnipiac University,Hamden,CT,6518,3,NCAA Division I without football,2673,4111,6784,2,"Private nonprofit, 4-year or above",2,14,16,2609446,2575530,5184976,2609446,2575530,5184976,Basketball
37247,2017,130226,Quinnipiac University,Hamden,CT,6518,3,NCAA Division I without football,2721,4238,6959,2,"Private nonprofit, 4-year or above",2,15,15,3193567,2714442,5908009,3193567,2714442,5908009,Basketball
54883,2018,130226,Quinnipiac University,Hamden,CT,6518,3,NCAA Division I without football,2744,4307,7051,2,"Private nonprofit, 4-year or above",2,15,22,3203013,2735931,5938944,3203013,2735931,5938944,Basketball
79048,2019,130226,Quinnipiac University,Hamden,CT,6518,3,NCAA Division I without football,2569,3974,6543,2,"Private nonprofit, 4-year or above",2,15,13,3046181,2256230,5302411,3046181,2256230,5302411,Basketball
15795,2015,233277,Radford University,Radford,VA,24142,3,NCAA Division I without football,3696,4794,8490,1,"Public, 4-year or above",2,17,13,1327458,1029142,2356600,1327458,1029142,2356600,Basketball
33269,2016,233277,Radford University,Radford,VA,24142,3,NCAA Division I without football,3492,4599,8091,1,"Public, 4-year or above",2,17,13,2325900,1777885,4103785,1544246,1123683,2667929,Basketball
50813,2017,233277,Radford University,Radford,VA,24142,3,NCAA Division I without football,3419,4607,8026,1,"Public, 4-year or above",2,15,14,1605340,1177960,2783300,1605340,1177960,2783300,Basketball
68561,2018,233277,Radford University,Radford,VA,24142,3,NCAA Division I without football,3203,4328,7531,1,"Public, 4-year or above",2,15,14,1682177,1167573,2849750,1682177,1167573,2849750,Basketball
125929,2019,233277,Radford University,Radford,VA,24142,3,NCAA Division I without football,2930,4550,7480,1,"Public, 4-year or above",2,17,14,532253,115027,647280,1674412,1144233,2818645,Basketball
9143,2015,186201,Ramapo College of New Jersey,Mahwah,NJ,74301680,7,NCAA Division III without football,2269,2654,4923,1,"Public, 4-year or above",2,22,25,209482,143919,353401,201011,139248,340259,Basketball
26566,2016,186201,Ramapo College of New Jersey,Mahwah,NJ,7430,7,NCAA Division III without football,2309,2656,4965,1,"Public, 4-year or above",2,20,16,262218,166186,428404,257545,159143,416688,Basketball
44061,2017,186201,Ramapo College of New Jersey,Mahwah,NJ,7430,7,NCAA Division III without football,2228,2621,4849,1,"Public, 4-year or above",2,19,17,272089,182468,454557,265190,175661,440851,Basketball
61783,2018,186201,Ramapo College of New Jersey,Mahwah,NJ,7430,7,NCAA Division III without football,2201,2594,4795,1,"Public, 4-year or above",2,19,18,275875,203554,479429,274623,203554,478177,Basketball
102533,2019,186201,Ramapo College of New Jersey,Mahwah,NJ,7430,7,NCAA Division III without football,2142,2698,4840,1,"Public, 4-year or above",2,19,17,232277,176067,408344,253834,176231,430065,Basketball
15815,2015,233301,Randolph College,Lynchburg,VA,245031555,7,NCAA Division III without football,223,438,661,2,"Private nonprofit, 4-year or above",2,20,15,196915,82024,278939,190414,77672,268086,Basketball
33289,2016,233301,Randolph College,Lynchburg,VA,24503,7,NCAA Division III without football,221,423,644,2,"Private nonprofit, 4-year or above",2,17,16,125773,118704,244477,119400,117885,237285,Basketball
50833,2017,233301,Randolph College,Lynchburg,VA,24503,7,NCAA Division III without football,234,409,643,2,"Private nonprofit, 4-year or above",2,18,13,134800,110390,245190,126170,109111,235281,Basketball
68581,2018,233301,Randolph College,Lynchburg,VA,24503,7,NCAA Division III without football,213,370,583,2,"Private nonprofit, 4-year or above",2,19,10,127350,94721,222071,116224,93347,209571,Basketball
126005,2019,233301,Randolph College,Lynchburg,VA,24503,7,NCAA Division III without football,210,332,542,2,"Private nonprofit, 4-year or above",2,20,16,116927,110754,227681,105047,106297,211344,Basketball
15805,2015,233295,Randolph-Macon College,Ashland,VA,230055505,6,NCAA Division III with football,626,757,1383,2,"Private nonprofit, 4-year or above",2,18,12,242326,226267,468593,235932,226267,462199,Basketball
33279,2016,233295,Randolph-Macon College,Ashland,VA,23005,6,NCAA Division III with football,657,752,1409,2,"Private nonprofit, 4-year or above",2,15,16,251495,244855,496350,235935,244855,480790,Basketball
50823,2017,233295,Randolph-Macon College,Ashland,VA,23005,6,NCAA Division III with football,649,774,1423,2,"Private nonprofit, 4-year or above",2,15,10,263173,229431,492604,263173,229431,492604,Basketball
68571,2018,233295,Randolph-Macon College,Ashland,VA,23005,6,NCAA Division III with football,685,774,1459,2,"Private nonprofit, 4-year or above",2,16,14,284973,264542,549515,277531,264542,542073,Basketball
125967,2019,233295,Randolph-Macon College,Ashland,VA,23005,6,NCAA Division III with football,714,799,1513,2,"Private nonprofit, 4-year or above",2,15,13,291338,248991,540329,257077,248991,506068,Basketball
6792,2015,167598,Regis College,Weston,MA,24931571,7,NCAA Division III without football,231,727,958,2,"Private nonprofit, 4-year or above",2,15,16,104576,96923,201499,104576,96923,201499,Basketball
24183,2016,167598,Regis College,Weston,MA,2493,7,NCAA Division III without football,209,755,964,2,"Private nonprofit, 4-year or above",2,20,14,129869,104078,233947,129869,104078,233947,Basketball
41687,2017,167598,Regis College,Weston,MA,2493,7,NCAA Division III without football,203,729,932,2,"Private nonprofit, 4-year or above",2,18,15,94011,97062,191073,94011,97062,191073,Basketball
59377,2018,167598,Regis College,Weston,MA,2493,7,NCAA Division III without football,223,926,1149,2,"Private nonprofit, 4-year or above",2,12,15,96037,99943,195980,96037,99943,195980,Basketball
94195,2019,167598,Regis College,Weston,MA,2493,7,NCAA Division III without football,225,899,1124,2,"Private nonprofit, 4-year or above",2,14,14,90856,94892,185748,90856,94892,185748,Basketball
2291,2015,127918,Regis University,Denver,CO,802211099,5,NCAA Division II without football,898,1536,2434,2,"Private nonprofit, 4-year or above",2,14,13,662767,577557,1240324,655668,577557,1233225,Basketball
19662,2016,127918,Regis University,Denver,CO,80221,5,NCAA Division II without football,876,1483,2359,2,"Private nonprofit, 4-year or above",2,15,14,668159,599034,1267193,668159,599034,1267193,Basketball
37101,2017,127918,Regis University,Denver,CO,80221,5,NCAA Division II without football,844,1534,2378,2,"Private nonprofit, 4-year or above",2,15,13,702696,603104,1305800,702696,603104,1305800,Basketball
54737,2018,127918,Regis University,Denver,CO,80221,5,NCAA Division II without football,838,1535,2373,2,"Private nonprofit, 4-year or above",2,13,15,687858,617501,1305359,687858,617501,1305359,Basketball
78671,2019,127918,Regis University,Denver,CO,80221,5,NCAA Division II without football,752,1438,2190,2,"Private nonprofit, 4-year or above",2,15,13,458827,589835,1048662,709113,589835,1298948,Basketball
10177,2015,194824,Rensselaer Polytechnic Institute,Troy,NY,121803590,6,NCAA Division III with football,3984,1794,5778,2,"Private nonprofit, 4-year or above",2,13,15,182434,153256,335690,172974,137265,310239,Basketball
27598,2016,194824,Rensselaer Polytechnic Institute,Troy,NY,12180,6,NCAA Division III with football,4243,1954,6197,2,"Private nonprofit, 4-year or above",2,13,14,203713,166500,370213,185866,145881,331747,Basketball
45085,2017,194824,Rensselaer Polytechnic Institute,Troy,NY,12180,6,NCAA Division III with football,4286,2019,6305,2,"Private nonprofit, 4-year or above",2,14,13,198709,161553,360262,198054,155232,353286,Basketball
62792,2018,194824,Rensselaer Polytechnic Institute,Troy,NY,12180,6,NCAA Division III with football,4492,2093,6585,2,"Private nonprofit, 4-year or above",2,16,17,208676,158858,367534,224485,153644,378129,Basketball
105885,2019,194824,Rensselaer Polytechnic Institute,Troy,NY,12180,6,NCAA Division III with football,4206,1992,6198,2,"Private nonprofit, 4-year or above",2,17,18,238533,163116,401649,205663,174667,380330,Basketball
13831,2015,217420,Rhode Island College,Providence,RI,2908,7,NCAA Division III without football,1796,3737,5533,1,"Public, 4-year or above",2,13,14,143877,123725,267602,141993,123725,265718,Basketball
31283,2016,217420,Rhode Island College,Providence,RI,2908,7,NCAA Division III without football,1776,3786,5562,1,"Public, 4-year or above",2,21,17,142750,132094,274844,139650,132094,271744,Basketball
48794,2017,217420,Rhode Island College,Providence,RI,2908,7,NCAA Division III without football,1699,3718,5417,1,"Public, 4-year or above",2,14,14,154071,136912,290983,154071,136912,290983,Basketball
66549,2018,217420,Rhode Island College,Providence,RI,2908,7,NCAA Division III without football,1538,3518,5056,1,"Public, 4-year or above",2,13,10,141112,146665,287777,140517,145665,286182,Basketball
118192,2019,217420,Rhode Island College,Providence,RI,2908,7,NCAA Division III without football,1492,3427,4919,1,"Public, 4-year or above",2,14,14,128990,127772,256762,128990,127772,256762,Basketball
14490,2015,221351,Rhodes College,Memphis,TN,381121690,6,NCAA Division III with football,885,1142,2027,2,"Private nonprofit, 4-year or above",2,18,17,178235,176328,354563,178235,176328,354563,Basketball
31955,2016,221351,Rhodes College,Memphis,TN,38112,6,NCAA Division III with football,875,1099,1974,2,"Private nonprofit, 4-year or above",2,23,13,186506,149241,335747,186032,134604,320636,Basketball
49474,2017,221351,Rhodes College,Memphis,TN,38112,6,NCAA Division III with football,866,1103,1969,2,"Private nonprofit, 4-year or above",2,26,12,191789,174034,365823,191958,174034,365992,Basketball
67243,2018,221351,Rhodes College,Memphis,TN,38112,6,NCAA Division III with football,873,1108,1981,2,"Private nonprofit, 4-year or above",2,16,13,186729,176223,362952,186729,174290,361019,Basketball
120768,2019,221351,Rhodes College,Memphis,TN,38112,6,NCAA Division III with football,814,1125,1939,2,"Private nonprofit, 4-year or above",2,23,10,218885,162080,380965,180954,165002,345956,Basketball
15026,2015,227757,Rice University,Houston,TX,770051827,1,NCAA Division I-FBS,2013,1820,3833,2,"Private nonprofit, 4-year or above",2,17,15,3427660,2200134,5627794,3427660,2200134,5627794,Basketball
32494,2016,227757,Rice University,Houston,TX,77005,1,NCAA Division I-FBS,1999,1825,3824,2,"Private nonprofit, 4-year or above",2,17,20,3599914,2245409,5845323,3599914,2245409,5845323,Basketball
50021,2017,227757,Rice University,Houston,TX,77005,1,NCAA Division I-FBS,2063,1839,3902,2,"Private nonprofit, 4-year or above",2,16,24,3257777,2497873,5755650,3257777,2497873,5755650,Basketball
67800,2018,227757,Rice University,Houston,TX,77005,1,NCAA Division I-FBS,2020,1862,3882,2,"Private nonprofit, 4-year or above",2,14,21,3169654,2944961,6114615,3169654,2944961,6114615,Basketball
123287,2019,227757,Rice University,Houston,TX,77005,1,NCAA Division I-FBS,2033,1898,3931,2,"Private nonprofit, 4-year or above",2,16,20,3277980,3186482,6464462,3277980,3186482,6464462,Basketball
9155,2015,186283,Rider University,Lawrenceville,NJ,86483099,3,NCAA Division I without football,1561,2114,3675,2,"Private nonprofit, 4-year or above",2,14,12,1774910,1455548,3230458,1774910,1455548,3230458,Basketball
26578,2016,186283,Rider University,Lawrenceville,NJ,8648,3,NCAA Division I without football,1515,2117,3632,2,"Private nonprofit, 4-year or above",2,14,15,2038734,1826219,3864953,2038734,1826219,3864953,Basketball
44073,2017,186283,Rider University,Lawrenceville,NJ,8648,3,NCAA Division I without football,1544,2160,3704,2,"Private nonprofit, 4-year or above",2,17,14,2055949,1655390,3711339,2055949,1655390,3711339,Basketball
61795,2018,186283,Rider University,Lawrenceville,NJ,8648,3,NCAA Division I without football,1476,2054,3530,2,"Private nonprofit, 4-year or above",2,15,12,2508228,1620103,4128331,2508228,1620103,4128331,Basketball
102545,2019,186283,Rider University,Lawrenceville,NJ,8648,3,NCAA Division I without football,1485,1969,3454,2,"Private nonprofit, 4-year or above",2,12,19,2228897,1516404,3745301,2228897,1516404,3745301,Basketball
16575,2015,239628,Ripon College,Ripon,WI,549710248,6,NCAA Division III with football,388,392,780,2,"Private nonprofit, 4-year or above",2,18,17,85363,82757,168120,85363,82757,168120,Basketball
34052,2016,239628,Ripon College,Ripon,WI,54971,6,NCAA Division III with football,376,400,776,2,"Private nonprofit, 4-year or above",2,19,17,91406,82550,173956,91406,82550,173956,Basketball
51608,2017,239628,Ripon College,Ripon,WI,54971,6,NCAA Division III with football,340,395,735,2,"Private nonprofit, 4-year or above",2,19,20,120598,120403,241001,120598,120403,241001,Basketball
69354,2018,239628,Ripon College,Ripon,WI,54971,6,NCAA Division III with football,366,420,786,2,"Private nonprofit, 4-year or above",2,16,17,133534,123911,257445,124314,123311,247625,Basketball
129027,2019,239628,Ripon College,Ripon,WI,54971,6,NCAA Division III with football,350,415,765,2,"Private nonprofit, 4-year or above",2,16,18,125931,123847,249778,130513,77442,207955,Basketball
8880,2015,183211,Rivier University,Nashua,NH,3060,7,NCAA Division III without football,216,561,777,2,"Private nonprofit, 4-year or above",2,18,14,45414,32728,78142,45414,32728,78142,Basketball
26307,2016,183211,Rivier University,Nashua,NH,30605086,7,NCAA Division III without football,233,606,839,2,"Private nonprofit, 4-year or above",2,12,16,54457,46452,100909,54457,46452,100909,Basketball
43804,2017,183211,Rivier University,Nashua,NH,3060,7,NCAA Division III without football,217,691,908,2,"Private nonprofit, 4-year or above",2,17,15,52059,34962,87021,52059,34962,87021,Basketball
61521,2018,183211,Rivier University,Nashua,NH,30605086,7,NCAA Division III without football,229,717,946,2,"Private nonprofit, 4-year or above",2,15,12,66422,46092,112514,66422,46092,112514,Basketball
101558,2019,183211,Rivier University,Nashua,NH,30605086,7,NCAA Division III without football,211,732,943,2,"Private nonprofit, 4-year or above",2,17,13,58939,44634,103573,58939,44634,103573,Basketball
15839,2015,233426,Roanoke College,Salem,VA,241533794,7,NCAA Division III without football,781,1144,1925,2,"Private nonprofit, 4-year or above",2,16,14,170307,128800,299107,170307,128800,299107,Basketball
33313,2016,233426,Roanoke College,Salem,VA,24153,7,NCAA Division III without football,796,1123,1919,2,"Private nonprofit, 4-year or above",2,17,13,206056,148960,355016,206056,148960,355016,Basketball
50861,2017,233426,Roanoke College,Salem,VA,24153,7,NCAA Division III without football,829,1129,1958,2,"Private nonprofit, 4-year or above",2,15,16,207739,164908,372647,207739,164908,372647,Basketball
68609,2018,233426,Roanoke College,Salem,VA,24153,7,NCAA Division III without football,823,1124,1947,2,"Private nonprofit, 4-year or above",2,14,15,201070,150149,351219,201070,150149,351219,Basketball
126119,2019,233426,Roanoke College,Salem,VA,24153,7,NCAA Division III without football,815,1113,1928,2,"Private nonprofit, 4-year or above",2,21,18,206005,184585,390590,206005,184585,390590,Basketball
13463,2015,215655,Robert Morris University,Moon Township,PA,151081189,2,NCAA Division I-FCS,2323,1641,3964,2,"Private nonprofit, 4-year or above",2,16,15,1962797,1646936,3609733,1962797,1646936,3609733,Basketball
30921,2016,215655,Robert Morris University,Moon Township,PA,15108,2,NCAA Division I-FCS,2339,1601,3940,2,"Private nonprofit, 4-year or above",2,15,12,2179096,1428012,3607108,2179096,1428012,3607108,Basketball
48430,2017,215655,Robert Morris University,Moon Township,PA,15108,2,NCAA Division I-FCS,2210,1629,3839,2,"Private nonprofit, 4-year or above",2,15,12,2206245,1484041,3690286,2206245,1484041,3690286,Basketball
66172,2018,215655,Robert Morris University,Moon Township,PA,15108,2,NCAA Division I-FCS,2058,1619,3677,2,"Private nonprofit, 4-year or above",2,15,13,2661978,1555049,4217027,2661978,1555049,4217027,Basketball
117253,2019,215655,Robert Morris University,Moon Township,PA,15108,2,NCAA Division I-FCS,1969,1527,3496,2,"Private nonprofit, 4-year or above",2,14,14,2220578,1481808,3702386,2220578,1481808,3702386,Basketball
10188,2015,194958,Roberts Wesleyan College,Rochester,NY,14624,5,NCAA Division II without football,357,858,1215,2,"Private nonprofit, 4-year or above",2,14,26,258901,284428,543329,242168,281265,523433,Basketball
27609,2016,194958,Roberts Wesleyan College,Rochester,NY,14624,5,NCAA Division II without football,366,841,1207,2,"Private nonprofit, 4-year or above",2,25,19,255083,292416,547499,235117,282085,517202,Basketball
45096,2017,194958,Roberts Wesleyan College,Rochester,NY,14624,5,NCAA Division II without football,385,863,1248,2,"Private nonprofit, 4-year or above",2,26,19,337064,317109,654173,313643,302730,616373,Basketball
62803,2018,194958,Roberts Wesleyan College,Rochester,NY,14624,5,NCAA Division II without football,349,852,1201,2,"Private nonprofit, 4-year or above",2,22,12,341377,270321,611698,332052,265409,597461,Basketball
105922,2019,194958,Roberts Wesleyan College,Rochester,NY,14624,5,NCAA Division II without football,385,791,1176,2,"Private nonprofit, 4-year or above",2,26,24,510324,464241,974565,316703,303040,619743,Basketball
4156,2015,148405,Rockford University,Rockford,IL,611082311,6,NCAA Division III with football,366,549,915,2,"Private nonprofit, 4-year or above",2,25,11,127643,69086,196729,127643,69086,196729,Basketball
21530,2016,148405,Rockford University,Rockford,IL,61108,6,NCAA Division III with football,378,531,909,2,"Private nonprofit, 4-year or above",2,27,14,132525,92750,225275,132525,92750,225275,Basketball
38993,2017,148405,Rockford University,Rockford,IL,61108,6,NCAA Division III with football,400,490,890,2,"Private nonprofit, 4-year or above",2,22,15,160936,105510,266446,160936,105510,266446,Basketball
56652,2018,148405,Rockford University,Rockford,IL,61108,6,NCAA Division III with football,393,478,871,2,"Private nonprofit, 4-year or above",2,26,15,166956,102460,269416,166956,102460,269416,Basketball
85302,2019,148405,Rockford University,Rockford,IL,61108,6,NCAA Division III with football,400,491,891,2,"Private nonprofit, 4-year or above",2,29,11,154676,91159,245835,154676,91159,245835,Basketball
8346,2015,179043,Rockhurst University,Kansas City,MO,641102561,5,NCAA Division II without football,628,814,1442,2,"Private nonprofit, 4-year or above",2,17,14,562739,452013,1014752,562739,452013,1014752,Basketball
25779,2016,179043,Rockhurst University,Kansas City,MO,64110,5,NCAA Division II without football,615,788,1403,2,"Private nonprofit, 4-year or above",2,14,17,515094,519625,1034719,515094,519625,1034719,Basketball
43269,2017,179043,Rockhurst University,Kansas City,MO,64110,5,NCAA Division II without football,630,814,1444,2,"Private nonprofit, 4-year or above",2,17,17,524688,567750,1092438,524688,567750,1092438,Basketball
60989,2018,179043,Rockhurst University,Kansas City,MO,64110,5,NCAA Division II without football,630,822,1452,2,"Private nonprofit, 4-year or above",2,17,21,582784,644042,1226826,582784,644042,1226826,Basketball
99632,2019,179043,Rockhurst University,Kansas City,MO,64110,5,NCAA Division II without football,657,794,1451,2,"Private nonprofit, 4-year or above",2,15,22,546163,675222,1221385,546163,675222,1221385,Basketball
13863,2015,217518,Roger Williams University,Bristol,RI,28092921,7,NCAA Division III without football,1892,2055,3947,2,"Private nonprofit, 4-year or above",2,15,11,134299,106028,240327,133742,110160,243902,Basketball
31317,2016,217518,Roger Williams University,Bristol,RI,2809,7,NCAA Division III without football,1901,2219,4120,2,"Private nonprofit, 4-year or above",2,15,15,116389,126241,242630,106512,121972,228484,Basketball
48828,2017,217518,Roger Williams University,Bristol,RI,2809,7,NCAA Division III without football,1905,2135,4040,2,"Private nonprofit, 4-year or above",2,16,11,129754,119019,248773,113688,116261,229949,Basketball
66582,2018,217518,Roger Williams University,Bristol,RI,2809,7,NCAA Division III without football,1919,2035,3954,2,"Private nonprofit, 4-year or above",2,14,14,155074,116156,271230,155074,116156,271230,Basketball
118281,2019,217518,Roger Williams University,Bristol,RI,2809,7,NCAA Division III without football,1982,2034,4016,2,"Private nonprofit, 4-year or above",2,12,15,118418,119781,238199,114366,108993,223359,Basketball
12207,2015,207661,Rogers State University,Claremore,OK,740173252,5,NCAA Division II without football,987,1472,2459,1,"Public, 4-year or above",2,13,14,527350,492693,1020043,527350,492693,1020043,Basketball
29647,2016,207661,Rogers State University,Claremore,OK,74017,5,NCAA Division II without football,951,1403,2354,1,"Public, 4-year or above",2,14,14,567062,534185,1101247,567062,534185,1101247,Basketball
47152,2017,207661,Rogers State University,Claremore,OK,74017,5,NCAA Division II without football,956,1219,2175,1,"Public, 4-year or above",2,14,12,623575,523974,1147549,623575,523974,1147549,Basketball
64897,2018,207661,Rogers State University,Claremore,OK,74017,5,NCAA Division II without football,936,1318,2254,1,"Public, 4-year or above",2,17,12,687401,577470,1264871,687401,577470,1264871,Basketball
112881,2019,207661,Rogers State University,Claremore,OK,74017,5,NCAA Division II without football,893,1375,2268,1,"Public, 4-year or above",2,14,11,634404,554902,1189306,634404,554902,1189306,Basketball
2989,2015,136950,Rollins College,Winter Park,FL,327894499,5,NCAA Division II without football,1021,1457,2478,2,"Private nonprofit, 4-year or above",2,16,13,847349,673112,1520461,847349,673112,1520461,Basketball
20363,2016,136950,Rollins College,Winter Park,FL,32789,5,NCAA Division II without football,990,1460,2450,2,"Private nonprofit, 4-year or above",2,17,14,925844,754625,1680469,925844,754625,1680469,Basketball
37814,2017,136950,Rollins College,Winter Park,FL,32789,5,NCAA Division II without football,972,1481,2453,2,"Private nonprofit, 4-year or above",2,19,15,879098,844630,1723728,879098,844630,1723728,Basketball
55464,2018,136950,Rollins College,Winter Park,FL,32789,5,NCAA Division II without football,975,1458,2433,2,"Private nonprofit, 4-year or above",2,16,15,948786,833974,1782760,948786,833974,1782760,Basketball
81060,2019,136950,Rollins College,Winter Park,FL,32789,5,NCAA Division II without football,979,1503,2482,2,"Private nonprofit, 4-year or above",2,15,15,943629,877683,1821312,943629,877683,1821312,Basketball
4611,2015,152318,Rose-Hulman Institute of Technology,Terre Haute,IN,478033920,6,NCAA Division III with football,1726,491,2217,2,"Private nonprofit, 4-year or above",2,21,19,156538,92950,249488,148254,92550,240804,Basketball
21980,2016,152318,Rose-Hulman Institute of Technology,Terre Haute,IN,47803,6,NCAA Division III with football,1628,543,2171,2,"Private nonprofit, 4-year or above",2,20,15,165095,90321,255416,165095,90321,255416,Basketball
39451,2017,152318,Rose-Hulman Institute of Technology,Terre Haute,IN,47803,6,NCAA Division III with football,1605,528,2133,2,"Private nonprofit, 4-year or above",2,22,15,173180,100750,273930,151770,99288,251058,Basketball
57112,2018,152318,Rose-Hulman Institute of Technology,Terre Haute,IN,47803,6,NCAA Division III with football,1545,507,2052,2,"Private nonprofit, 4-year or above",2,19,13,270760,197714,468474,270760,197714,468474,Basketball
86987,2019,152318,Rose-Hulman Institute of Technology,Terre Haute,IN,47803,6,NCAA Division III with football,1494,481,1975,2,"Private nonprofit, 4-year or above",2,20,10,168982,190773,359755,156667,190773,347440,Basketball
13473,2015,215691,Rosemont College,Rosemont,PA,190101699,7,NCAA Division III without football,156,292,448,2,"Private nonprofit, 4-year or above",2,20,10,47113,32971,80084,46975,32971,79946,Basketball
30931,2016,215691,Rosemont College,Rosemont,PA,19010,7,NCAA Division III without football,195,322,517,2,"Private nonprofit, 4-year or above",2,17,14,60664,42070,102734,60664,42070,102734,Basketball
48440,2017,215691,Rosemont College,Rosemont,PA,190101499,7,NCAA Division III without football,189,325,514,2,"Private nonprofit, 4-year or above",2,18,16,76501,44241,120742,76501,44241,120742,Basketball
66182,2018,215691,Rosemont College,Rosemont,PA,190101499,7,NCAA Division III without football,167,291,458,2,"Private nonprofit, 4-year or above",2,16,13,73293,58102,131395,71504,58102,129606,Basketball
117290,2019,215691,Rosemont College,Rosemont,PA,19010,7,NCAA Division III without football,136,249,385,2,"Private nonprofit, 4-year or above",2,15,8,75305,66569,141874,75305,66569,141874,Basketball
9027,2015,184782,Rowan University,Glassboro,NJ,8028,6,NCAA Division III with football,6400,5300,11700,1,"Public, 4-year or above",2,17,17,229523,204026,433549,229523,204026,433549,Basketball
26451,2016,184782,Rowan University,Glassboro,NJ,8028,6,NCAA Division III with football,7016,5712,12728,1,"Public, 4-year or above",2,16,15,293114,238171,531285,293114,238171,531285,Basketball
43947,2017,184782,Rowan University,Glassboro,NJ,8028,6,NCAA Division III with football,7497,6082,13579,1,"Public, 4-year or above",2,16,14,327851,228417,556268,327851,228417,556268,Basketball
61666,2018,184782,Rowan University,Glassboro,NJ,8028,6,NCAA Division III with football,7788,6251,14039,1,"Public, 4-year or above",2,16,14,376608,240877,617485,353732,217217,570949,Basketball
102214,2019,184782,Rowan University,Glassboro,NJ,8028,6,NCAA Division III with football,7739,6310,14049,1,"Public, 4-year or above",2,16,13,316219,207744,523963,302625,179379,482004,Basketball
8046,2015,176318,Rust College,Holly Springs,MS,38635,7,NCAA Division III without football,318,477,795,2,"Private nonprofit, 4-year or above",2,16,16,141648,136723,278371,141648,136723,278371,Basketball
25464,2016,176318,Rust College,Holly Springs,MS,38635,7,NCAA Division III without football,350,522,872,2,"Private nonprofit, 4-year or above",2,12,13,151831,150233,302064,151831,150233,302064,Basketball
9166,2015,186371,Rutgers University-Camden,Camden,NJ,8102,7,NCAA Division III without football,1687,2238,3925,1,"Public, 4-year or above",2,11,10,87817,101309,189126,87817,101309,189126,Basketball
26589,2016,186371,Rutgers University-Camden,Camden,NJ,81021400,7,NCAA Division III without football,1675,2377,4052,1,"Public, 4-year or above",2,16,13,93932,94461,188393,93932,94461,188393,Basketball
44084,2017,186371,Rutgers University-Camden,Camden,NJ,8102,7,NCAA Division III without football,1813,2631,4444,1,"Public, 4-year or above",2,15,15,126271,124621,250892,126271,124621,250892,Basketball
61806,2018,186371,Rutgers University-Camden,Camden,NJ,8102,7,NCAA Division III without football,1844,2915,4759,1,"Public, 4-year or above",2,10,9,125373,135594,260967,125373,135594,260967,Basketball
102583,2019,186371,Rutgers University-Camden,Camden,NJ,8102,7,NCAA Division III without football,1769,2993,4762,1,"Public, 4-year or above",2,16,14,118403,133347,251750,118403,133347,251750,Basketball
9178,2015,186380,Rutgers University-New Brunswick,New Brunswick,NJ,89011281,1,NCAA Division I-FBS,16654,16640,33294,1,"Public, 4-year or above",2,15,23,6147089,4420669,10567758,6147089,4420669,10567758,Basketball
26600,2016,186380,Rutgers University-New Brunswick,New Brunswick,NJ,8901,1,NCAA Division I-FBS,16991,16948,33939,1,"Public, 4-year or above",2,16,26,8168723,4197164,12365887,8168723,4197164,12365887,Basketball
44095,2017,186380,Rutgers University-New Brunswick,New Brunswick,NJ,8901,1,NCAA Division I-FBS,16844,16775,33619,1,"Public, 4-year or above",2,17,26,8333665,4985066,13318731,8333665,4985066,13318731,Basketball
61817,2018,186380,Rutgers University-New Brunswick,New Brunswick,NJ,8901,1,NCAA Division I-FBS,16916,17065,33981,1,"Public, 4-year or above",2,15,29,7545360,5450614,12995974,7545360,5450614,12995974,Basketball
102594,2019,186380,Rutgers University-New Brunswick,New Brunswick,NJ,8901,1,NCAA Division I-FBS,17189,17044,34233,1,"Public, 4-year or above",2,15,37,8249544,5321701,13571245,8249544,5321701,13571245,Basketball
9193,2015,186399,Rutgers University-Newark,Newark,NJ,7102,7,NCAA Division III without football,2952,3254,6206,1,"Public, 4-year or above",2,19,13,198376,119609,317985,199197,120906,320103,Basketball
26615,2016,186399,Rutgers University-Newark,Newark,NJ,7102,7,NCAA Division III without football,3094,3572,6666,1,"Public, 4-year or above",2,17,13,171355,147509,318864,169185,147509,316694,Basketball
44110,2017,186399,Rutgers University-Newark,Newark,NJ,7102,7,NCAA Division III without football,3219,3937,7156,1,"Public, 4-year or above",2,18,13,201120,149209,350329,199053,148245,347298,Basketball
61832,2018,186399,Rutgers University-Newark,Newark,NJ,7102,7,NCAA Division III without football,3447,4268,7715,1,"Public, 4-year or above",2,17,14,206012,165365,371377,197523,164021,361544,Basketball
102632,2019,186399,Rutgers University-Newark,Newark,NJ,7102,7,NCAA Division III without football,3448,4510,7958,1,"Public, 4-year or above",2,15,15,200325,167744,368069,199690,166806,366496,Basketball
2451,2015,130253,Sacred Heart University,Fairfield,CT,68251000,2,NCAA Division I-FCS,1647,2787,4434,2,"Private nonprofit, 4-year or above",2,15,20,1431536,1453408,2884944,1431536,1453408,2884944,Basketball
19821,2016,130253,Sacred Heart University,Fairfield,CT,6825,2,NCAA Division I-FCS,1769,3024,4793,2,"Private nonprofit, 4-year or above",2,14,15,1387829,1365462,2753291,1387829,1365462,2753291,Basketball
37260,2017,130253,Sacred Heart University,Fairfield,CT,6825,2,NCAA Division I-FCS,1844,3136,4980,2,"Private nonprofit, 4-year or above",2,14,16,1483982,1458365,2942347,1483982,1458365,2942347,Basketball
54896,2018,130253,Sacred Heart University,Fairfield,CT,6825,2,NCAA Division I-FCS,1852,3278,5130,2,"Private nonprofit, 4-year or above",2,14,13,1496346,1393337,2889683,1496346,1393337,2889683,Basketball
79086,2019,130253,Sacred Heart University,Fairfield,CT,6825,2,NCAA Division I-FCS,1891,3457,5348,2,"Private nonprofit, 4-year or above",2,14,21,1582453,1579501,3161954,1582453,1579501,3161954,Basketball
7390,2015,172051,Saginaw Valley State University,University Center,MI,48710,4,NCAA Division II with football,3041,4139,7180,1,"Public, 4-year or above",2,16,13,585195,511182,1096377,585195,510182,1095377,Basketball
24798,2016,172051,Saginaw Valley State University,University Center,MI,48710,4,NCAA Division II with football,2779,3971,6750,1,"Public, 4-year or above",2,17,14,598289,551339,1149628,598289,543763,1142052,Basketball
42296,2017,172051,Saginaw Valley State University,University Center,MI,48710,4,NCAA Division II with football,2580,3813,6393,1,"Public, 4-year or above",2,14,14,587392,562595,1149987,587392,541662,1129054,Basketball
60001,2018,172051,Saginaw Valley State University,University Center,MI,48710,4,NCAA Division II with football,2501,3824,6325,1,"Public, 4-year or above",2,17,14,646791,622916,1269707,632878,622916,1255794,Basketball
96077,2019,172051,Saginaw Valley State University,University Center,MI,48710,4,NCAA Division II with football,2371,3837,6208,1,"Public, 4-year or above",2,17,15,645180,501193,1146373,645180,501193,1146373,Basketball
8888,2015,183239,Saint Anselm College,Manchester,NH,31021310,4,NCAA Division II with football,748,1129,1877,2,"Private nonprofit, 4-year or above",2,14,14,843395,780907,1624302,785299,732308,1517607,Basketball
26315,2016,183239,Saint Anselm College,Manchester,NH,3102,4,NCAA Division II with football,724,1150,1874,2,"Private nonprofit, 4-year or above",2,16,13,752699,637963,1390662,674136,642444,1316580,Basketball
43812,2017,183239,Saint Anselm College,Manchester,NH,3102,4,NCAA Division II with football,763,1162,1925,2,"Private nonprofit, 4-year or above",2,16,14,1000460,755196,1755656,994807,747442,1742249,Basketball
61529,2018,183239,Saint Anselm College,Manchester,NH,3102,4,NCAA Division II with football,788,1217,2005,2,"Private nonprofit, 4-year or above",2,14,14,1017229,824581,1841810,921176,808333,1729509,Basketball
101596,2019,183239,Saint Anselm College,Manchester,NH,3102,4,NCAA Division II with football,778,1235,2013,2,"Private nonprofit, 4-year or above",2,15,12,985692,812663,1798355,881392,804789,1686181,Basketball
11196,2015,199582,Saint Augustine's University,Raleigh,NC,276102298,4,NCAA Division II with football,419,379,798,2,"Private nonprofit, 4-year or above",2,14,10,295876,286448,582324,293764,286448,580212,Basketball
28636,2016,199582,Saint Augustine's University,Raleigh,NC,27610,4,NCAA Division II with football,494,425,919,2,"Private nonprofit, 4-year or above",2,19,13,258005,201376,459381,258005,201376,459381,Basketball
46136,2017,199582,Saint Augustine's University,Raleigh,NC,27610,4,NCAA Division II with football,527,434,961,2,"Private nonprofit, 4-year or above",2,16,12,242856,131876,374732,242856,131876,374732,Basketball
63859,2018,199582,Saint Augustine's University,Raleigh,NC,27610,4,NCAA Division II with football,379,371,750,2,"Private nonprofit, 4-year or above",2,18,14,227818,196281,424099,227818,196281,424099,Basketball
109165,2019,199582,Saint Augustine's University,Raleigh,NC,27610,4,NCAA Division II with football,477,385,862,2,"Private nonprofit, 4-year or above",2,18,19,246146,219991,466137,246146,219991,466137,Basketball
7749,2015,174783,Saint Cloud State University,Saint Cloud,MN,563014498,4,NCAA Division II with football,4326,4469,8795,1,"Public, 4-year or above",2,15,17,567381,334528,901909,633043,449441,1082484,Basketball
25163,2016,174783,Saint Cloud State University,Saint Cloud,MN,56301,4,NCAA Division II with football,4135,4371,8506,1,"Public, 4-year or above",2,14,16,557274,329189,886463,705429,470403,1175832,Basketball
42662,2017,174783,Saint Cloud State University,Saint Cloud,MN,56301,4,NCAA Division II with football,3974,4088,8062,1,"Public, 4-year or above",2,12,16,555485,379570,935055,667885,528716,1196601,Basketball
60368,2018,174783,Saint Cloud State University,Saint Cloud,MN,56301,4,NCAA Division II with football,3650,3832,7482,1,"Public, 4-year or above",2,13,18,652470,433838,1086308,610917,536304,1147221,Basketball
97301,2019,174783,Saint Cloud State University,Saint Cloud,MN,56301,4,NCAA Division II with football,3268,3415,6683,1,"Public, 4-year or above",2,14,17,464045,323162,787207,582875,474833,1057708,Basketball
15039,2015,227845,Saint Edward's University,Austin,TX,787046489,5,NCAA Division II without football,1391,2134,3525,2,"Private nonprofit, 4-year or above",2,14,12,818809,780930,1599739,816022,780212,1596234,Basketball
32508,2016,227845,Saint Edward's University,Austin,TX,78704,5,NCAA Division II without football,1424,2184,3608,2,"Private nonprofit, 4-year or above",2,17,13,875675,800509,1676184,852041,808239,1660280,Basketball
50034,2017,227845,Saint Edward's University,Austin,TX,78704,5,NCAA Division II without football,1369,2158,3527,2,"Private nonprofit, 4-year or above",2,15,15,816724,869690,1686414,783755,869690,1653445,Basketball
67813,2018,227845,Saint Edward's University,Austin,TX,78704,5,NCAA Division II without football,1304,2147,3451,2,"Private nonprofit, 4-year or above",2,15,14,901777,943704,1845481,866461,859575,1726036,Basketball
123363,2019,227845,Saint Edward's University,Austin,TX,78704,5,NCAA Division II without football,1183,1984,3167,2,"Private nonprofit, 4-year or above",2,17,14,1295861,1092150,2388011,1239556,962835,2202391,Basketball
13481,2015,215743,Saint Francis University,Loretto,PA,159400600,2,NCAA Division I-FCS,607,984,1591,2,"Private nonprofit, 4-year or above",2,16,17,1529048,1463735,2992783,1529048,1463735,2992783,Basketball
30939,2016,215743,Saint Francis University,Loretto,PA,15940,2,NCAA Division I-FCS,585,955,1540,2,"Private nonprofit, 4-year or above",2,18,16,1673478,1498820,3172298,1673477,1498820,3172297,Basketball
48448,2017,215743,Saint Francis University,Loretto,PA,15940,2,NCAA Division I-FCS,546,964,1510,2,"Private nonprofit, 4-year or above",2,17,18,1749067,1636248,3385315,1749067,1636248,3385315,Basketball
66190,2018,215743,Saint Francis University,Loretto,PA,15940,2,NCAA Division I-FCS,533,936,1469,2,"Private nonprofit, 4-year or above",2,18,17,2040877,1552791,3593668,2040877,1552791,3593668,Basketball
117299,2019,215743,Saint Francis University,Loretto,PA,15940,2,NCAA Division I-FCS,544,903,1447,2,"Private nonprofit, 4-year or above",2,19,14,1722704,1322155,3044859,1722704,1322155,3044859,Basketball
10350,2015,195720,Saint John Fisher College,Rochester,NY,146183597,6,NCAA Division III with football,1044,1572,2616,2,"Private nonprofit, 4-year or above",2,31,13,242257,179101,421358,239854,174872,414726,Basketball
27773,2016,195720,Saint John Fisher College,Rochester,NY,14618,6,NCAA Division III with football,1046,1555,2601,2,"Private nonprofit, 4-year or above",2,35,16,322875,195609,518484,301110,190644,491754,Basketball
45269,2017,195720,Saint John Fisher College,Rochester,NY,14618,6,NCAA Division III with football,1064,1550,2614,2,"Private nonprofit, 4-year or above",2,36,14,223338,159901,383239,205449,154785,360234,Basketball
62977,2018,195720,Saint John Fisher College,Rochester,NY,14618,6,NCAA Division III with football,1103,1513,2616,2,"Private nonprofit, 4-year or above",2,29,20,245161,190067,435228,235189,181292,416481,Basketball
106370,2019,195720,Saint John Fisher College,Rochester,NY,14618,6,NCAA Division III with football,1043,1492,2535,2,"Private nonprofit, 4-year or above",2,28,17,199318,192381,391699,189400,191176,380576,Basketball
5996,2015,161518,Saint Joseph's College of Maine,Standish,ME,40845236,7,NCAA Division III without football,345,622,967,2,"Private nonprofit, 4-year or above",2,13,18,72831,67085,139916,65431,55650,121081,Basketball
23383,2016,161518,Saint Joseph's College of Maine,Standish,ME,4084,7,NCAA Division III without football,365,629,994,2,"Private nonprofit, 4-year or above",2,16,13,75853,69987,145840,79775,72424,152199,Basketball
40885,2017,161518,Saint Joseph's College of Maine,Standish,ME,4084,7,NCAA Division III without football,354,606,960,2,"Private nonprofit, 4-year or above",2,14,13,96008,71426,167434,89657,62399,152056,Basketball
58574,2018,161518,Saint Joseph's College of Maine,Standish,ME,4084,7,NCAA Division III without football,357,615,972,2,"Private nonprofit, 4-year or above",2,19,13,102731,86764,189495,101113,85691,186804,Basketball
91681,2019,161518,Saint Joseph's College of Maine,Standish,ME,4084,7,NCAA Division III without football,329,551,880,2,"Private nonprofit, 4-year or above",2,23,12,73985,62600,136585,75466,45485,120951,Basketball
10340,2015,195544,Saint Joseph's College-New York,Brooklyn,NY,112053688,7,NCAA Division III without football,1076,2079,3155,2,"Private nonprofit, 4-year or above",2,29,23,100040,90399,190439,100040,90399,190439,Basketball
13496,2015,215770,Saint Joseph's University,Philadelphia,PA,191311395,3,NCAA Division I without football,2122,2490,4612,2,"Private nonprofit, 4-year or above",2,18,15,4208092,2321511,6529603,4208092,2321511,6529603,Basketball
30955,2016,215770,Saint Joseph's University,Philadelphia,PA,19131,3,NCAA Division I without football,2125,2524,4649,2,"Private nonprofit, 4-year or above",2,18,15,4212082,2611953,6824035,4212082,2611953,6824035,Basketball
48464,2017,215770,Saint Joseph's University,Philadelphia,PA,19131,3,NCAA Division I without football,2075,2397,4472,2,"Private nonprofit, 4-year or above",2,18,15,4231094,2785053,7016147,4231094,2785053,7016147,Basketball
66206,2018,215770,Saint Joseph's University,Philadelphia,PA,19131,3,NCAA Division I without football,2004,2342,4346,2,"Private nonprofit, 4-year or above",2,12,14,6152876,2540102,8692978,6152876,2540102,8692978,Basketball
117337,2019,215770,Saint Joseph's University,Philadelphia,PA,19131,3,NCAA Division I without football,1980,2224,4204,2,"Private nonprofit, 4-year or above",2,17,14,4424092,2588687,7012779,4424092,2588687,7012779,Basketball
4632,2015,152363,Saint Josephs College,Rensselaer,IN,479780870,4,NCAA Division II with football,437,507,944,2,"Private nonprofit, 4-year or above",2,19,12,394500,348196,742696,394500,348196,742696,Basketball
3002,2015,137032,Saint Leo University,Saint Leo,FL,335746665,5,NCAA Division II without football,3282,4802,8084,2,"Private nonprofit, 4-year or above",2,15,15,584638,468940,1053578,575346,445583,1020929,Basketball
20376,2016,137032,Saint Leo University,Saint Leo,FL,33574,5,NCAA Division II without football,3050,4505,7555,2,"Private nonprofit, 4-year or above",2,16,14,594774,504097,1098871,577701,487764,1065465,Basketball
37827,2017,137032,Saint Leo University,Saint Leo,FL,33574,5,NCAA Division II without football,2700,3974,6674,2,"Private nonprofit, 4-year or above",2,17,15,614861,535272,1150133,601538,525521,1127059,Basketball
55477,2018,137032,Saint Leo University,Saint Leo,FL,33574,5,NCAA Division II without football,2459,3626,6085,2,"Private nonprofit, 4-year or above",2,14,16,676495,565951,1242446,619766,531558,1151324,Basketball
81098,2019,137032,Saint Leo University,Saint Leo,FL,33574,5,NCAA Division II without football,2271,3573,5844,2,"Private nonprofit, 4-year or above",2,12,14,688177,558201,1246378,656734,525832,1182566,Basketball
8355,2015,179159,Saint Louis University,Saint Louis,MO,631032097,3,NCAA Division I without football,2825,3956,6781,2,"Private nonprofit, 4-year or above",2,15,15,6414061,1925595,8339656,6414061,1925595,8339656,Basketball
25788,2016,179159,Saint Louis University,Saint Louis,MO,63103,3,NCAA Division I without football,2745,3927,6672,2,"Private nonprofit, 4-year or above",2,15,21,5590746,2301912,7892658,5590746,2301912,7892658,Basketball
43278,2017,179159,Saint Louis University,Saint Louis,MO,63103,3,NCAA Division I without football,2631,3973,6604,2,"Private nonprofit, 4-year or above",2,15,19,6876215,2550668,9426883,6876215,2550668,9426883,Basketball
60998,2018,179159,Saint Louis University,Saint Louis,MO,63103,3,NCAA Division I without football,2544,3865,6409,2,"Private nonprofit, 4-year or above",2,16,20,7428566,2640557,10069123,7428566,2640557,10069123,Basketball
99670,2019,179159,Saint Louis University,Saint Louis,MO,63103,3,NCAA Division I without football,2613,4045,6658,2,"Private nonprofit, 4-year or above",2,15,18,7207705,2491015,9698720,7207705,2491015,9698720,Basketball
16109,2015,236452,Saint Martin's University,Lacey,WA,985037500,5,NCAA Division II without football,476,504,980,2,"Private nonprofit, 4-year or above",2,16,15,512899,343266,856165,512899,343266,856165,Basketball
33583,2016,236452,Saint Martin's University,Lacey,WA,98503,5,NCAA Division II without football,488,548,1036,2,"Private nonprofit, 4-year or above",2,15,17,320032,428650,748682,320032,428650,748682,Basketball
51138,2017,236452,Saint Martin's University,Lacey,WA,98503,5,NCAA Division II without football,565,551,1116,2,"Private nonprofit, 4-year or above",2,15,15,686037,548285,1234322,567109,533942,1101051,Basketball
68885,2018,236452,Saint Martin's University,Lacey,WA,98503,5,NCAA Division II without football,595,567,1162,2,"Private nonprofit, 4-year or above",2,15,15,704328,622810,1327138,704328,622810,1327138,Basketball
127279,2019,236452,Saint Martin's University,Lacey,WA,98503,5,NCAA Division II without football,598,653,1251,2,"Private nonprofit, 4-year or above",2,15,15,200406,83337,283743,426097,753972,1180069,Basketball
2011,2015,123554,Saint Mary's College of California,Moraga,CA,94575,3,NCAA Division I without football,1086,1580,2666,2,"Private nonprofit, 4-year or above",2,15,20,2956340,1616052,4572392,2956340,1616052,4572392,Basketball
19378,2016,123554,Saint Mary's College of California,Moraga,CA,94575,3,NCAA Division I without football,1052,1538,2590,2,"Private nonprofit, 4-year or above",2,15,26,3467559,1701005,5168564,3467559,1701005,5168564,Basketball
36813,2017,123554,Saint Mary's College of California,Moraga,CA,94575,3,NCAA Division I without football,1061,1545,2606,2,"Private nonprofit, 4-year or above",2,15,30,4217785,1696813,5914598,4217785,1696813,5914598,Basketball
54448,2018,123554,Saint Mary's College of California,Moraga,CA,94575,3,NCAA Division I without football,1104,1505,2609,2,"Private nonprofit, 4-year or above",2,15,22,4401818,1714698,6116516,4401818,1714698,6116516,Basketball
77600,2019,123554,Saint Mary's College of California,Moraga,CA,94575,3,NCAA Division I without football,1095,1391,2486,2,"Private nonprofit, 4-year or above",2,16,21,4401624,1672315,6073939,4401624,1672315,6073939,Basketball
7762,2015,174817,Saint Mary's University of Minnesota,Winona,MN,559871399,7,NCAA Division III without football,592,630,1222,2,"Private nonprofit, 4-year or above",2,18,13,155887,106106,261993,155887,106106,261993,Basketball
25176,2016,174817,Saint Mary's University of Minnesota,Winona,MN,55987,7,NCAA Division III without football,552,599,1151,2,"Private nonprofit, 4-year or above",2,15,13,179027,114750,293777,179027,114750,293777,Basketball
42675,2017,174817,Saint Mary's University of Minnesota,Winona,MN,55987,7,NCAA Division III without football,545,571,1116,2,"Private nonprofit, 4-year or above",2,17,18,173298,130757,304055,173298,130757,304055,Basketball
60381,2018,174817,Saint Mary's University of Minnesota,Winona,MN,55987,7,NCAA Division III without football,492,606,1098,2,"Private nonprofit, 4-year or above",2,20,19,206554,108192,314746,206554,108192,314746,Basketball
97339,2019,174817,Saint Mary's University of Minnesota,Winona,MN,55987,7,NCAA Division III without football,510,611,1121,2,"Private nonprofit, 4-year or above",2,21,17,139251,111905,251156,139251,111905,251156,Basketball
15529,2015,231059,Saint Michael's College,Colchester,VT,5439,5,NCAA Division II without football,871,1060,1931,2,"Private nonprofit, 4-year or above",2,13,11,703110,652291,1355401,703110,652290,1355400,Basketball
32997,2016,231059,Saint Michael's College,Colchester,VT,5439,5,NCAA Division II without football,810,1029,1839,2,"Private nonprofit, 4-year or above",2,13,12,742252,735582,1477834,737062,730049,1467111,Basketball
50529,2017,231059,Saint Michael's College,Colchester,VT,5439,5,NCAA Division II without football,776,970,1746,2,"Private nonprofit, 4-year or above",2,14,10,775527,756136,1531663,775527,756136,1531663,Basketball
68290,2018,231059,Saint Michael's College,Colchester,VT,5439,5,NCAA Division II without football,744,898,1642,2,"Private nonprofit, 4-year or above",2,13,12,802715,796844,1599559,802715,796844,1599559,Basketball
125079,2019,231059,Saint Michael's College,Colchester,VT,5439,5,NCAA Division II without football,707,833,1540,2,"Private nonprofit, 4-year or above",2,13,14,730278,762921,1493199,730278,762921,1493199,Basketball
16586,2015,239716,Saint Norbert College,De Pere,WI,541152099,6,NCAA Division III with football,882,1149,2031,2,"Private nonprofit, 4-year or above",2,17,14,212906,157329,370235,212906,157329,370235,Basketball
34063,2016,239716,Saint Norbert College,De Pere,WI,54115,6,NCAA Division III with football,881,1167,2048,2,"Private nonprofit, 4-year or above",2,20,18,242492,199153,441645,242492,199153,441645,Basketball
51619,2017,239716,Saint Norbert College,De Pere,WI,54115,6,NCAA Division III with football,872,1148,2020,2,"Private nonprofit, 4-year or above",2,23,13,220945,158532,379477,220945,158532,379477,Basketball
69365,2018,239716,Saint Norbert College,De Pere,WI,54115,6,NCAA Division III with football,864,1216,2080,2,"Private nonprofit, 4-year or above",2,19,16,212168,164693,376861,212168,164693,376861,Basketball
129064,2019,239716,Saint Norbert College,De Pere,WI,54115,6,NCAA Division III with football,819,1137,1956,2,"Private nonprofit, 4-year or above",2,20,15,276550,146512,423062,276550,146512,423062,Basketball
9200,2015,186432,Saint Peter's University,Jersey City,NJ,73065997,3,NCAA Division I without football,885,1320,2205,2,"Private nonprofit, 4-year or above",2,16,14,1387927,1159307,2547234,1387927,1159307,2547234,Basketball
26622,2016,186432,Saint Peter's University,Jersey City,NJ,7306,3,NCAA Division I without football,897,1486,2383,2,"Private nonprofit, 4-year or above",2,13,13,1490850,1161519,2652369,1490850,1161519,2652369,Basketball
44117,2017,186432,Saint Peter's University,Jersey City,NJ,7306,3,NCAA Division I without football,877,1499,2376,2,"Private nonprofit, 4-year or above",2,14,14,1446858,1292532,2739390,1446858,1292532,2739390,Basketball
61839,2018,186432,Saint Peter's University,Jersey City,NJ,7306,3,NCAA Division I without football,874,1465,2339,2,"Private nonprofit, 4-year or above",2,15,15,1641425,1285517,2926942,1641425,1285517,2926942,Basketball
102639,2019,186432,Saint Peter's University,Jersey City,NJ,7306,3,NCAA Division I without football,852,1338,2190,2,"Private nonprofit, 4-year or above",2,14,12,1569188,1102634,2671822,1569188,1102634,2671822,Basketball
13506,2015,215798,Saint Vincent College,Latrobe,PA,156502690,6,NCAA Division III with football,835,744,1579,2,"Private nonprofit, 4-year or above",2,15,16,272429,209777,482206,272429,209777,482206,Basketball
30965,2016,215798,Saint Vincent College,Latrobe,PA,15650,6,NCAA Division III with football,819,762,1581,2,"Private nonprofit, 4-year or above",2,13,18,285691,195937,481628,285691,195937,481628,Basketball
48474,2017,215798,Saint Vincent College,Latrobe,PA,15650,6,NCAA Division III with football,880,723,1603,2,"Private nonprofit, 4-year or above",2,16,18,305308,227526,532834,305308,227526,532834,Basketball
66216,2018,215798,Saint Vincent College,Latrobe,PA,15650,6,NCAA Division III with football,877,708,1585,2,"Private nonprofit, 4-year or above",2,16,17,304781,204868,509649,304781,204868,509649,Basketball
117347,2019,215798,Saint Vincent College,Latrobe,PA,15650,6,NCAA Division III with football,791,692,1483,2,"Private nonprofit, 4-year or above",2,14,18,199773,222363,422136,199773,222363,422136,Basketball
11205,2015,199607,Salem College,Winston-Salem,NC,27101,7,NCAA Division III without football,20,742,762,2,"Private nonprofit, 4-year or above",2,0,10,NA,45149,45149,NA,45149,45149,Basketball
28643,2016,199607,Salem College,Winston-Salem,NC,27101,7,NCAA Division III without football,4,715,719,2,"Private nonprofit, 4-year or above",2,0,12,NA,55566,55566,NA,55566,55566,Basketball
46143,2017,199607,Salem College,Winston-Salem,NC,27101,7,NCAA Division III without football,5,667,672,2,"Private nonprofit, 4-year or above",2,0,14,NA,38903,38903,NA,38903,38903,Basketball
63865,2018,199607,Salem College,Winston-Salem,NC,27101,7,NCAA Division III without football,6,546,552,2,"Private nonprofit, 4-year or above",2,0,12,NA,47730,47730,NA,47730,47730,Basketball
109200,2019,199607,Salem College,Winston-Salem,NC,27101,7,NCAA Division III without football,4,469,473,2,"Private nonprofit, 4-year or above",2,0,10,NA,63579,63579,NA,62769,62769,Basketball
16348,2015,237783,Salem International University,Salem,WV,26426,5,NCAA Division II without football,258,275,533,3,"Private for-profit, 4-year or above",2,31,22,466523,312990,779513,453048,316240,769288,Basketball
33823,2016,237783,Salem International University,Salem,WV,26426,5,NCAA Division II without football,297,352,649,3,"Private for-profit, 4-year or above",2,31,12,365117,221450,586567,314669,197693,512362,Basketball
51378,2017,237783,Salem International University,Salem,WV,26426,5,NCAA Division II without football,421,471,892,3,"Private for-profit, 4-year or above",2,40,21,571418,432723,1004141,571418,432723,1004141,Basketball
69123,2018,237783,Salem International University,Salem,WV,26426,5,NCAA Division II without football,317,430,747,3,"Private for-profit, 4-year or above",2,24,18,499194,408315,907509,475538,422136,897674,Basketball
6808,2015,167729,Salem State University,Salem,MA,1970,7,NCAA Division III without football,2299,3559,5858,1,"Public, 4-year or above",2,16,12,65473,50013,115486,65473,50013,115486,Basketball
24199,2016,167729,Salem State University,Salem,MA,1970,7,NCAA Division III without football,2243,3585,5828,1,"Public, 4-year or above",2,17,12,46081,60962,107043,46081,60962,107043,Basketball
41703,2017,167729,Salem State University,Salem,MA,1970,7,NCAA Division III without football,2198,3578,5776,1,"Public, 4-year or above",2,17,12,49720,40184,89904,49720,40184,89904,Basketball
59394,2018,167729,Salem State University,Salem,MA,1970,7,NCAA Division III without football,2017,3398,5415,1,"Public, 4-year or above",2,15,15,46895,57263,104158,46895,57263,104158,Basketball
94211,2019,167729,Salem State University,Salem,MA,1970,7,NCAA Division III without football,1853,3127,4980,1,"Public, 4-year or above",2,15,13,45788,31500,77288,45788,31500,77288,Basketball
128242,2019,237783,Salem University,Salem,WV,26426,5,NCAA Division II without football,310,318,628,3,"Private for-profit, 4-year or above",2,23,16,476550,449234,925784,468309,433978,902287,Basketball
6249,2015,163851,Salisbury University,Salisbury,MD,218016862,6,NCAA Division III with football,3066,4065,7131,1,"Public, 4-year or above",2,14,17,167307,145583,312890,157792,132465,290257,Basketball
23631,2016,163851,Salisbury University,Salisbury,MD,21801,6,NCAA Division III with football,3093,4143,7236,1,"Public, 4-year or above",2,20,18,161529,146709,308238,161529,144019,305548,Basketball
41135,2017,163851,Salisbury University,Salisbury,MD,21801,6,NCAA Division III with football,3156,4026,7182,1,"Public, 4-year or above",2,17,13,210343,156553,366896,200162,145600,345762,Basketball
58831,2018,163851,Salisbury University,Salisbury,MD,21801,6,NCAA Division III with football,3087,3990,7077,1,"Public, 4-year or above",2,13,14,129115,179541,308656,119647,166420,286067,Basketball
92642,2019,163851,Salisbury University,Salisbury,MD,21801,6,NCAA Division III with football,3130,3951,7081,1,"Public, 4-year or above",2,16,16,165377,194493,359870,158852,179788,338640,Basketball
13879,2015,217536,Salve Regina University,Newport,RI,28404192,6,NCAA Division III with football,586,1408,1994,2,"Private nonprofit, 4-year or above",2,15,14,82331,84932,167263,82331,84932,167263,Basketball
31333,2016,217536,Salve Regina University,Newport,RI,2840,6,NCAA Division III with football,608,1367,1975,2,"Private nonprofit, 4-year or above",2,17,13,97869,105626,203495,97869,105626,203495,Basketball
48844,2017,217536,Salve Regina University,Newport,RI,2840,6,NCAA Division III with football,704,1383,2087,2,"Private nonprofit, 4-year or above",2,15,13,100322,105663,205985,100322,105663,205985,Basketball
66598,2018,217536,Salve Regina University,Newport,RI,2840,6,NCAA Division III with football,650,1307,1957,2,"Private nonprofit, 4-year or above",2,16,13,90488,101350,191838,90488,101350,191838,Basketball
118297,2019,217536,Salve Regina University,Newport,RI,2840,6,NCAA Division III with football,738,1347,2085,2,"Private nonprofit, 4-year or above",2,13,15,99703,110202,209905,99703,110202,209905,Basketball
15051,2015,227881,Sam Houston State University,Huntsville,TX,77340,2,NCAA Division I-FCS,5482,8635,14117,1,"Public, 4-year or above",2,16,15,1087458,813588,1901046,1087458,813588,1901046,Basketball
32520,2016,227881,Sam Houston State University,Huntsville,TX,77340,2,NCAA Division I-FCS,5518,8979,14497,1,"Public, 4-year or above",2,15,17,1135562,859585,1995147,1135562,859585,1995147,Basketball
50046,2017,227881,Sam Houston State University,Huntsville,TX,77340,2,NCAA Division I-FCS,5589,9219,14808,1,"Public, 4-year or above",2,17,20,1227278,1105322,2332600,1227278,1105322,2332600,Basketball
67826,2018,227881,Sam Houston State University,Huntsville,TX,77340,2,NCAA Division I-FCS,5707,9366,15073,1,"Public, 4-year or above",2,15,20,1194442,1001360,2195802,1194442,1001360,2195802,Basketball
123438,2019,227881,Sam Houston State University,Huntsville,TX,77340,2,NCAA Division I-FCS,5798,9513,15311,1,"Public, 4-year or above",2,15,17,1209741,1052147,2261888,1209741,1052147,2261888,Basketball
229,2015,102049,Samford University,Birmingham,AL,352292240,2,NCAA Division I-FCS,1087,1948,3035,2,"Private nonprofit, 4-year or above",2,16,12,1961983,1078801,3040784,1821098,1008723,2829821,Basketball
17576,2016,102049,Samford University,Birmingham,AL,35229,2,NCAA Division I-FCS,1114,2090,3204,2,"Private nonprofit, 4-year or above",2,14,12,1843562,1233021,3076583,1843562,1209246,3052808,Basketball
34988,2017,102049,Samford University,Birmingham,AL,35229,2,NCAA Division I-FCS,1100,2163,3263,2,"Private nonprofit, 4-year or above",2,17,13,2152089,1338292,3490381,2152089,1338292,3490381,Basketball
52615,2018,102049,Samford University,Birmingham,AL,35229,2,NCAA Division I-FCS,1145,2307,3452,2,"Private nonprofit, 4-year or above",2,13,13,1917385,1338830,3256215,1917384,1338830,3256214,Basketball
71276,2019,102049,Samford University,Birmingham,AL,35229,2,NCAA Division I-FCS,1168,2340,3508,2,"Private nonprofit, 4-year or above",2,13,13,2139479,1311244,3450723,2139479,1311244,3450723,Basketball
1808,2015,122409,San Diego State University,San Diego,CA,92182,1,NCAA Division I-FBS,11725,13997,25722,1,"Public, 4-year or above",2,19,14,7819546,2833711,10653257,5734713,2320327,8055040,Basketball
19171,2016,122409,San Diego State University,San Diego,CA,92182,1,NCAA Division I-FBS,12068,14462,26530,1,"Public, 4-year or above",2,17,13,6453937,2255742,8709679,5924498,3210973,9135471,Basketball
36608,2017,122409,San Diego State University,San Diego,CA,92182,1,NCAA Division I-FBS,12235,14567,26802,1,"Public, 4-year or above",2,15,17,7777135,1975724,9752859,6207228,3054673,9261901,Basketball
54240,2018,122409,San Diego State University,San Diego,CA,92182,1,NCAA Division I-FBS,12196,14938,27134,1,"Public, 4-year or above",2,18,16,6248159,1796883,8045042,5786034,2796201,8582235,Basketball
76960,2019,122409,San Diego State University,San Diego,CA,92182,1,NCAA Division I-FBS,12122,15247,27369,1,"Public, 4-year or above",2,19,14,6180000,1774805,7954805,5560084,2876370,8436454,Basketball
1833,2015,122597,San Francisco State University,San Francisco,CA,94132,5,NCAA Division II without football,9291,12606,21897,1,"Public, 4-year or above",2,16,15,310410,358167,668577,310410,358167,668577,Basketball
19196,2016,122597,San Francisco State University,San Francisco,CA,94132,5,NCAA Division II without football,9165,12108,21273,1,"Public, 4-year or above",2,13,13,323097,330741,653838,323097,330741,653838,Basketball
36633,2017,122597,San Francisco State University,San Francisco,CA,94132,5,NCAA Division II without football,9491,12547,22038,1,"Public, 4-year or above",2,12,12,344936,358263,703199,333699,352247,685946,Basketball
54265,2018,122597,San Francisco State University,San Francisco,CA,94132,5,NCAA Division II without football,9445,12450,21895,1,"Public, 4-year or above",2,17,13,372567,356777,729344,372566,356777,729343,Basketball
77035,2019,122597,San Francisco State University,San Francisco,CA,94132,5,NCAA Division II without football,9400,12044,21444,1,"Public, 4-year or above",2,16,12,429383,394376,823759,429383,394376,823759,Basketball
1878,2015,122755,San Jose State University,San Jose,CA,951920001,1,NCAA Division I-FBS,11279,10285,21564,1,"Public, 4-year or above",2,15,14,1851101,1471179,3322280,1851101,1471179,3322280,Basketball
19240,2016,122755,San Jose State University,San Jose,CA,95192,1,NCAA Division I-FBS,11298,10271,21569,1,"Public, 4-year or above",2,15,12,2012188,1495120,3507308,2012188,1495120,3507308,Basketball
36678,2017,122755,San Jose State University,San Jose,CA,95192,1,NCAA Division I-FBS,11891,11141,23032,1,"Public, 4-year or above",2,14,16,2610949,2134548,4745497,2610949,2134548,4745497,Basketball
54312,2018,122755,San Jose State University,San Jose,CA,95192,1,NCAA Division I-FBS,11556,11468,23024,1,"Public, 4-year or above",2,15,13,2035793,1656137,3691930,2035793,1656137,3691930,Basketball
77168,2019,122755,San Jose State University,San Jose,CA,95192,1,NCAA Division I-FBS,11654,11862,23516,1,"Public, 4-year or above",2,13,15,2598370,1798647,4397017,2598371,1798648,4397019,Basketball
1913,2015,122931,Santa Clara University,Santa Clara,CA,95053,3,NCAA Division I without football,2680,2588,5268,2,"Private nonprofit, 4-year or above",2,15,16,3868477,1860023,5728500,3345588,1839613,5185201,Basketball
19276,2016,122931,Santa Clara University,Santa Clara,CA,95053,3,NCAA Division I without football,2664,2669,5333,2,"Private nonprofit, 4-year or above",2,18,16,3990886,2067991,6058877,3990886,2067991,6058877,Basketball
36713,2017,122931,Santa Clara University,Santa Clara,CA,95053,3,NCAA Division I without football,2703,2694,5397,2,"Private nonprofit, 4-year or above",2,18,22,4046491,2178113,6224604,4046491,2178113,6224604,Basketball
54347,2018,122931,Santa Clara University,Santa Clara,CA,95053,3,NCAA Division I without football,2743,2683,5426,2,"Private nonprofit, 4-year or above",2,17,14,4445480,2222128,6667608,4445480,2222128,6667608,Basketball
77282,2019,122931,Santa Clara University,Santa Clara,CA,95053,3,NCAA Division I without football,2773,2797,5570,2,"Private nonprofit, 4-year or above",2,19,24,3664575,1973972,5638547,4780775,2266616,7047391,Basketball
10300,2015,195304,Sarah Lawrence College,Bronxville,NY,10708,7,NCAA Division III without football,352,914,1266,2,"Private nonprofit, 4-year or above",2,12,0,92969,NA,92969,92969,NA,92969,Basketball
27722,2016,195304,Sarah Lawrence College,Bronxville,NY,10708,7,NCAA Division III without football,388,973,1361,2,"Private nonprofit, 4-year or above",2,17,0,91320,NA,91320,91320,NA,91320,Basketball
45210,2017,195304,Sarah Lawrence College,Bronxville,NY,10708,7,NCAA Division III without football,380,961,1341,2,"Private nonprofit, 4-year or above",2,10,7,90635,74304,164939,90635,74304,164939,Basketball
62919,2018,195304,Sarah Lawrence College,Bronxville,NY,10708,7,NCAA Division III without football,364,993,1357,2,"Private nonprofit, 4-year or above",2,15,11,85992,79038,165030,85992,79038,165030,Basketball
106170,2019,195304,Sarah Lawrence College,Bronxville,NY,10708,7,NCAA Division III without football,342,1012,1354,2,"Private nonprofit, 4-year or above",2,17,10,81491,75910,157401,81491,75910,157401,Basketball
3418,2015,140960,Savannah State University,Savannah,GA,314045310,2,NCAA Division I-FCS,1679,2351,4030,1,"Public, 4-year or above",2,16,18,676064,570652,1246716,752761,641276,1394037,Basketball
20787,2016,140960,Savannah State University,Savannah,GA,31404,2,NCAA Division I-FCS,1665,2443,4108,1,"Public, 4-year or above",2,18,16,810801,685482,1496283,810801,685482,1496283,Basketball
38246,2017,140960,Savannah State University,Savannah,GA,31404,2,NCAA Division I-FCS,1476,2168,3644,1,"Public, 4-year or above",2,17,18,836012,703925,1539937,806389,640216,1446605,Basketball
55899,2018,140960,Savannah State University,Savannah,GA,31404,2,NCAA Division I-FCS,1309,1986,3295,1,"Public, 4-year or above",2,16,14,629174,504024,1133198,581988,410708,992696,Basketball
82618,2019,140960,Savannah State University,Savannah,GA,31404,4,NCAA Division II with football,1139,1822,2961,1,"Public, 4-year or above",2,20,18,348944,308888,657832,348944,308888,657832,Basketball
15066,2015,228042,Schreiner University,Kerrville,TX,780285697,7,NCAA Division III without football,439,606,1045,2,"Private nonprofit, 4-year or above",2,33,22,154448,154929,309377,132003,124868,256871,Basketball
32535,2016,228042,Schreiner University,Kerrville,TX,78028,7,NCAA Division III without football,450,579,1029,2,"Private nonprofit, 4-year or above",2,33,18,184421,121180,305601,160152,111325,271477,Basketball
50061,2017,228042,Schreiner University,Kerrville,TX,78028,7,NCAA Division III without football,480,620,1100,2,"Private nonprofit, 4-year or above",2,37,18,145179,111456,256635,145179,111456,256635,Basketball
67838,2018,228042,Schreiner University,Kerrville,TX,78028,7,NCAA Division III without football,504,576,1080,2,"Private nonprofit, 4-year or above",2,33,12,178904,125641,304545,178904,125641,304545,Basketball
123478,2019,228042,Schreiner University,Kerrville,TX,78028,7,NCAA Division III without football,486,576,1062,2,"Private nonprofit, 4-year or above",2,35,17,209182,154203,363385,182720,131689,314409,Basketball
16115,2015,236577,Seattle Pacific University,Seattle,WA,981191997,5,NCAA Division II without football,994,2085,3079,2,"Private nonprofit, 4-year or above",2,16,16,959931,775895,1735826,930444,780916,1711360,Basketball
33589,2016,236577,Seattle Pacific University,Seattle,WA,98119,5,NCAA Division II without football,966,2029,2995,2,"Private nonprofit, 4-year or above",2,16,17,903310,805075,1708385,890589,797861,1688450,Basketball
51144,2017,236577,Seattle Pacific University,Seattle,WA,98119,5,NCAA Division II without football,922,1861,2783,2,"Private nonprofit, 4-year or above",2,14,17,904039,827030,1731069,924122,875567,1799689,Basketball
68891,2018,236577,Seattle Pacific University,Seattle,WA,98119,5,NCAA Division II without football,916,1865,2781,2,"Private nonprofit, 4-year or above",2,15,18,1022376,833395,1855771,972368,833395,1805763,Basketball
127289,2019,236577,Seattle Pacific University,Seattle,WA,98119,5,NCAA Division II without football,867,1768,2635,2,"Private nonprofit, 4-year or above",2,15,13,970652,782858,1753510,956912,769549,1726461,Basketball
16122,2015,236595,Seattle University,Seattle,WA,981224340,3,NCAA Division I without football,1748,2653,4401,2,"Private nonprofit, 4-year or above",2,13,15,3413715,1810074,5223789,3413715,1810074,5223789,Basketball
33596,2016,236595,Seattle University,Seattle,WA,981221090,3,NCAA Division I without football,1738,2725,4463,2,"Private nonprofit, 4-year or above",2,17,16,3477443,1778047,5255490,3477443,1778047,5255490,Basketball
51151,2017,236595,Seattle University,Seattle,WA,98122,3,NCAA Division I without football,1650,2674,4324,2,"Private nonprofit, 4-year or above",2,18,15,2993341,1770450,4763791,2993341,1770450,4763791,Basketball
68898,2018,236595,Seattle University,Seattle,WA,98122,3,NCAA Division I without football,1748,2721,4469,2,"Private nonprofit, 4-year or above",2,16,16,2681442,1761309,4442751,2681442,1761309,4442751,Basketball
127327,2019,236595,Seattle University,Seattle,WA,98122,3,NCAA Division I without football,1729,2680,4409,2,"Private nonprofit, 4-year or above",2,18,16,2774167,1952670,4726837,2986940,1986812,4973752,Basketball
9210,2015,186584,Seton Hall University,South Orange,NJ,70792697,3,NCAA Division I without football,2468,3104,5572,2,"Private nonprofit, 4-year or above",2,14,16,6264583,2995632,9260215,6264583,2995632,9260215,Basketball
26632,2016,186584,Seton Hall University,South Orange,NJ,7079,3,NCAA Division I without football,2468,3016,5484,2,"Private nonprofit, 4-year or above",2,15,17,6011447,2849311,8860758,6011447,2849311,8860758,Basketball
44127,2017,186584,Seton Hall University,South Orange,NJ,7079,3,NCAA Division I without football,2531,3016,5547,2,"Private nonprofit, 4-year or above",2,15,14,6301138,2813491,9114629,6301138,2813491,9114629,Basketball
61847,2018,186584,Seton Hall University,South Orange,NJ,7079,3,NCAA Division I without football,2678,3093,5771,2,"Private nonprofit, 4-year or above",2,14,16,7506127,3038044,10544171,7506127,3038044,10544171,Basketball
102684,2019,186584,Seton Hall University,South Orange,NJ,7079,3,NCAA Division I without football,2727,3053,5780,2,"Private nonprofit, 4-year or above",2,14,16,8039631,3013377,11053008,8039631,3013377,11053008,Basketball
13529,2015,215947,Seton Hill University,Greensburg,PA,15601,4,NCAA Division II with football,519,953,1472,2,"Private nonprofit, 4-year or above",2,18,15,544739,544918,1089657,544739,544919,1089658,Basketball
30988,2016,215947,Seton Hill University,Greensburg,PA,15601,4,NCAA Division II with football,518,964,1482,2,"Private nonprofit, 4-year or above",2,17,16,577011,497907,1074918,577011,497907,1074918,Basketball
48500,2017,215947,Seton Hill University,Greensburg,PA,15601,4,NCAA Division II with football,550,999,1549,2,"Private nonprofit, 4-year or above",2,17,17,600438,568772,1169210,600438,568772,1169210,Basketball
66242,2018,215947,Seton Hill University,Greensburg,PA,15601,4,NCAA Division II with football,564,1006,1570,2,"Private nonprofit, 4-year or above",2,13,15,505928,493566,999494,505927,493566,999493,Basketball
117399,2019,215947,Seton Hill University,Greensburg,PA,15601,4,NCAA Division II with football,547,1024,1571,2,"Private nonprofit, 4-year or above",2,14,15,489257,482051,971308,489257,482050,971307,Basketball
14511,2015,221519,Sewanee-The University of the South,Sewanee,TN,373831000,6,NCAA Division III with football,806,875,1681,2,"Private nonprofit, 4-year or above",2,19,13,205681,162046,367727,205681,162046,367727,Basketball
31976,2016,221519,Sewanee-The University of the South,Sewanee,TN,37383,6,NCAA Division III with football,813,900,1713,2,"Private nonprofit, 4-year or above",2,18,12,229001,175143,404144,213839,175143,388982,Basketball
49496,2017,221519,Sewanee-The University of the South,Sewanee,TN,37383,6,NCAA Division III with football,797,886,1683,2,"Private nonprofit, 4-year or above",2,18,12,200343,160931,361274,200343,160931,361274,Basketball
67266,2018,221519,Sewanee-The University of the South,Sewanee,TN,37383,6,NCAA Division III with football,814,861,1675,2,"Private nonprofit, 4-year or above",2,18,15,197403,177179,374582,197403,177179,374582,Basketball
11214,2015,199643,Shaw University,Raleigh,NC,27601,4,NCAA Division II with football,610,797,1407,2,"Private nonprofit, 4-year or above",2,17,14,506184,558648,1064832,506184,558648,1064832,Basketball
28652,2016,199643,Shaw University,Raleigh,NC,27601,4,NCAA Division II with football,700,904,1604,2,"Private nonprofit, 4-year or above",2,16,14,565687,642662,1208349,565687,642662,1208349,Basketball
46154,2017,199643,Shaw University,Raleigh,NC,27601,4,NCAA Division II with football,613,853,1466,2,"Private nonprofit, 4-year or above",2,17,11,550702,636426,1187128,550702,636426,1187128,Basketball
63876,2018,199643,Shaw University,Raleigh,NC,27601,4,NCAA Division II with football,530,716,1246,2,"Private nonprofit, 4-year or above",2,16,13,596826,624100,1220926,596826,624100,1220926,Basketball
109274,2019,199643,Shaw University,Raleigh,NC,27601,4,NCAA Division II with football,447,635,1082,2,"Private nonprofit, 4-year or above",2,18,13,523191,613673,1136864,523191,613673,1136864,Basketball
15851,2015,233541,Shenandoah University,Winchester,VA,226015195,6,NCAA Division III with football,787,1140,1927,2,"Private nonprofit, 4-year or above",2,23,13,205229,165826,371055,205229,165826,371055,Basketball
33325,2016,233541,Shenandoah University,Winchester,VA,22601,6,NCAA Division III with football,813,1203,2016,2,"Private nonprofit, 4-year or above",2,20,15,242400,173309,415709,242400,173309,415709,Basketball
50874,2017,233541,Shenandoah University,Winchester,VA,22601,6,NCAA Division III with football,797,1194,1991,2,"Private nonprofit, 4-year or above",2,17,12,214172,187974,402146,214172,187974,402146,Basketball
68622,2018,233541,Shenandoah University,Winchester,VA,22601,6,NCAA Division III with football,795,1171,1966,2,"Private nonprofit, 4-year or above",2,16,18,208453,184838,393291,208453,184838,393291,Basketball
126157,2019,233541,Shenandoah University,Winchester,VA,22601,6,NCAA Division III with football,801,1188,1989,2,"Private nonprofit, 4-year or above",2,17,15,246556,185941,432497,246556,185941,432497,Basketball
16358,2015,237792,Shepherd University,Shepherdstown,WV,25443,4,NCAA Division II with football,1219,1715,2934,1,"Public, 4-year or above",2,11,13,319736,351897,671633,316886,349712,666598,Basketball
33833,2016,237792,Shepherd University,Shepherdstown,WV,25443,4,NCAA Division II with football,1101,1596,2697,1,"Public, 4-year or above",2,13,14,334041,366254,700295,329001,361182,690183,Basketball
51387,2017,237792,Shepherd University,Shepherdstown,WV,25443,4,NCAA Division II with football,1088,1523,2611,1,"Public, 4-year or above",2,11,14,337859,333882,671741,333728,329089,662817,Basketball
69132,2018,237792,Shepherd University,Shepherdstown,WV,25443,4,NCAA Division II with football,1059,1483,2542,1,"Public, 4-year or above",2,13,13,373181,335754,708935,369461,331978,701439,Basketball
128280,2019,237792,Shepherd University,Shepherdstown,WV,25443,4,NCAA Division II with football,983,1371,2354,1,"Public, 4-year or above",2,12,13,344559,317161,661720,334258,307154,641412,Basketball
13542,2015,216010,Shippensburg University of Pennsylvania,Shippensburg,PA,172572299,4,NCAA Division II with football,2861,2787,5648,1,"Public, 4-year or above",2,15,15,387688,423346,811034,387688,423346,811034,Basketball
31001,2016,216010,Shippensburg University of Pennsylvania,Shippensburg,PA,17257,4,NCAA Division II with football,2798,2734,5532,1,"Public, 4-year or above",2,15,16,503239,439026,942265,503239,439026,942265,Basketball
48513,2017,216010,Shippensburg University of Pennsylvania,Shippensburg,PA,17257,4,NCAA Division II with football,2546,2599,5145,1,"Public, 4-year or above",2,15,15,488803,479194,967997,488803,479194,967997,Basketball
66255,2018,216010,Shippensburg University of Pennsylvania,Shippensburg,PA,172572299,4,NCAA Division II with football,2437,2569,5006,1,"Public, 4-year or above",2,15,15,446175,470323,916498,446175,470323,916498,Basketball
117437,2019,216010,Shippensburg University of Pennsylvania,Shippensburg,PA,172572299,4,NCAA Division II with football,2347,2496,4843,1,"Public, 4-year or above",2,15,15,471195,496731,967926,471195,496731,967926,Basketball
3428,2015,140988,Shorter University,Rome,GA,30165,4,NCAA Division II with football,534,670,1204,2,"Private nonprofit, 4-year or above",2,16,16,436147,471032,907179,436147,471032,907179,Basketball
20797,2016,140988,Shorter University,Rome,GA,30165,4,NCAA Division II with football,566,646,1212,2,"Private nonprofit, 4-year or above",2,38,16,503151,436186,939337,503151,436186,939337,Basketball
38256,2017,140988,Shorter University,Rome,GA,30165,4,NCAA Division II with football,502,632,1134,2,"Private nonprofit, 4-year or above",2,17,21,362155,409594,771749,362155,409594,771749,Basketball
55909,2018,140988,Shorter University,Rome,GA,30165,4,NCAA Division II with football,470,603,1073,2,"Private nonprofit, 4-year or above",2,17,13,369452,347005,716457,369452,347005,716457,Basketball
82628,2019,140988,Shorter University,Rome,GA,30165,4,NCAA Division II with football,507,595,1102,2,"Private nonprofit, 4-year or above",2,27,15,379345,302630,681975,379345,302630,681975,Basketball
10314,2015,195474,Siena College,Loudonville,NY,122111462,3,NCAA Division I without football,1455,1536,2991,2,"Private nonprofit, 4-year or above",2,16,13,3083128,1544049,4627177,3083128,1544049,4627177,Basketball
27736,2016,195474,Siena College,Loudonville,NY,12211,3,NCAA Division I without football,1470,1590,3060,2,"Private nonprofit, 4-year or above",2,15,14,3102278,1726019,4828297,3102278,1726019,4828297,Basketball
45224,2017,195474,Siena College,Loudonville,NY,12211,3,NCAA Division I without football,1419,1617,3036,2,"Private nonprofit, 4-year or above",2,14,13,3579394,1839383,5418777,3579394,1839383,5418777,Basketball
62933,2018,195474,Siena College,Loudonville,NY,12211,3,NCAA Division I without football,1356,1690,3046,2,"Private nonprofit, 4-year or above",2,16,15,3219292,1791641,5010933,3219292,1791641,5010933,Basketball
106246,2019,195474,Siena College,Loudonville,NY,12211,3,NCAA Division I without football,1327,1751,3078,2,"Private nonprofit, 4-year or above",2,12,11,2982539,1758000,4740539,2982539,1758000,4740539,Basketball
5019,2015,154350,Simpson College,Indianola,IA,50125,6,NCAA Division III with football,643,775,1418,2,"Private nonprofit, 4-year or above",2,31,23,185860,240845,426705,185860,240845,426705,Basketball
22375,2016,154350,Simpson College,Indianola,IA,50125,6,NCAA Division III with football,605,774,1379,2,"Private nonprofit, 4-year or above",2,31,24,177427,232495,409922,177427,232495,409922,Basketball
39853,2017,154350,Simpson College,Indianola,IA,50125,6,NCAA Division III with football,587,691,1278,2,"Private nonprofit, 4-year or above",2,29,24,192309,221587,413896,192309,221587,413896,Basketball
57522,2018,154350,Simpson College,Indianola,IA,50125,6,NCAA Division III with football,581,671,1252,2,"Private nonprofit, 4-year or above",2,34,26,196071,215407,411478,196071,215407,411478,Basketball
88317,2019,154350,Simpson College,Indianola,IA,50125,6,NCAA Division III with football,542,617,1159,2,"Private nonprofit, 4-year or above",2,29,24,208262,210826,419088,208262,210826,419088,Basketball
10326,2015,195526,Skidmore College,Saratoga Springs,NY,12866,7,NCAA Division III without football,1016,1585,2601,2,"Private nonprofit, 4-year or above",2,15,14,148695,110820,259515,145684,109381,255065,Basketball
27750,2016,195526,Skidmore College,Saratoga Springs,NY,12866,7,NCAA Division III without football,1050,1587,2637,2,"Private nonprofit, 4-year or above",2,14,15,155660,117531,273191,155660,117530,273190,Basketball
45238,2017,195526,Skidmore College,Saratoga Springs,NY,12866,7,NCAA Division III without football,1061,1568,2629,2,"Private nonprofit, 4-year or above",2,14,12,144592,127038,271630,144592,127038,271630,Basketball
62946,2018,195526,Skidmore College,Saratoga Springs,NY,12866,7,NCAA Division III without football,1001,1579,2580,2,"Private nonprofit, 4-year or above",2,13,12,147816,110731,258547,147816,110731,258547,Basketball
106259,2019,195526,Skidmore College,Saratoga Springs,NY,12866,7,NCAA Division III without football,1061,1556,2617,2,"Private nonprofit, 4-year or above",2,12,10,130705,103732,234437,130705,103732,234437,Basketball
13554,2015,216038,Slippery Rock University of Pennsylvania,Slippery Rock,PA,160571383,4,NCAA Division II with football,3081,3914,6995,1,"Public, 4-year or above",2,16,16,411781,460013,871794,388065,460013,848078,Basketball
31013,2016,216038,Slippery Rock University of Pennsylvania,Slippery Rock,PA,16057,4,NCAA Division II with football,3137,3979,7116,1,"Public, 4-year or above",2,13,17,449031,482714,931745,449031,474242,923273,Basketball
48525,2017,216038,Slippery Rock University of Pennsylvania,Slippery Rock,PA,16057,4,NCAA Division II with football,3130,3967,7097,1,"Public, 4-year or above",2,16,15,404751,481587,886338,470901,431969,902870,Basketball
66267,2018,216038,Slippery Rock University of Pennsylvania,Slippery Rock,PA,16057,4,NCAA Division II with football,3138,3867,7005,1,"Public, 4-year or above",2,16,17,435274,488859,924133,459205,455845,915050,Basketball
117475,2019,216038,Slippery Rock University of Pennsylvania,Slippery Rock,PA,16057,4,NCAA Division II with football,3110,3841,6951,1,"Public, 4-year or above",2,16,16,313544,316457,630001,453121,487691,940812,Basketball
2031,2015,123572,Sonoma State University,Rohnert Park,CA,949283609,5,NCAA Division II without football,2880,4925,7805,1,"Public, 4-year or above",2,16,17,456513,335181,791694,456513,335181,791694,Basketball
19396,2016,123572,Sonoma State University,Rohnert Park,CA,94928,5,NCAA Division II without football,2800,4993,7793,1,"Public, 4-year or above",2,18,16,486104,383835,869939,486104,383835,869939,Basketball
36832,2017,123572,Sonoma State University,Rohnert Park,CA,94928,5,NCAA Division II without football,2910,4967,7877,1,"Public, 4-year or above",2,17,17,402684,416190,818874,402684,344343,747027,Basketball
54467,2018,123572,Sonoma State University,Rohnert Park,CA,94928,5,NCAA Division II without football,3022,4849,7871,1,"Public, 4-year or above",2,17,15,438311,421108,859419,438311,421108,859419,Basketball
77645,2019,123572,Sonoma State University,Rohnert Park,CA,94928,5,NCAA Division II without football,2766,4642,7408,1,"Public, 4-year or above",2,17,16,468372,440843,909215,468372,440843,909215,Basketball
14132,2015,218733,South Carolina State University,Orangeburg,SC,291170001,2,NCAA Division I-FCS,1100,1123,2223,1,"Public, 4-year or above",2,14,12,1208555,556984,1765539,806005,749731,1555736,Basketball
31590,2016,218733,South Carolina State University,Orangeburg,SC,29117,2,NCAA Division I-FCS,1146,1135,2281,1,"Public, 4-year or above",2,17,10,909141,675147,1584288,664303,675147,1339450,Basketball
49106,2017,218733,South Carolina State University,Orangeburg,SC,29117,2,NCAA Division I-FCS,1171,1110,2281,1,"Public, 4-year or above",2,17,11,720318,778927,1499245,720318,778927,1499245,Basketball
66868,2018,218733,South Carolina State University,Orangeburg,SC,29117,2,NCAA Division I-FCS,1069,1083,2152,1,"Public, 4-year or above",2,18,17,785619,697329,1482948,785619,697329,1482948,Basketball
119326,2019,218733,South Carolina State University,Orangeburg,SC,29117,2,NCAA Division I-FCS,913,1045,1958,1,"Public, 4-year or above",2,18,15,847152,736523,1583675,737913,739162,1477075,Basketball
14236,2015,219347,South Dakota School of Mines and Technology,Rapid City,SD,577013995,4,NCAA Division II with football,1883,476,2359,1,"Public, 4-year or above",2,16,14,358663,334622,693285,331674,323672,655346,Basketball
31695,2016,219347,South Dakota School of Mines and Technology,Rapid City,SD,57701,4,NCAA Division II with football,1604,401,2005,1,"Public, 4-year or above",2,18,16,392780,351283,744063,385158,349951,735109,Basketball
49211,2017,219347,South Dakota School of Mines and Technology,Rapid City,SD,57701,4,NCAA Division II with football,1571,416,1987,1,"Public, 4-year or above",2,16,16,375811,401149,776960,366645,394330,760975,Basketball
66978,2018,219347,South Dakota School of Mines and Technology,Rapid City,SD,57701,4,NCAA Division II with football,1451,414,1865,1,"Public, 4-year or above",2,17,12,535497,403958,939455,528664,403958,932622,Basketball
119716,2019,219347,South Dakota School of Mines and Technology,Rapid City,SD,57701,4,NCAA Division II with football,1434,427,1861,1,"Public, 4-year or above",2,14,14,495202,479616,974818,517867,455632,973499,Basketball
14243,2015,219356,South Dakota State University,Brookings,SD,570071898,2,NCAA Division I-FCS,4212,4323,8535,1,"Public, 4-year or above",2,16,14,1443001,1179724,2622725,1443001,1179724,2622725,Basketball
31704,2016,219356,South Dakota State University,Brookings,SD,57007,2,NCAA Division I-FCS,4180,4262,8442,1,"Public, 4-year or above",2,14,15,1656066,1379137,3035203,1656066,1379137,3035203,Basketball
49218,2017,219356,South Dakota State University,Brookings,SD,57007,2,NCAA Division I-FCS,4223,4186,8409,1,"Public, 4-year or above",2,15,15,1991489,1459991,3451480,1991489,1459991,3451480,Basketball
66985,2018,219356,South Dakota State University,Brookings,SD,57007,2,NCAA Division I-FCS,4035,4127,8162,1,"Public, 4-year or above",2,14,14,2177776,1584178,3761954,2177776,1584178,3761954,Basketball
119754,2019,219356,South Dakota State University,Brookings,SD,57007,2,NCAA Division I-FCS,3917,4044,7961,1,"Public, 4-year or above",2,14,14,1921465,1501371,3422836,1921465,1501371,3422836,Basketball
8392,2015,179557,Southeast Missouri State University,Cape Girardeau,MO,63701,2,NCAA Division I-FCS,3435,4286,7721,1,"Public, 4-year or above",2,14,22,1192809,892346,2085155,1192809,892346,2085155,Basketball
25826,2016,179557,Southeast Missouri State University,Cape Girardeau,MO,63701,2,NCAA Division I-FCS,3334,4387,7721,1,"Public, 4-year or above",2,15,24,1291470,939588,2231058,1291470,939588,2231058,Basketball
43316,2017,179557,Southeast Missouri State University,Cape Girardeau,MO,63701,2,NCAA Division I-FCS,3261,4378,7639,1,"Public, 4-year or above",2,14,26,1283062,987528,2270590,1283062,987528,2270590,Basketball
61035,2018,179557,Southeast Missouri State University,Cape Girardeau,MO,63701,2,NCAA Division I-FCS,3022,4180,7202,1,"Public, 4-year or above",2,16,23,1304144,968718,2272862,1304144,968718,2272862,Basketball
99898,2019,179557,Southeast Missouri State University,Cape Girardeau,MO,63701,2,NCAA Division I-FCS,2862,4194,7056,1,"Public, 4-year or above",2,15,19,1391207,960278,2351485,1391207,960278,2351485,Basketball
5842,2015,160612,Southeastern Louisiana University,Hammond,LA,70402,2,NCAA Division I-FCS,3682,5886,9568,1,"Public, 4-year or above",2,19,14,978938,919426,1898364,978939,919426,1898365,Basketball
23226,2016,160612,Southeastern Louisiana University,Hammond,LA,70402,2,NCAA Division I-FCS,3461,5549,9010,1,"Public, 4-year or above",2,16,15,1195047,953911,2148958,1195047,953911,2148958,Basketball
40724,2017,160612,Southeastern Louisiana University,Hammond,LA,70402,2,NCAA Division I-FCS,3424,5567,8991,1,"Public, 4-year or above",2,16,15,1081185,784552,1865737,1081185,784552,1865737,Basketball
58408,2018,160612,Southeastern Louisiana University,Hammond,LA,70402,2,NCAA Division I-FCS,3453,5734,9187,1,"Public, 4-year or above",2,17,15,1172241,912977,2085218,1172241,912977,2085218,Basketball
91092,2019,160612,Southeastern Louisiana University,Hammond,LA,70402,2,NCAA Division I-FCS,3488,5752,9240,1,"Public, 4-year or above",2,15,15,1109682,902660,2012342,1109682,902660,2012342,Basketball
12236,2015,207847,Southeastern Oklahoma State University,Durant,OK,747013347,4,NCAA Division II with football,1172,1286,2458,1,"Public, 4-year or above",2,19,15,334251,320154,654405,334251,320154,654405,Basketball
29678,2016,207847,Southeastern Oklahoma State University,Durant,OK,74701,4,NCAA Division II with football,1171,1234,2405,1,"Public, 4-year or above",2,20,15,372732,343608,716340,372732,343608,716340,Basketball
47174,2017,207847,Southeastern Oklahoma State University,Durant,OK,74701,4,NCAA Division II with football,1177,1191,2368,1,"Public, 4-year or above",2,16,15,338972,340619,679591,338972,340619,679591,Basketball
64918,2018,207847,Southeastern Oklahoma State University,Durant,OK,74701,4,NCAA Division II with football,1156,1266,2422,1,"Public, 4-year or above",2,18,14,417379,371627,789006,417379,371627,789006,Basketball
113033,2019,207847,Southeastern Oklahoma State University,Durant,OK,74701,4,NCAA Division II with football,1163,1226,2389,1,"Public, 4-year or above",2,17,15,419597,342995,762592,419597,342995,762592,Basketball
617,2015,107983,Southern Arkansas University Main Campus,Magnolia,AR,71753,4,NCAA Division II with football,1186,1477,2663,1,"Public, 4-year or above",2,16,15,311272,246297,557569,311272,246297,557569,Basketball
17965,2016,107983,Southern Arkansas University Main Campus,Magnolia,AR,71753,4,NCAA Division II with football,1292,1524,2816,1,"Public, 4-year or above",2,15,18,289949,296199,586148,289949,296199,586148,Basketball
35397,2017,107983,Southern Arkansas University Main Campus,Magnolia,AR,71753,4,NCAA Division II with football,1374,1542,2916,1,"Public, 4-year or above",2,17,11,303950,296129,600079,303950,296129,600079,Basketball
53018,2018,107983,Southern Arkansas University Main Campus,Magnolia,AR,71753,4,NCAA Division II with football,1355,1642,2997,1,"Public, 4-year or above",2,17,17,328340,300353,628693,328340,300353,628693,Basketball
72948,2019,107983,Southern Arkansas University Main Campus,Magnolia,AR,71753,4,NCAA Division II with football,1344,1644,2988,1,"Public, 4-year or above",2,16,15,186591,169454,356045,328055,314350,642405,Basketball
2479,2015,130493,Southern Connecticut State University,New Haven,CT,65151355,4,NCAA Division II with football,2596,4273,6869,1,"Public, 4-year or above",2,14,17,454308,520033,974341,454308,520033,974341,Basketball
19849,2016,130493,Southern Connecticut State University,New Haven,CT,6515,4,NCAA Division II with football,2555,4275,6830,1,"Public, 4-year or above",2,16,17,521401,546363,1067764,521401,546363,1067764,Basketball
37288,2017,130493,Southern Connecticut State University,New Haven,CT,6515,4,NCAA Division II with football,2672,4142,6814,1,"Public, 4-year or above",2,15,18,505101,517758,1022859,505101,517758,1022859,Basketball
54925,2018,130493,Southern Connecticut State University,New Haven,CT,6515,4,NCAA Division II with football,2667,4187,6854,1,"Public, 4-year or above",2,15,14,639658,622501,1262159,639658,622501,1262159,Basketball
79181,2019,130493,Southern Connecticut State University,New Haven,CT,6515,4,NCAA Division II with football,2629,4161,6790,1,"Public, 4-year or above",2,15,13,596883,682639,1279522,596883,682639,1279522,Basketball
4223,2015,149222,Southern Illinois University-Carbondale,Carbondale,IL,629014512,2,NCAA Division I-FCS,6069,5186,11255,1,"Public, 4-year or above",2,16,14,2241413,1278969,3520382,2241413,1278969,3520382,Basketball
21597,2016,149222,Southern Illinois University-Carbondale,Carbondale,IL,62901,2,NCAA Division I-FCS,5652,4857,10509,1,"Public, 4-year or above",2,15,13,2093251,1203693,3296944,2093251,1203693,3296944,Basketball
39062,2017,149222,Southern Illinois University-Carbondale,Carbondale,IL,62901,2,NCAA Division I-FCS,4983,4429,9412,1,"Public, 4-year or above",2,13,14,2127894,1382276,3510170,2127894,1382276,3510170,Basketball
56719,2018,149222,Southern Illinois University-Carbondale,Carbondale,IL,629016899,2,NCAA Division I-FCS,4300,3740,8040,1,"Public, 4-year or above",2,14,15,2482549,1393521,3876070,2482549,1393521,3876070,Basketball
85591,2019,149222,Southern Illinois University-Carbondale,Carbondale,IL,629016899,2,NCAA Division I-FCS,3769,3361,7130,1,"Public, 4-year or above",2,14,14,3120987,1333533,4454520,3120987,1333533,4454520,Basketball
4232,2015,149231,Southern Illinois University-Edwardsville,Edwardsville,IL,620261259,3,NCAA Division I without football,4641,5280,9921,1,"Public, 4-year or above",2,14,13,1097263,797026,1894289,1025625,799967,1825592,Basketball
21606,2016,149231,Southern Illinois University-Edwardsville,Edwardsville,IL,62026,3,NCAA Division I without football,4712,5171,9883,1,"Public, 4-year or above",2,15,13,1306501,930631,2237132,1106537,921110,2027647,Basketball
39070,2017,149231,Southern Illinois University-Edwardsville,Edwardsville,IL,62026,3,NCAA Division I without football,4544,4982,9526,1,"Public, 4-year or above",2,13,15,1409424,992122,2401546,1271688,1001268,2272956,Basketball
56727,2018,149231,Southern Illinois University-Edwardsville,Edwardsville,IL,62026,3,NCAA Division I without football,4296,4670,8966,1,"Public, 4-year or above",2,16,21,1348897,1083416,2432313,1342465,1065666,2408131,Basketball
85604,2019,149231,Southern Illinois University-Edwardsville,Edwardsville,IL,62026,3,NCAA Division I without football,4048,4551,8599,1,"Public, 4-year or above",2,16,13,1318279,959919,2278198,1318279,959919,2278198,Basketball
15083,2015,228246,Southern Methodist University,Dallas,TX,752750221,1,NCAA Division I-FBS,3061,3095,6156,2,"Private nonprofit, 4-year or above",2,12,24,7086547,3217719,10304266,7086547,3217719,10304266,Basketball
32552,2016,228246,Southern Methodist University,Dallas,TX,75275,1,NCAA Division I-FBS,3132,3162,6294,2,"Private nonprofit, 4-year or above",2,13,17,7269481,3549466,10818947,7269481,3549466,10818947,Basketball
50078,2017,228246,Southern Methodist University,Dallas,TX,75275,1,NCAA Division I-FBS,3146,3089,6235,2,"Private nonprofit, 4-year or above",2,13,14,7497541,3728980,11226521,7497541,3728980,11226521,Basketball
67856,2018,228246,Southern Methodist University,Dallas,TX,75275,1,NCAA Division I-FBS,3206,3067,6273,2,"Private nonprofit, 4-year or above",2,15,14,7590481,3715222,11305703,7590481,3715222,11305703,Basketball
123591,2019,228246,Southern Methodist University,Dallas,TX,75275,1,NCAA Division I-FBS,3314,3202,6516,2,"Private nonprofit, 4-year or above",2,14,12,7373594,3429479,10803073,7373594,3429479,10803073,Basketball
12045,2015,206862,Southern Nazarene University,Bethany,OK,73008,4,NCAA Division II with football,771,831,1602,2,"Private nonprofit, 4-year or above",2,33,21,653282,539342,1192624,566730,531586,1098316,Basketball
29486,2016,206862,Southern Nazarene University,Bethany,OK,73008,4,NCAA Division II with football,729,827,1556,2,"Private nonprofit, 4-year or above",2,32,19,607238,496481,1103719,610325,496482,1106807,Basketball
46990,2017,206862,Southern Nazarene University,Bethany,OK,73008,4,NCAA Division II with football,740,743,1483,2,"Private nonprofit, 4-year or above",2,33,19,630073,632515,1262588,603769,632515,1236284,Basketball
64734,2018,206862,Southern Nazarene University,Bethany,OK,73008,4,NCAA Division II with football,757,771,1528,2,"Private nonprofit, 4-year or above",2,35,20,855959,738535,1594494,708713,637153,1345866,Basketball
112240,2019,206862,Southern Nazarene University,Bethany,OK,73008,4,NCAA Division II with football,654,672,1326,2,"Private nonprofit, 4-year or above",2,25,23,777250,614242,1391492,672175,589390,1261565,Basketball
8821,2015,183026,Southern New Hampshire University,Manchester,NH,31061045,5,NCAA Division II without football,7574,12359,19933,2,"Private nonprofit, 4-year or above",2,12,15,795366,647998,1443364,795366,647998,1443364,Basketball
26248,2016,183026,Southern New Hampshire University,Manchester,NH,3106,5,NCAA Division II without football,8755,13019,21774,2,"Private nonprofit, 4-year or above",2,14,14,707585,644917,1352502,707585,644917,1352502,Basketball
43745,2017,183026,Southern New Hampshire University,Manchester,NH,3106,5,NCAA Division II without football,7814,12078,19892,2,"Private nonprofit, 4-year or above",2,14,15,1413056,1232611,2645667,1413056,1232611,2645667,Basketball
61461,2018,183026,Southern New Hampshire University,Manchester,NH,3106,5,NCAA Division II without football,9308,15218,24526,2,"Private nonprofit, 4-year or above",2,17,16,751622,611676,1363298,751622,611676,1363298,Basketball
101412,2019,183026,Southern New Hampshire University,Manchester,NH,3106,5,NCAA Division II without football,10307,17028,27335,2,"Private nonprofit, 4-year or above",2,13,13,680595,575082,1255677,680595,575082,1255677,Basketball
5851,2015,160621,Southern University and A & M College,Baton Rouge,LA,70813,2,NCAA Division I-FCS,1678,2953,4631,1,"Public, 4-year or above",2,16,14,883227,708652,1591879,883227,708652,1591879,Basketball
23235,2016,160621,Southern University and A & M College,Baton Rouge,LA,70813,2,NCAA Division I-FCS,1554,2774,4328,1,"Public, 4-year or above",2,18,14,899950,707795,1607745,899950,707795,1607745,Basketball
40733,2017,160621,Southern University and A & M College,Baton Rouge,LA,70813,2,NCAA Division I-FCS,1644,2876,4520,1,"Public, 4-year or above",2,20,17,475243,212434,687677,776243,803783,1580026,Basketball
58417,2018,160621,Southern University and A & M College,Baton Rouge,LA,70813,2,NCAA Division I-FCS,1765,3097,4862,1,"Public, 4-year or above",2,14,16,596992,344407,941399,815704,807328,1623032,Basketball
91130,2019,160621,Southern University and A & M College,Baton Rouge,LA,70813,2,NCAA Division I-FCS,1690,3183,4873,1,"Public, 4-year or above",2,18,16,825043,874846,1699889,825043,874846,1699889,Basketball
15398,2015,230603,Southern Utah University,Cedar City,UT,84720,2,NCAA Division I-FCS,2502,2894,5396,1,"Public, 4-year or above",2,17,13,1181384,685005,1866389,1111575,805832,1917407,Basketball
32861,2016,230603,Southern Utah University,Cedar City,UT,84720,2,NCAA Division I-FCS,2545,3056,5601,1,"Public, 4-year or above",2,15,13,1366625,787311,2153936,1296633,929103,2225736,Basketball
50394,2017,230603,Southern Utah University,Cedar City,UT,84720,2,NCAA Division I-FCS,2760,3299,6059,1,"Public, 4-year or above",2,14,13,1324816,969262,2294078,1324816,969262,2294078,Basketball
68169,2018,230603,Southern Utah University,Cedar City,UT,84720,2,NCAA Division I-FCS,2962,3673,6635,1,"Public, 4-year or above",2,18,13,1274977,766798,2041775,1301285,1023140,2324425,Basketball
124755,2019,230603,Southern Utah University,Cedar City,UT,84720,2,NCAA Division I-FCS,3040,3791,6831,1,"Public, 4-year or above",2,14,15,1494194,883747,2377941,1384268,967309,2351577,Basketball
15547,2015,231086,Southern Vermont College,Bennington,VT,52016002,7,NCAA Division III without football,163,256,419,2,"Private nonprofit, 4-year or above",2,16,13,113564,62215,175779,113564,62215,175779,Basketball
33016,2016,231086,Southern Vermont College,Bennington,VT,5201,7,NCAA Division III without football,141,210,351,2,"Private nonprofit, 4-year or above",2,9,9,90656,54742,145398,90656,54742,145398,Basketball
50550,2017,231086,Southern Vermont College,Bennington,VT,5201,7,NCAA Division III without football,144,194,338,2,"Private nonprofit, 4-year or above",2,14,12,101500,57300,158800,107241,42507,149748,Basketball
15862,2015,233611,Southern Virginia University,Buena Vista,VA,24416,6,NCAA Division III with football,363,349,712,2,"Private nonprofit, 4-year or above",2,19,16,137833,98064,235897,137833,98064,235897,Basketball
33336,2016,233611,Southern Virginia University,Buena Vista,VA,24416,6,NCAA Division III with football,367,389,756,2,"Private nonprofit, 4-year or above",2,19,18,142440,116063,258503,142440,116063,258503,Basketball
50885,2017,233611,Southern Virginia University,Buena Vista,VA,24416,6,NCAA Division III with football,435,418,853,2,"Private nonprofit, 4-year or above",2,14,15,146746,113017,259763,146746,113017,259763,Basketball
68633,2018,233611,Southern Virginia University,Buena Vista,VA,24416,6,NCAA Division III with football,438,497,935,2,"Private nonprofit, 4-year or above",2,18,17,145979,145004,290983,145979,145004,290983,Basketball
126195,2019,233611,Southern Virginia University,Buena Vista,VA,24416,6,NCAA Division III with football,484,531,1015,2,"Private nonprofit, 4-year or above",2,20,23,160971,140535,301506,160971,140535,301506,Basketball
13926,2015,217776,Southern Wesleyan University,Central,SC,296301020,5,NCAA Division II without football,504,745,1249,2,"Private nonprofit, 4-year or above",2,15,14,290119,261422,551541,290119,261422,551541,Basketball
31382,2016,217776,Southern Wesleyan University,Central,SC,29630,5,NCAA Division II without football,360,425,785,2,"Private nonprofit, 4-year or above",2,19,18,303820,306045,609865,303820,306045,609865,Basketball
48893,2017,217776,Southern Wesleyan University,Central,SC,29630,5,NCAA Division II without football,375,444,819,2,"Private nonprofit, 4-year or above",2,18,16,337914,307093,645007,337914,307093,645007,Basketball
66651,2018,217776,Southern Wesleyan University,Central,SC,29630,5,NCAA Division II without football,365,445,810,2,"Private nonprofit, 4-year or above",2,20,17,321446,302206,623652,321446,302206,623652,Basketball
118445,2019,217776,Southern Wesleyan University,Central,SC,29630,5,NCAA Division II without football,329,471,800,2,"Private nonprofit, 4-year or above",2,31,19,346833,316697,663530,346833,316697,663530,Basketball
8380,2015,179326,Southwest Baptist University,Bolivar,MO,656132596,4,NCAA Division II with football,722,1159,1881,2,"Private nonprofit, 4-year or above",2,18,17,610205,624165,1234370,569994,505792,1075786,Basketball
25811,2016,179326,Southwest Baptist University,Bolivar,MO,65613,4,NCAA Division II with football,705,1116,1821,2,"Private nonprofit, 4-year or above",2,18,15,540933,539387,1080320,540933,539387,1080320,Basketball
43301,2017,179326,Southwest Baptist University,Bolivar,MO,65613,4,NCAA Division II with football,705,1090,1795,2,"Private nonprofit, 4-year or above",2,17,15,565533,542928,1108461,553703,612738,1166441,Basketball
61020,2018,179326,Southwest Baptist University,Bolivar,MO,65613,4,NCAA Division II with football,675,1076,1751,2,"Private nonprofit, 4-year or above",2,18,16,589185,520106,1109291,589185,520106,1109291,Basketball
99784,2019,179326,Southwest Baptist University,Bolivar,MO,65613,4,NCAA Division II with football,632,1039,1671,2,"Private nonprofit, 4-year or above",2,16,17,590433,567850,1158283,590433,567850,1158283,Basketball
7830,2015,175078,Southwest Minnesota State University,Marshall,MN,562585468,4,NCAA Division II with football,820,1027,1847,1,"Public, 4-year or above",2,18,14,357762,314453,672215,357762,314453,672215,Basketball
25244,2016,175078,Southwest Minnesota State University,Marshall,MN,56258,4,NCAA Division II with football,852,999,1851,1,"Public, 4-year or above",2,14,12,404687,290073,694760,404687,290073,694760,Basketball
42745,2017,175078,Southwest Minnesota State University,Marshall,MN,56258,4,NCAA Division II with football,756,916,1672,1,"Public, 4-year or above",2,14,15,432688,333557,766245,432688,333557,766245,Basketball
60451,2018,175078,Southwest Minnesota State University,Marshall,MN,56258,4,NCAA Division II with football,708,866,1574,1,"Public, 4-year or above",2,15,14,427205,349964,777169,427205,349964,777169,Basketball
97537,2019,175078,Southwest Minnesota State University,Marshall,MN,56258,4,NCAA Division II with football,639,815,1454,1,"Public, 4-year or above",2,14,16,484715,374979,859694,484715,374979,859694,Basketball
12254,2015,207865,Southwestern Oklahoma State University,Weatherford,OK,730963098,4,NCAA Division II with football,1576,1906,3482,1,"Public, 4-year or above",2,19,15,407995,368410,776405,407995,368410,776405,Basketball
29696,2016,207865,Southwestern Oklahoma State University,Weatherford,OK,73096,4,NCAA Division II with football,1615,2043,3658,1,"Public, 4-year or above",2,18,17,357193,352221,709414,357193,352221,709414,Basketball
47192,2017,207865,Southwestern Oklahoma State University,Weatherford,OK,73096,4,NCAA Division II with football,1575,2138,3713,1,"Public, 4-year or above",2,15,17,382346,404150,786496,382346,404150,786496,Basketball
64937,2018,207865,Southwestern Oklahoma State University,Weatherford,OK,73096,4,NCAA Division II with football,1500,2093,3593,1,"Public, 4-year or above",2,16,19,372752,466139,838891,372752,466139,838891,Basketball
113109,2019,207865,Southwestern Oklahoma State University,Weatherford,OK,73096,4,NCAA Division II with football,1358,1969,3327,1,"Public, 4-year or above",2,18,17,380660,419829,800489,380660,419829,800489,Basketball
15103,2015,228343,Southwestern University,Georgetown,TX,78626,6,NCAA Division III with football,645,855,1500,2,"Private nonprofit, 4-year or above",2,16,16,121247,162196,283443,118344,146943,265287,Basketball
32572,2016,228343,Southwestern University,Georgetown,TX,78626,6,NCAA Division III with football,619,845,1464,2,"Private nonprofit, 4-year or above",2,17,18,136313,144283,280596,129332,129659,258991,Basketball
50097,2017,228343,Southwestern University,Georgetown,TX,78626,6,NCAA Division III with football,581,786,1367,2,"Private nonprofit, 4-year or above",2,17,18,161454,164050,325504,151833,152938,304771,Basketball
67875,2018,228343,Southwestern University,Georgetown,TX,78626,6,NCAA Division III with football,636,780,1416,2,"Private nonprofit, 4-year or above",2,17,16,174096,165977,340073,163864,159240,323104,Basketball
123678,2019,228343,Southwestern University,Georgetown,TX,78627,6,NCAA Division III with football,677,818,1495,2,"Private nonprofit, 4-year or above",2,17,17,193360,185687,379047,181440,185143,366583,Basketball
5662,2015,157757,Spalding University,Louisville,KY,402032188,7,NCAA Division III without football,282,642,924,2,"Private nonprofit, 4-year or above",2,19,11,96202,113620,209822,93454,111704,205158,Basketball
23041,2016,157757,Spalding University,Louisville,KY,40203,7,NCAA Division III without football,254,666,920,2,"Private nonprofit, 4-year or above",2,17,16,93071,102292,195363,93071,102292,195363,Basketball
40538,2017,157757,Spalding University,Louisville,KY,40203,7,NCAA Division III without football,255,661,916,2,"Private nonprofit, 4-year or above",2,19,11,85896,113989,199885,85896,113989,199885,Basketball
58220,2018,157757,Spalding University,Louisville,KY,40203,7,NCAA Division III without football,262,585,847,2,"Private nonprofit, 4-year or above",2,22,18,105024,140959,245983,105024,140959,245983,Basketball
90395,2019,157757,Spalding University,Louisville,KY,40203,7,NCAA Division III without football,236,508,744,2,"Private nonprofit, 4-year or above",2,13,10,104382,128374,232756,104382,128374,232756,Basketball
259,2015,102234,Spring Hill College,Mobile,AL,366081791,5,NCAA Division II without football,525,798,1323,2,"Private nonprofit, 4-year or above",2,15,15,419473,428962,848435,419473,428132,847605,Basketball
17607,2016,102234,Spring Hill College,Mobile,AL,36608,5,NCAA Division II without football,502,863,1365,2,"Private nonprofit, 4-year or above",2,17,17,515533,505537,1021070,511513,499076,1010589,Basketball
35019,2017,102234,Spring Hill College,Mobile,AL,36608,5,NCAA Division II without football,502,861,1363,2,"Private nonprofit, 4-year or above",2,17,17,406844,466316,873160,406844,456455,863299,Basketball
52644,2018,102234,Spring Hill College,Mobile,AL,36608,5,NCAA Division II without football,478,763,1241,2,"Private nonprofit, 4-year or above",2,14,17,508537,537651,1046188,483452,528897,1012349,Basketball
71428,2019,102234,Spring Hill College,Mobile,AL,36608,5,NCAA Division II without football,429,714,1143,2,"Private nonprofit, 4-year or above",2,15,21,616081,666790,1282871,592137,651437,1243574,Basketball
6818,2015,167899,Springfield College,Springfield,MA,11093797,6,NCAA Division III with football,1044,1070,2114,2,"Private nonprofit, 4-year or above",2,15,13,208341,199231,407572,208341,199231,407572,Basketball
24209,2016,167899,Springfield College,Springfield,MA,1109,6,NCAA Division III with football,1043,1039,2082,2,"Private nonprofit, 4-year or above",2,12,15,219392,264594,483986,219392,264594,483986,Basketball
41713,2017,167899,Springfield College,Springfield,MA,1109,6,NCAA Division III with football,1109,1071,2180,2,"Private nonprofit, 4-year or above",2,13,13,259359,196744,456103,259359,196744,456103,Basketball
59404,2018,167899,Springfield College,Springfield,MA,1109,6,NCAA Division III with football,1052,1028,2080,2,"Private nonprofit, 4-year or above",2,14,13,243703,208783,452486,243703,208783,452486,Basketball
94248,2019,167899,Springfield College,Springfield,MA,1109,6,NCAA Division III with football,1068,1071,2139,2,"Private nonprofit, 4-year or above",2,16,15,261391,199392,460783,261391,199392,460783,Basketball
10242,2015,195164,St Bonaventure University,Saint Bonaventure,NY,14778,3,NCAA Division I without football,825,795,1620,2,"Private nonprofit, 4-year or above",2,13,19,2896641,1509353,4405994,2917071,1555824,4472895,Basketball
27664,2016,195164,St Bonaventure University,Saint Bonaventure,NY,14778,3,NCAA Division I without football,799,790,1589,2,"Private nonprofit, 4-year or above",2,15,22,3449008,1465954,4914962,3449008,1465954,4914962,Basketball
45151,2017,195164,St Bonaventure University,Saint Bonaventure,NY,14778,3,NCAA Division I without football,817,762,1579,2,"Private nonprofit, 4-year or above",2,14,12,3779310,1566081,5345391,3779310,1566081,5345391,Basketball
62860,2018,195164,St Bonaventure University,Saint Bonaventure,NY,14778,3,NCAA Division I without football,921,795,1716,2,"Private nonprofit, 4-year or above",2,14,12,3832105,1583634,5415739,3832105,1583634,5415739,Basketball
106055,2019,195164,St Bonaventure University,Saint Bonaventure,NY,14778,3,NCAA Division I without football,941,824,1765,2,"Private nonprofit, 4-year or above",2,13,15,3850362,1731163,5581525,3850362,1731163,5581525,Basketball
7820,2015,175005,St Catherine University,Saint Paul,MN,55105,7,NCAA Division III without football,6,2121,2127,2,"Private nonprofit, 4-year or above",2,0,13,NA,141720,141720,NA,141720,141720,Basketball
25234,2016,175005,St Catherine University,Saint Paul,MN,55105,7,NCAA Division III without football,14,2019,2033,2,"Private nonprofit, 4-year or above",2,0,16,NA,158971,158971,NA,158971,158971,Basketball
42735,2017,175005,St Catherine University,Saint Paul,MN,55105,7,NCAA Division III without football,31,2090,2121,2,"Private nonprofit, 4-year or above",2,0,17,NA,152514,152514,NA,152514,152514,Basketball
60441,2018,175005,St Catherine University,Saint Paul,MN,55105,7,NCAA Division III without football,42,2097,2139,2,"Private nonprofit, 4-year or above",2,0,19,NA,145816,145816,NA,145816,145816,Basketball
97500,2019,175005,St Catherine University,Saint Paul,MN,55105,7,NCAA Division III without football,39,1964,2003,2,"Private nonprofit, 4-year or above",2,0,22,NA,156364,156364,NA,156364,156364,Basketball
10250,2015,195173,St Francis College,Brooklyn Heights,NY,112019902,3,NCAA Division I without football,1009,1384,2393,2,"Private nonprofit, 4-year or above",2,14,15,1410698,1364204,2774902,1410698,1364204,2774902,Basketball
27672,2016,195173,St Francis College,Brooklyn Heights,NY,11201,3,NCAA Division I without football,977,1362,2339,2,"Private nonprofit, 4-year or above",2,14,13,1317776,1120201,2437977,1317776,1120201,2437977,Basketball
45159,2017,195173,St Francis College,Brooklyn Heights,NY,11201,3,NCAA Division I without football,847,1249,2096,2,"Private nonprofit, 4-year or above",2,13,13,1321633,1232663,2554296,1321633,1232663,2554296,Basketball
62868,2018,195173,St Francis College,Brooklyn Heights,NY,11201,3,NCAA Division I without football,863,1332,2195,2,"Private nonprofit, 4-year or above",2,15,17,1358525,1166858,2525383,1358525,1166858,2525383,Basketball
106064,2019,195173,St Francis College,Brooklyn Heights,NY,11201,3,NCAA Division I without football,920,1454,2374,2,"Private nonprofit, 4-year or above",2,14,11,1394083,1107745,2501828,1394083,1107745,2501828,Basketball
10364,2015,195809,St John's University-New York,Queens,NY,11439,3,NCAA Division I without football,4904,6070,10974,2,"Private nonprofit, 4-year or above",2,15,16,9167279,2912914,12080193,9167279,2912914,12080193,Basketball
27787,2016,195809,St John's University-New York,Queens,NY,11439,3,NCAA Division I without football,5011,6457,11468,2,"Private nonprofit, 4-year or above",2,16,14,8323127,2843143,11166270,8323127,2843143,11166270,Basketball
45283,2017,195809,St John's University-New York,Queens,NY,11439,3,NCAA Division I without football,4946,6556,11502,2,"Private nonprofit, 4-year or above",2,16,13,8321657,2770857,11092514,8321657,2770857,11092514,Basketball
62991,2018,195809,St John's University-New York,Queens,NY,11439,3,NCAA Division I without football,4979,6706,11685,2,"Private nonprofit, 4-year or above",2,19,18,10028677,2948753,12977430,10028677,2948753,12977430,Basketball
106408,2019,195809,St John's University-New York,Queens,NY,11439,3,NCAA Division I without football,4993,6474,11467,2,"Private nonprofit, 4-year or above",2,15,13,11549101,3387804,14936905,11549101,3387804,14936905,Basketball
10260,2015,195216,St Lawrence University,Canton,NY,13617,6,NCAA Division III with football,1065,1280,2345,2,"Private nonprofit, 4-year or above",2,14,19,124819,122835,247654,124819,122835,247654,Basketball
27682,2016,195216,St Lawrence University,Canton,NY,13617,6,NCAA Division III with football,1057,1284,2341,2,"Private nonprofit, 4-year or above",2,15,13,154331,118493,272824,154331,118493,272824,Basketball
45169,2017,195216,St Lawrence University,Canton,NY,13617,6,NCAA Division III with football,1045,1325,2370,2,"Private nonprofit, 4-year or above",2,14,14,161412,125144,286556,161412,125144,286556,Basketball
62878,2018,195216,St Lawrence University,Canton,NY,13617,6,NCAA Division III with football,1080,1324,2404,2,"Private nonprofit, 4-year or above",2,15,11,143387,137204,280591,143387,137204,280591,Basketball
106102,2019,195216,St Lawrence University,Canton,NY,13617,6,NCAA Division III with football,1071,1288,2359,2,"Private nonprofit, 4-year or above",2,15,12,138872,122676,261548,138872,122676,261548,Basketball
6260,2015,163912,St Mary's College of Maryland,St. Mary's City,MD,206863001,7,NCAA Division III without football,706,936,1642,1,"Public, 4-year or above",2,18,15,202381,120323,322704,202381,120323,322704,Basketball
23642,2016,163912,St Mary's College of Maryland,St. Mary's City,MD,20686,7,NCAA Division III without football,661,879,1540,1,"Public, 4-year or above",2,21,13,253566,131894,385460,253566,131894,385460,Basketball
41146,2017,163912,St Mary's College of Maryland,St. Mary's City,MD,20686,7,NCAA Division III without football,635,873,1508,1,"Public, 4-year or above",2,21,13,261010,98127,359137,261010,98127,359137,Basketball
58842,2018,163912,St Mary's College of Maryland,St. Mary's City,MD,20686,7,NCAA Division III without football,627,872,1499,1,"Public, 4-year or above",2,23,15,233423,121071,354494,233423,121071,354494,Basketball
15074,2015,228149,St Mary's University,San Antonio,TX,78228,5,NCAA Division II without football,989,1199,2188,2,"Private nonprofit, 4-year or above",2,16,14,737467,546951,1284418,713666,530573,1244239,Basketball
7773,2015,174844,St Olaf College,Northfield,MN,550571098,6,NCAA Division III with football,1285,1712,2997,2,"Private nonprofit, 4-year or above",2,15,15,141193,99437,240630,102278,82502,184780,Basketball
25187,2016,174844,St Olaf College,Northfield,MN,55057,6,NCAA Division III with football,1303,1680,2983,2,"Private nonprofit, 4-year or above",2,15,15,158525,121845,280370,131371,97339,228710,Basketball
42685,2017,174844,St Olaf College,Northfield,MN,55057,6,NCAA Division III with football,1260,1734,2994,2,"Private nonprofit, 4-year or above",2,14,14,162067,114619,276686,146967,107219,254186,Basketball
60391,2018,174844,St Olaf College,Northfield,MN,55057,6,NCAA Division III with football,1289,1725,3014,2,"Private nonprofit, 4-year or above",2,19,13,173015,131429,304444,163265,130454,293719,Basketball
97377,2019,174844,St Olaf College,Northfield,MN,55057,6,NCAA Division III with football,1263,1767,3030,2,"Private nonprofit, 4-year or above",2,18,17,163641,153647,317288,146712,129388,276100,Basketball
45259,2017,195562,St. Joseph's College-Long Island,Patchogue,NY,11772,7,NCAA Division III without football,877,1736,2613,2,"Private nonprofit, 4-year or above",2,12,11,58690,58986,117676,58690,58986,117676,Basketball
62967,2018,195562,St. Joseph's College-Long Island,Patchogue,NY,11772,7,NCAA Division III without football,850,1810,2660,2,"Private nonprofit, 4-year or above",2,14,11,60120,60185,120305,60120,60185,120305,Basketball
106335,2019,195562,St. Joseph's College-Long Island,Patchogue,NY,11772,7,NCAA Division III without football,829,1782,2611,2,"Private nonprofit, 4-year or above",2,13,11,58772,58405,117177,58772,58405,117177,Basketball
27763,2016,195544,St. Joseph's College-New York,Brooklyn,NY,11205,7,NCAA Division III without football,1170,2202,3372,2,"Private nonprofit, 4-year or above",2,29,22,99853,87873,187726,99853,87873,187726,Basketball
45251,2017,195544,St. Joseph's College-New York,Brooklyn,NY,11205,7,NCAA Division III without football,265,532,797,2,"Private nonprofit, 4-year or above",2,15,13,48766,40958,89724,48766,40958,89724,Basketball
62959,2018,195544,St. Joseph's College-New York,Brooklyn,NY,11205,7,NCAA Division III without football,260,563,823,2,"Private nonprofit, 4-year or above",2,11,11,35542,43668,79210,35542,43668,79210,Basketball
106297,2019,195544,St. Joseph's College-New York,Brooklyn,NY,11205,7,NCAA Division III without football,310,574,884,2,"Private nonprofit, 4-year or above",2,16,13,51723,59130,110853,51723,59130,110853,Basketball
92680,2019,163912,St. Mary's College of Maryland,St. Mary's City,MD,20686,7,NCAA Division III without football,587,845,1432,1,"Public, 4-year or above",2,17,14,191842,129340,321182,191842,129340,321182,Basketball
32543,2016,228149,St. Mary's University,San Antonio,TX,78228,5,NCAA Division II without football,1017,1163,2180,2,"Private nonprofit, 4-year or above",2,16,13,659931,589988,1249919,654559,581694,1236253,Basketball
50069,2017,228149,St. Mary's University,San Antonio,TX,78228,5,NCAA Division II without football,1005,1216,2221,2,"Private nonprofit, 4-year or above",2,14,14,661301,563897,1225198,661301,563897,1225198,Basketball
67847,2018,228149,St. Mary's University,San Antonio,TX,78228,5,NCAA Division II without football,1004,1253,2257,2,"Private nonprofit, 4-year or above",2,14,15,721647,594493,1316140,704611,583498,1288109,Basketball
123516,2019,228149,St. Mary's University,San Antonio,TX,78228,5,NCAA Division II without football,949,1211,2160,2,"Private nonprofit, 4-year or above",2,17,13,838012,600340,1438352,796907,582345,1379252,Basketball
10292,2015,195243,St. Thomas Aquinas College,Sparkill,NY,109761050,5,NCAA Division II without football,550,567,1117,2,"Private nonprofit, 4-year or above",2,15,13,495650,486722,982372,472030,445215,917245,Basketball
27714,2016,195243,St. Thomas Aquinas College,Sparkill,NY,10976,5,NCAA Division II without football,514,577,1091,2,"Private nonprofit, 4-year or above",2,14,14,521718,511041,1032759,491080,460427,951507,Basketball
45201,2017,195243,St. Thomas Aquinas College,Sparkill,NY,10976,5,NCAA Division II without football,504,555,1059,2,"Private nonprofit, 4-year or above",2,15,15,546978,510207,1057185,550589,505015,1055604,Basketball
62909,2018,195243,St. Thomas Aquinas College,Sparkill,NY,10976,5,NCAA Division II without football,593,546,1139,2,"Private nonprofit, 4-year or above",2,14,17,529121,509608,1038729,527204,519671,1046875,Basketball
106132,2019,195243,St. Thomas Aquinas College,Sparkill,NY,10976,5,NCAA Division II without football,559,551,1110,2,"Private nonprofit, 4-year or above",2,14,14,558192,520664,1078856,560985,513701,1074686,Basketball
17018,2015,243744,Stanford University,Stanford,CA,94305,1,NCAA Division I-FBS,3663,3331,6994,2,"Private nonprofit, 4-year or above",2,16,15,6847588,20043215,26890803,5727840,4546722,10274562,Basketball
34422,2016,243744,Stanford University,Stanford,CA,94305,1,NCAA Division I-FBS,3620,3412,7032,2,"Private nonprofit, 4-year or above",2,17,14,6971688,21440365,28412053,5339167,4650941,9990108,Basketball
52024,2017,243744,Stanford University,Stanford,CA,94305,1,NCAA Division I-FBS,3510,3546,7056,2,"Private nonprofit, 4-year or above",2,15,14,7254493,2030574,9285067,6375064,5262202,11637266,Basketball
69780,2018,243744,Stanford University,Stanford,CA,94305,1,NCAA Division I-FBS,3535,3548,7083,2,"Private nonprofit, 4-year or above",2,16,14,6769220,2289210,9058430,7143168,6133875,13277043,Basketball
130252,2019,243744,Stanford University,Stanford,CA,94305,1,NCAA Division I-FBS,3467,3527,6994,2,"Private nonprofit, 4-year or above",2,15,15,7768928,2365008,10133936,6480368,5625822,12106190,Basketball
10562,2015,196176,State University of New York at New Paltz,New Paltz,NY,125612443,7,NCAA Division III without football,2290,3828,6118,1,"Public, 4-year or above",2,14,14,116171,145558,261729,110226,138227,248453,Basketball
27988,2016,196176,State University of New York at New Paltz,New Paltz,NY,12561,7,NCAA Division III without football,2351,3846,6197,1,"Public, 4-year or above",2,14,15,143687,184289,327976,137517,174855,312372,Basketball
45484,2017,196176,State University of New York at New Paltz,New Paltz,NY,12561,7,NCAA Division III without football,2398,3836,6234,1,"Public, 4-year or above",2,17,14,136019,168740,304759,132641,160231,292872,Basketball
63193,2018,196176,State University of New York at New Paltz,New Paltz,NY,12561,7,NCAA Division III without football,2345,3843,6188,1,"Public, 4-year or above",2,14,12,173981,189853,363834,171849,178155,350004,Basketball
106968,2019,196176,State University of New York at New Paltz,New Paltz,NY,12561,7,NCAA Division III without football,2330,3960,6290,1,"Public, 4-year or above",2,13,13,183856,179907,363763,178063,170847,348910,Basketball
15114,2015,228431,Stephen F Austin State University,Nacogdoches,TX,75961,2,NCAA Division I-FCS,3446,5967,9413,1,"Public, 4-year or above",2,16,18,2188109,1094376,3282485,2188109,1094376,3282485,Basketball
32583,2016,228431,Stephen F Austin State University,Nacogdoches,TX,75961,2,NCAA Division I-FCS,3430,6141,9571,1,"Public, 4-year or above",2,15,14,1832582,1127429,2960011,1832582,1127429,2960011,Basketball
50109,2017,228431,Stephen F Austin State University,Nacogdoches,TX,75962,2,NCAA Division I-FCS,3483,6047,9530,1,"Public, 4-year or above",2,17,12,1931408,1122206,3053614,1931408,1122206,3053614,Basketball
67887,2018,228431,Stephen F Austin State University,Nacogdoches,TX,75962,2,NCAA Division I-FCS,3358,5987,9345,1,"Public, 4-year or above",2,14,12,2015066,1284172,3299238,2015066,1284172,3299238,Basketball
123690,2019,228431,Stephen F Austin State University,Nacogdoches,TX,75962,2,NCAA Division I-FCS,3305,5878,9183,1,"Public, 4-year or above",2,16,13,2064144,1175024,3239168,2064144,1175024,3239168,Basketball
3050,2015,137546,Stetson University,DeLand,FL,32723,2,NCAA Division I-FCS,1287,1708,2995,2,"Private nonprofit, 4-year or above",2,13,11,1623909,1538625,3162534,1623909,1538625,3162534,Basketball
20424,2016,137546,Stetson University,DeLand,FL,32723,2,NCAA Division I-FCS,1264,1753,3017,2,"Private nonprofit, 4-year or above",2,14,19,1626751,1842729,3469480,1626751,1842729,3469480,Basketball
37876,2017,137546,Stetson University,DeLand,FL,32723,2,NCAA Division I-FCS,1283,1715,2998,2,"Private nonprofit, 4-year or above",2,16,19,1861028,1793271,3654299,1861028,1793271,3654299,Basketball
55527,2018,137546,Stetson University,DeLand,FL,32723,2,NCAA Division I-FCS,1358,1728,3086,2,"Private nonprofit, 4-year or above",2,15,23,2386051,1654467,4040518,2386051,1654467,4040518,Basketball
81318,2019,137546,Stetson University,DeLand,FL,32723,2,NCAA Division I-FCS,1326,1771,3097,2,"Private nonprofit, 4-year or above",2,16,15,1874779,1747789,3622568,1874779,1747789,3622568,Basketball
9232,2015,186867,Stevens Institute of Technology,Hoboken,NJ,70305991,7,NCAA Division III without football,2087,868,2955,2,"Private nonprofit, 4-year or above",2,18,13,183324,167612,350936,183324,167612,350936,Basketball
26653,2016,186867,Stevens Institute of Technology,Hoboken,NJ,7030,7,NCAA Division III without football,2191,917,3108,2,"Private nonprofit, 4-year or above",2,18,13,202688,164420,367108,202688,164420,367108,Basketball
44148,2017,186867,Stevens Institute of Technology,Hoboken,NJ,7030,7,NCAA Division III without football,2185,928,3113,2,"Private nonprofit, 4-year or above",2,18,12,180422,172201,352623,180422,172201,352623,Basketball
61868,2018,186867,Stevens Institute of Technology,Hoboken,NJ,7030,7,NCAA Division III without football,2416,1004,3420,2,"Private nonprofit, 4-year or above",2,15,17,198326,177375,375701,198326,177375,375701,Basketball
102798,2019,186867,Stevens Institute of Technology,Hoboken,NJ,7030,7,NCAA Division III without football,2569,1072,3641,2,"Private nonprofit, 4-year or above",2,17,14,198556,177438,375994,198556,177438,375994,Basketball
6286,2015,164173,Stevenson University,Stevenson,MD,211530641,6,NCAA Division III with football,1100,2022,3122,2,"Private nonprofit, 4-year or above",2,16,15,241659,221528,463187,241659,221528,463187,Basketball
23669,2016,164173,Stevenson University,Stevenson,MD,21153,6,NCAA Division III with football,1094,1971,3065,2,"Private nonprofit, 4-year or above",2,19,14,210241,222557,432798,210241,222557,432798,Basketball
41173,2017,164173,Stevenson University,Stevenson,MD,21153,6,NCAA Division III with football,1049,1877,2926,2,"Private nonprofit, 4-year or above",2,15,21,179713,171247,350960,179713,171247,350960,Basketball
58869,2018,164173,Stevenson University,Stevenson,MD,21153,6,NCAA Division III with football,1018,1690,2708,2,"Private nonprofit, 4-year or above",2,17,14,180567,188418,368985,180567,188418,368985,Basketball
92732,2019,164173,Stevenson University,Stevenson,MD,21153,6,NCAA Division III with football,1041,1683,2724,2,"Private nonprofit, 4-year or above",2,16,19,154851,186271,341122,154851,186271,341122,Basketball
268,2015,102270,Stillman College,Tuscaloosa,AL,35401,4,NCAA Division II with football,406,363,769,2,"Private nonprofit, 4-year or above",2,15,11,268407,176127,444534,268407,172867,441274,Basketball
9246,2015,186876,Stockton University,Galloway,NJ,82059441,7,NCAA Division III without football,3000,4369,7369,1,"Public, 4-year or above",2,15,15,296081,186040,482121,263190,166600,429790,Basketball
26667,2016,186876,Stockton University,Galloway,NJ,8205,7,NCAA Division III without football,3032,4380,7412,1,"Public, 4-year or above",2,17,16,274155,186246,460401,242007,173275,415282,Basketball
44162,2017,186876,Stockton University,Galloway,NJ,8205,7,NCAA Division III without football,3202,4605,7807,1,"Public, 4-year or above",2,17,16,167895,171994,339889,167895,171994,339889,Basketball
61882,2018,186876,Stockton University,Galloway,NJ,8205,7,NCAA Division III without football,3391,4742,8133,1,"Public, 4-year or above",2,16,14,157976,141153,299129,157976,141153,299129,Basketball
102836,2019,186876,Stockton University,Galloway,NJ,8205,7,NCAA Division III without football,3455,5001,8456,1,"Public, 4-year or above",2,20,12,172849,157154,330003,172849,157154,330003,Basketball
6856,2015,167996,Stonehill College,Easton,MA,23576110,4,NCAA Division II with football,962,1414,2376,2,"Private nonprofit, 4-year or above",2,15,20,786816,787890,1574706,786816,787890,1574706,Basketball
24247,2016,167996,Stonehill College,Easton,MA,2357,4,NCAA Division II with football,984,1471,2455,2,"Private nonprofit, 4-year or above",2,15,13,861318,980600,1841918,843045,925715,1768760,Basketball
41750,2017,167996,Stonehill College,Easton,MA,2357,4,NCAA Division II with football,1013,1469,2482,2,"Private nonprofit, 4-year or above",2,14,15,918132,900348,1818480,865161,882207,1747368,Basketball
59441,2018,167996,Stonehill College,Easton,MA,2357,4,NCAA Division II with football,1008,1505,2513,2,"Private nonprofit, 4-year or above",2,16,14,907027,960507,1867534,902606,950067,1852673,Basketball
94318,2019,167996,Stonehill College,Easton,MA,2357,4,NCAA Division II with football,1004,1434,2438,2,"Private nonprofit, 4-year or above",2,16,16,944991,997264,1942255,943331,993319,1936650,Basketball
10479,2015,196097,Stony Brook University,Stony Brook,NY,11794,2,NCAA Division I-FCS,8475,7057,15532,1,"Public, 4-year or above",2,14,16,2015458,787088,2802546,2435574,1368737,3804311,Basketball
27903,2016,196097,Stony Brook University,Stony Brook,NY,11794,2,NCAA Division I-FCS,8473,7256,15729,1,"Public, 4-year or above",2,15,16,2045144,827754,2872898,2193596,1397374,3590970,Basketball
45395,2017,196097,Stony Brook University,Stony Brook,NY,11794,2,NCAA Division I-FCS,8585,7510,16095,1,"Public, 4-year or above",2,14,14,2016356,846079,2862435,2276032,1549889,3825921,Basketball
63105,2018,196097,Stony Brook University,Stony Brook,NY,11794,2,NCAA Division I-FCS,8383,7860,16243,1,"Public, 4-year or above",2,14,16,2064588,941506,3006094,2392346,1691404,4083750,Basketball
106717,2019,196097,Stony Brook University,Stony Brook,NY,11794,2,NCAA Division I-FCS,8368,8211,16579,1,"Public, 4-year or above",2,15,16,2850823,1960175,4810998,2850823,1960175,4810998,Basketball
6868,2015,168005,Suffolk University,Boston,MA,21082770,7,NCAA Division III without football,2350,2756,5106,2,"Private nonprofit, 4-year or above",2,16,13,68213,67229,135442,68213,67229,135442,Basketball
24259,2016,168005,Suffolk University,Boston,MA,2108,7,NCAA Division III without football,2223,2676,4899,2,"Private nonprofit, 4-year or above",2,15,13,65198,69335,134533,65198,69335,134533,Basketball
41763,2017,168005,Suffolk University,Boston,MA,2108,7,NCAA Division III without football,2172,2590,4762,2,"Private nonprofit, 4-year or above",2,17,11,74690,61214,135904,74690,61214,135904,Basketball
59454,2018,168005,Suffolk University,Boston,MA,2108,7,NCAA Division III without football,2155,2681,4836,2,"Private nonprofit, 4-year or above",2,17,14,113165,69738,182903,113165,69738,182903,Basketball
94335,2019,168005,Suffolk University,Boston,MA,2108,7,NCAA Division III without football,2043,2622,4665,2,"Private nonprofit, 4-year or above",2,17,13,90436,66356,156792,90436,66356,156792,Basketball
15139,2015,228501,Sul Ross State University,Alpine,TX,79832,6,NCAA Division III with football,617,640,1257,1,"Public, 4-year or above",2,12,13,101088,90196,191284,101088,90196,191284,Basketball
32608,2016,228501,Sul Ross State University,Alpine,TX,79832,6,NCAA Division III with football,675,702,1377,1,"Public, 4-year or above",2,15,12,104875,98924,203799,106875,97924,204799,Basketball
50134,2017,228501,Sul Ross State University,Alpine,TX,79832,6,NCAA Division III with football,690,686,1376,1,"Public, 4-year or above",2,18,14,119898,110145,230043,124012,108004,232016,Basketball
67910,2018,228501,Sul Ross State University,Alpine,TX,79832,6,NCAA Division III with football,643,684,1327,1,"Public, 4-year or above",2,14,16,160915,105950,266865,159355,114072,273427,Basketball
123746,2019,228501,Sul Ross State University,Alpine,TX,79832,6,NCAA Division III with football,545,634,1179,1,"Public, 4-year or above",2,19,12,227601,218138,445739,165557,187033,352590,Basketball
12563,2015,211024,Summit University of Pennsylvania,South Abington Twp.,PA,18411,7,NCAA Division III without football,190,201,391,2,"Private nonprofit, 4-year or above",2,14,13,24234,16993,41227,24234,16993,41227,Basketball
10444,2015,196060,SUNY at Albany,Albany,NY,12222,2,NCAA Division I-FCS,6163,5988,12151,1,"Public, 4-year or above",2,14,20,2037503,1680632,3718135,1621247,1584011,3205258,Basketball
27869,2016,196060,SUNY at Albany,Albany,NY,12222,2,NCAA Division I-FCS,6261,6126,12387,1,"Public, 4-year or above",2,14,17,2217109,1685373,3902482,1853097,1498466,3351563,Basketball
45363,2017,196060,SUNY at Albany,Albany,NY,12222,2,NCAA Division I-FCS,6254,6449,12703,1,"Public, 4-year or above",2,14,15,1990718,1690996,3681714,1669874,1584813,3254687,Basketball
63073,2018,196060,SUNY at Albany,Albany,NY,12222,2,NCAA Division I-FCS,6269,6602,12871,1,"Public, 4-year or above",2,14,12,2109818,1543316,3653134,1799859,1438682,3238541,Basketball
106603,2019,196060,SUNY at Albany,Albany,NY,12222,2,NCAA Division I-FCS,6014,6534,12548,1,"Public, 4-year or above",2,16,13,2135824,1656753,3792577,1628424,1387065,3015489,Basketball
10457,2015,196079,SUNY at Binghamton,Vestal,NY,138506000,3,NCAA Division I without football,6786,6259,13045,1,"Public, 4-year or above",2,15,12,1590639,1170025,2760664,1590639,1170025,2760664,Basketball
27881,2016,196079,SUNY at Binghamton,Vestal,NY,13850,3,NCAA Division I without football,6768,6411,13179,1,"Public, 4-year or above",2,17,14,1639092,1269411,2908503,1639092,1269411,2908503,Basketball
10541,2015,196158,SUNY at Fredonia,Fredonia,NY,140631136,7,NCAA Division III without football,1941,2501,4442,1,"Public, 4-year or above",2,17,14,149981,147482,297463,149981,147482,297463,Basketball
27967,2016,196158,SUNY at Fredonia,Fredonia,NY,14063,7,NCAA Division III without football,1819,2434,4253,1,"Public, 4-year or above",2,16,15,149999,147809,297808,150245,148769,299014,Basketball
45460,2017,196158,SUNY at Fredonia,Fredonia,NY,14063,7,NCAA Division III without football,1807,2472,4279,1,"Public, 4-year or above",2,17,15,161996,170047,332043,161996,170047,332043,Basketball
63169,2018,196158,SUNY at Fredonia,Fredonia,NY,14063,7,NCAA Division III without football,1830,2477,4307,1,"Public, 4-year or above",2,19,17,159993,160462,320455,159993,160462,320455,Basketball
106892,2019,196158,SUNY at Fredonia,Fredonia,NY,14063,7,NCAA Division III without football,1759,2368,4127,1,"Public, 4-year or above",2,15,16,163787,156634,320421,163787,156634,320421,Basketball
10605,2015,196219,SUNY at Purchase College,Purchase,NY,105771400,7,NCAA Division III without football,1561,2079,3640,1,"Public, 4-year or above",2,17,10,55111,48420,103531,55111,48420,103531,Basketball
28031,2016,196219,SUNY at Purchase College,Purchase,NY,10577,7,NCAA Division III without football,1568,2074,3642,1,"Public, 4-year or above",2,17,11,62992,52698,115690,62992,52698,115690,Basketball
45529,2017,196219,SUNY at Purchase College,Purchase,NY,10577,7,NCAA Division III without football,1561,2139,3700,1,"Public, 4-year or above",2,13,16,61990,58843,120833,61990,58843,120833,Basketball
63237,2018,196219,SUNY at Purchase College,Purchase,NY,10577,7,NCAA Division III without football,1562,2194,3756,1,"Public, 4-year or above",2,14,14,66559,61417,127976,66559,61417,127976,Basketball
107068,2019,196219,SUNY at Purchase College,Purchase,NY,10577,7,NCAA Division III without football,1542,2155,3697,1,"Public, 4-year or above",2,15,13,74944,61355,136299,74944,61355,136299,Basketball
10514,2015,196130,SUNY Buffalo State,Buffalo,NY,14222,6,NCAA Division III with football,3415,4696,8111,1,"Public, 4-year or above",2,16,14,190436,137372,327808,187236,137372,324608,Basketball
27940,2016,196130,SUNY Buffalo State,Buffalo,NY,14222,6,NCAA Division III with football,3214,4376,7590,1,"Public, 4-year or above",2,15,13,189624,96217,285841,190625,91810,282435,Basketball
45433,2017,196130,SUNY Buffalo State,Buffalo,NY,14222,6,NCAA Division III with football,3251,4388,7639,1,"Public, 4-year or above",2,16,15,161050,74130,235180,161000,74115,235115,Basketball
63142,2018,196130,SUNY Buffalo State,Buffalo,NY,14222,6,NCAA Division III with football,3063,4192,7255,1,"Public, 4-year or above",2,15,14,192306,94823,287129,190287,94820,285107,Basketball
106837,2019,196130,SUNY Buffalo State,Buffalo,NY,14222,6,NCAA Division III with football,2865,4018,6883,1,"Public, 4-year or above",2,14,16,184977,129886,314863,179072,130926,309998,Basketball
10501,2015,196121,SUNY College at Brockport,Brockport,NY,144202919,6,NCAA Division III with football,2903,3449,6352,1,"Public, 4-year or above",2,15,13,112451,126416,238867,112451,126416,238867,Basketball
27925,2016,196121,SUNY College at Brockport,Brockport,NY,14420,6,NCAA Division III with football,2865,3510,6375,1,"Public, 4-year or above",2,18,14,105423,134089,239512,105423,134583,240006,Basketball
45418,2017,196121,SUNY College at Brockport,Brockport,NY,14420,6,NCAA Division III with football,2806,3612,6418,1,"Public, 4-year or above",2,16,10,153542,181287,334829,145252,175685,320937,Basketball
63128,2018,196121,SUNY College at Brockport,Brockport,NY,14420,6,NCAA Division III with football,2776,3567,6343,1,"Public, 4-year or above",2,17,15,140042,187485,327527,137187,192430,329617,Basketball
106799,2019,196121,SUNY College at Brockport,Brockport,NY,14420,6,NCAA Division III with football,2583,3377,5960,1,"Public, 4-year or above",2,17,14,141913,179805,321718,138865,176327,315192,Basketball
10524,2015,196149,SUNY College at Cortland,Cortland,NY,130450900,6,NCAA Division III with football,2670,3509,6179,1,"Public, 4-year or above",2,18,15,184357,135521,319878,184357,135521,319878,Basketball
10550,2015,196167,SUNY College at Geneseo,Geneseo,NY,144541465,7,NCAA Division III without football,2175,3266,5441,1,"Public, 4-year or above",2,16,15,171245,166419,337664,171245,166419,337664,Basketball
27976,2016,196167,SUNY College at Geneseo,Geneseo,NY,14454,7,NCAA Division III without football,2165,3204,5369,1,"Public, 4-year or above",2,16,15,176342,161156,337498,176342,161156,337498,Basketball
45472,2017,196167,SUNY College at Geneseo,Geneseo,NY,14454,7,NCAA Division III without football,2136,3284,5420,1,"Public, 4-year or above",2,17,15,166100,152870,318970,165940,150708,316648,Basketball
63181,2018,196167,SUNY College at Geneseo,Geneseo,NY,14454,7,NCAA Division III without football,2058,3293,5351,1,"Public, 4-year or above",2,13,12,158342,125164,283506,158342,125164,283506,Basketball
106930,2019,196167,SUNY College at Geneseo,Geneseo,NY,14454,7,NCAA Division III without football,1930,3203,5133,1,"Public, 4-year or above",2,17,13,165405,112225,277630,165278,112162,277440,Basketball
10615,2015,196237,SUNY College at Old Westbury,Old Westbury,NY,115680210,7,NCAA Division III without football,1434,2056,3490,1,"Public, 4-year or above",2,15,18,62504,56894,119398,56061,53499,109560,Basketball
28041,2016,196237,SUNY College at Old Westbury,Old Westbury,NY,11568,7,NCAA Division III without football,1453,2136,3589,1,"Public, 4-year or above",2,14,17,68418,61420,129838,62438,57952,120390,Basketball
45539,2017,196237,SUNY College at Old Westbury,Old Westbury,NY,11568,7,NCAA Division III without football,1597,2408,4005,1,"Public, 4-year or above",2,15,18,71217,58548,129765,70180,56393,126573,Basketball
63247,2018,196237,SUNY College at Old Westbury,Old Westbury,NY,11568,7,NCAA Division III without football,1629,2479,4108,1,"Public, 4-year or above",2,15,13,49645,51717,101362,49035,48933,97968,Basketball
107106,2019,196237,SUNY College at Old Westbury,Old Westbury,NY,11568,7,NCAA Division III without football,1691,2410,4101,1,"Public, 4-year or above",2,15,13,73182,63806,136988,73078,63703,136781,Basketball
10583,2015,196194,SUNY College at Oswego,Oswego,NY,13126,7,NCAA Division III without football,3330,3423,6753,1,"Public, 4-year or above",2,14,14,123170,113419,236589,117836,100447,218283,Basketball
28009,2016,196194,SUNY College at Oswego,Oswego,NY,13126,7,NCAA Division III without football,3433,3435,6868,1,"Public, 4-year or above",2,16,14,128865,112076,240941,128419,102564,230983,Basketball
45505,2017,196194,SUNY College at Oswego,Oswego,NY,13126,7,NCAA Division III without football,3456,3380,6836,1,"Public, 4-year or above",2,16,11,131055,109111,240166,142987,104996,247983,Basketball
63214,2018,196194,SUNY College at Oswego,Oswego,NY,13126,7,NCAA Division III without football,3402,3363,6765,1,"Public, 4-year or above",2,15,14,166918,116013,282931,159203,108443,267646,Basketball
107019,2019,196194,SUNY College at Oswego,Oswego,NY,13126,7,NCAA Division III without football,3249,3312,6561,1,"Public, 4-year or above",2,16,14,151556,115607,267163,144939,108811,253750,Basketball
10624,2015,196246,SUNY College at Plattsburgh,Plattsburgh,NY,129012681,7,NCAA Division III without football,2192,2732,4924,1,"Public, 4-year or above",2,17,12,254170,198684,452854,235080,187292,422372,Basketball
28050,2016,196246,SUNY College at Plattsburgh,Plattsburgh,NY,12901,7,NCAA Division III without football,2113,2699,4812,1,"Public, 4-year or above",2,15,14,224261,215062,439323,223372,215008,438380,Basketball
45548,2017,196246,SUNY College at Plattsburgh,Plattsburgh,NY,12901,7,NCAA Division III without football,2089,2791,4880,1,"Public, 4-year or above",2,16,16,256436,200283,456719,256436,200283,456719,Basketball
63256,2018,196246,SUNY College at Plattsburgh,Plattsburgh,NY,12901,7,NCAA Division III without football,2104,2736,4840,1,"Public, 4-year or above",2,15,14,214468,221301,435769,263239,221301,484540,Basketball
107115,2019,196246,SUNY College at Plattsburgh,Plattsburgh,NY,12901,7,NCAA Division III without football,1860,2546,4406,1,"Public, 4-year or above",2,11,14,186529,162973,349502,224427,207909,432336,Basketball
10595,2015,196200,SUNY College at Potsdam,Potsdam,NY,136762294,7,NCAA Division III without football,1503,2001,3504,1,"Public, 4-year or above",2,19,15,117949,107205,225154,117949,107205,225154,Basketball
28021,2016,196200,SUNY College at Potsdam,Potsdam,NY,13676,7,NCAA Division III without football,1401,1919,3320,1,"Public, 4-year or above",2,14,15,128185,91701,219886,126611,87007,213618,Basketball
45517,2017,196200,SUNY College at Potsdam,Potsdam,NY,13676,7,NCAA Division III without football,1315,1880,3195,1,"Public, 4-year or above",2,15,13,120637,87581,208218,119349,86795,206144,Basketball
63226,2018,196200,SUNY College at Potsdam,Potsdam,NY,13676,7,NCAA Division III without football,1284,1934,3218,1,"Public, 4-year or above",2,13,13,145387,120319,265706,169935,122976,292911,Basketball
107056,2019,196200,SUNY College at Potsdam,Potsdam,NY,13676,7,NCAA Division III without football,1135,1842,2977,1,"Public, 4-year or above",2,14,15,3880,3659,7539,141080,101101,242181,Basketball
10410,2015,196033,SUNY College of Agriculture and Technology at Cobleskill,Cobleskill,NY,12043,7,NCAA Division III without football,1086,1222,2308,1,"Public, 4-year or above",2,19,15,50250,51925,102175,50250,51925,102175,Basketball
27834,2016,196033,SUNY College of Agriculture and Technology at Cobleskill,Cobleskill,NY,12043,7,NCAA Division III without football,1016,1151,2167,1,"Public, 4-year or above",2,21,13,37524,42529,80053,37524,42529,80053,Basketball
45329,2017,196033,SUNY College of Agriculture and Technology at Cobleskill,Cobleskill,NY,12043,7,NCAA Division III without football,1035,1140,2175,1,"Public, 4-year or above",2,19,15,75098,57573,132671,75098,57573,132671,Basketball
63039,2018,196033,SUNY College of Agriculture and Technology at Cobleskill,Cobleskill,NY,12043,7,NCAA Division III without football,972,1087,2059,1,"Public, 4-year or above",2,18,13,91310,74440,165750,91310,74440,165750,Basketball
106515,2019,196033,SUNY College of Agriculture and Technology at Cobleskill,Cobleskill,NY,12043,7,NCAA Division III without football,947,1139,2086,1,"Public, 4-year or above",2,22,16,92008,92187,184195,92008,92187,184195,Basketball
10381,2015,196006,SUNY College of Technology at Alfred,Alfred,NY,14802,6,NCAA Division III with football,2192,1184,3376,1,"Public, 4-year or above",2,20,13,98200,104997,203197,91985,100689,192674,Basketball
27804,2016,196006,SUNY College of Technology at Alfred,Alfred,NY,14802,6,NCAA Division III with football,2274,1171,3445,1,"Public, 4-year or above",2,21,16,108295,115389,223684,108295,115389,223684,Basketball
45300,2017,196006,SUNY College of Technology at Alfred,Alfred,NY,14802,6,NCAA Division III with football,2259,1136,3395,1,"Public, 4-year or above",2,19,12,102261,91770,194031,102261,91770,194031,Basketball
63008,2018,196006,SUNY College of Technology at Alfred,Alfred,NY,14802,6,NCAA Division III with football,2241,1214,3455,1,"Public, 4-year or above",2,15,10,150011,170332,320343,150011,166943,316954,Basketball
106426,2019,196006,SUNY College of Technology at Alfred,Alfred,NY,14802,6,NCAA Division III with football,2284,1198,3482,1,"Public, 4-year or above",2,16,13,148488,164165,312653,148488,164082,312570,Basketball
10393,2015,196015,SUNY College of Technology at Canton,Canton,NY,136171098,7,NCAA Division III without football,1223,1417,2640,1,"Public, 4-year or above",2,14,13,105776,119568,225344,105776,119568,225344,Basketball
27814,2016,196015,SUNY College of Technology at Canton,Canton,NY,13617,7,NCAA Division III without football,1209,1464,2673,1,"Public, 4-year or above",2,18,13,130945,86690,217635,120670,86200,206870,Basketball
45311,2017,196015,SUNY College of Technology at Canton,Canton,NY,13617,7,NCAA Division III without football,1185,1472,2657,1,"Public, 4-year or above",2,19,19,131933,123263,255196,116866,117747,234613,Basketball
63019,2018,196015,SUNY College of Technology at Canton,Canton,NY,13617,7,NCAA Division III without football,1219,1524,2743,1,"Public, 4-year or above",2,14,15,160463,108716,269179,149742,107716,257458,Basketball
106464,2019,196015,SUNY College of Technology at Canton,Canton,NY,13617,7,NCAA Division III without football,1282,1501,2783,1,"Public, 4-year or above",2,15,11,121138,118937,240075,119640,118868,238508,Basketball
63028,2018,196024,SUNY College of Technology at Delhi,Delhi,NY,13753,7,NCAA Division III without football,1287,1227,2514,1,"Public, 4-year or above",2,19,12,84733,71561,156294,84733,71561,156294,Basketball
106501,2019,196024,SUNY College of Technology at Delhi,Delhi,NY,13753,7,NCAA Division III without football,1253,1138,2391,1,"Public, 4-year or above",2,18,13,90660,78886,169546,90660,78886,169546,Basketball
27950,2016,196149,SUNY Cortland,Cortland,NY,13045,6,NCAA Division III with football,2731,3456,6187,1,"Public, 4-year or above",2,18,16,180687,129311,309998,180687,129311,309998,Basketball
45443,2017,196149,SUNY Cortland,Cortland,NY,13045,6,NCAA Division III with football,2715,3480,6195,1,"Public, 4-year or above",2,17,17,179491,129533,309024,179491,129533,309024,Basketball
63152,2018,196149,SUNY Cortland,Cortland,NY,13045,6,NCAA Division III with football,2701,3517,6218,1,"Public, 4-year or above",2,16,16,173811,111942,285753,173811,111942,285753,Basketball
106875,2019,196149,SUNY Cortland,Cortland,NY,13045,6,NCAA Division III with football,2682,3488,6170,1,"Public, 4-year or above",2,17,15,186165,141321,327486,186165,141321,327486,Basketball
10635,2015,196291,SUNY Maritime College,Throggs Neck,NY,104654198,6,NCAA Division III with football,1451,170,1621,1,"Public, 4-year or above",2,27,0,132878,NA,132878,160283,NA,160283,Basketball
28061,2016,196291,SUNY Maritime College,Throggs Neck,NY,10465,6,NCAA Division III with football,1399,186,1585,1,"Public, 4-year or above",2,14,0,70421,NA,70421,70421,NA,70421,Basketball
45559,2017,196291,SUNY Maritime College,Throggs Neck,NY,10465,6,NCAA Division III with football,1398,178,1576,1,"Public, 4-year or above",2,14,0,67343,NA,67343,61302,NA,61302,Basketball
63267,2018,196291,SUNY Maritime College,Throggs Neck,NY,10465,6,NCAA Division III with football,1349,189,1538,1,"Public, 4-year or above",2,15,0,67808,NA,67808,63707,NA,63707,Basketball
107153,2019,196291,SUNY Maritime College,Throggs Neck,NY,10465,6,NCAA Division III with football,1262,203,1465,1,"Public, 4-year or above",2,16,0,61236,NA,61236,51186,NA,51186,Basketball
106565,2019,196051,SUNY Morrisville,Morrisville,NY,13408,6,NCAA Division III with football,1156,1127,2283,1,"Public, 4-year or above",2,14,13,183554,151607,335161,181314,147410,328724,Basketball
10572,2015,196185,SUNY Oneonta,Oneonta,NY,138204015,7,NCAA Division III without football,2275,3472,5747,1,"Public, 4-year or above",2,18,12,125788,127282,253070,125788,127282,253070,Basketball
27998,2016,196185,SUNY Oneonta,Oneonta,NY,13820,7,NCAA Division III without football,2247,3357,5604,1,"Public, 4-year or above",2,14,14,129855,133175,263030,129855,133175,263030,Basketball
45494,2017,196185,SUNY Oneonta,Oneonta,NY,13820,7,NCAA Division III without football,2331,3495,5826,1,"Public, 4-year or above",2,13,14,144070,142789,286859,144070,142789,286859,Basketball
63203,2018,196185,SUNY Oneonta,Oneonta,NY,13820,7,NCAA Division III without football,2273,3663,5936,1,"Public, 4-year or above",2,14,14,163343,160961,324304,163343,160961,324304,Basketball
107006,2019,196185,SUNY Oneonta,Oneonta,NY,13820,7,NCAA Division III without football,2251,3687,5938,1,"Public, 4-year or above",2,13,15,178247,165284,343531,178247,165284,343531,Basketball
10494,2015,196112,SUNY Polytechnic Institute,Utica,NY,13502,7,NCAA Division III without football,1189,525,1714,1,"Public, 4-year or above",2,13,15,132050,133070,265120,131805,133059,264864,Basketball
27918,2016,196112,SUNY Polytechnic Institute,Utica,NY,13502,7,NCAA Division III without football,1202,483,1685,1,"Public, 4-year or above",2,13,15,140043,141788,281831,138987,140870,279857,Basketball
45411,2017,196112,SUNY Polytechnic Institute,Utica,NY,13502,7,NCAA Division III without football,1332,518,1850,1,"Public, 4-year or above",2,13,15,139767,140859,280626,139435,140780,280215,Basketball
63121,2018,196112,SUNY Polytechnic Institute,Utica,NY,13502,7,NCAA Division III without football,1361,558,1919,1,"Public, 4-year or above",2,16,14,140090,140615,280705,139767,140110,279877,Basketball
106761,2019,196112,SUNY Polytechnic Institute,Utica,NY,13502,7,NCAA Division III without football,1348,553,1901,1,"Public, 4-year or above",2,16,14,140573,142361,282934,139995,141386,281381,Basketball
13564,2015,216278,Susquehanna University,Selinsgrove,PA,178701025,6,NCAA Division III with football,946,1158,2104,2,"Private nonprofit, 4-year or above",2,25,19,170343,128638,298981,169474,128638,298112,Basketball
31023,2016,216278,Susquehanna University,Selinsgrove,PA,17870,6,NCAA Division III with football,940,1184,2124,2,"Private nonprofit, 4-year or above",2,24,22,178053,155016,333069,178053,155016,333069,Basketball
48535,2017,216278,Susquehanna University,Selinsgrove,PA,17870,6,NCAA Division III with football,999,1274,2273,2,"Private nonprofit, 4-year or above",2,22,18,172475,136166,308641,172475,136166,308641,Basketball
66277,2018,216278,Susquehanna University,Selinsgrove,PA,17870,6,NCAA Division III with football,1007,1295,2302,2,"Private nonprofit, 4-year or above",2,19,17,164598,132189,296787,164598,132189,296787,Basketball
117513,2019,216278,Susquehanna University,Selinsgrove,PA,17870,6,NCAA Division III with football,962,1229,2191,2,"Private nonprofit, 4-year or above",2,24,17,182566,132543,315109,182566,132543,315109,Basketball
13576,2015,216287,Swarthmore College,Swarthmore,PA,19081,7,NCAA Division III without football,778,788,1566,2,"Private nonprofit, 4-year or above",2,15,12,196662,137064,333726,139790,133769,273559,Basketball
31035,2016,216287,Swarthmore College,Swarthmore,PA,19081,7,NCAA Division III without football,766,774,1540,2,"Private nonprofit, 4-year or above",2,14,16,204662,139346,344008,187207,134729,321936,Basketball
48547,2017,216287,Swarthmore College,Swarthmore,PA,19081,7,NCAA Division III without football,778,787,1565,2,"Private nonprofit, 4-year or above",2,13,13,170539,112672,283211,150704,134998,285702,Basketball
66289,2018,216287,Swarthmore College,Swarthmore,PA,19081,7,NCAA Division III without football,757,787,1544,2,"Private nonprofit, 4-year or above",2,15,11,216588,150656,367244,173044,199164,372208,Basketball
117526,2019,216287,Swarthmore College,Swarthmore,PA,19081,7,NCAA Division III without football,786,798,1584,2,"Private nonprofit, 4-year or above",2,18,13,201218,161017,362235,209679,159697,369376,Basketball
10644,2015,196413,Syracuse University,Syracuse,NY,13244,1,NCAA Division I-FBS,6391,7736,14127,2,"Private nonprofit, 4-year or above",2,18,19,26889157,1670590,28559747,13876720,5831207,19707927,Basketball
28070,2016,196413,Syracuse University,Syracuse,NY,13244,1,NCAA Division I-FBS,6518,7806,14324,2,"Private nonprofit, 4-year or above",2,19,19,29322084,1808153,31130237,13260311,5463998,18724309,Basketball
45568,2017,196413,Syracuse University,Syracuse,NY,13244,1,NCAA Division I-FBS,6625,7721,14346,2,"Private nonprofit, 4-year or above",2,18,18,31772639,1863762,33636401,14742445,5448042,20190487,Basketball
63276,2018,196413,Syracuse University,Syracuse,NY,13244,1,NCAA Division I-FBS,6589,7747,14336,2,"Private nonprofit, 4-year or above",2,17,17,34567071,2389280,36956351,14845555,6018601,20864156,Basketball
107191,2019,196413,Syracuse University,Syracuse,NY,13244,1,NCAA Division I-FBS,6716,7721,14437,2,"Private nonprofit, 4-year or above",2,16,14,22665104,1767660,24432764,13981273,5010084,18991357,Basketball
15148,2015,228529,Tarleton State University,Stephenville,TX,764010000,4,NCAA Division II with football,3189,5120,8309,1,"Public, 4-year or above",2,20,15,680977,620052,1301029,680977,620052,1301029,Basketball
32617,2016,228529,Tarleton State University,Stephenville,TX,76401,4,NCAA Division II with football,3147,4912,8059,1,"Public, 4-year or above",2,15,13,776900,713806,1490706,720592,685966,1406558,Basketball
50143,2017,228529,Tarleton State University,Stephenville,TX,76401,4,NCAA Division II with football,3262,5167,8429,1,"Public, 4-year or above",2,19,16,771295,667072,1438367,771295,639334,1410629,Basketball
67919,2018,228529,Tarleton State University,Stephenville,TX,76401,4,NCAA Division II with football,3233,5145,8378,1,"Public, 4-year or above",2,17,13,848899,696067,1544966,864953,676109,1541062,Basketball
123754,2019,228529,Tarleton State University,Stephenville,TX,76401,4,NCAA Division II with football,3113,5098,8211,1,"Public, 4-year or above",2,18,15,874734,689690,1564424,874734,689690,1564424,Basketball
13592,2015,216339,Temple University,Philadelphia,PA,191226096,1,NCAA Division I-FBS,12108,13020,25128,1,"Public, 4-year or above",2,14,14,5920903,3371893,9292796,5920903,3371893,9292796,Basketball
31051,2016,216339,Temple University,Philadelphia,PA,19122,1,NCAA Division I-FBS,12406,13722,26128,1,"Public, 4-year or above",2,14,14,5675239,3228712,8903951,5675239,3228712,8903951,Basketball
48563,2017,216339,Temple University,Philadelphia,PA,19122,1,NCAA Division I-FBS,12400,14137,26537,1,"Public, 4-year or above",2,14,14,6533015,3196996,9730011,6533015,3196996,9730011,Basketball
66305,2018,216339,Temple University,Philadelphia,PA,19122,1,NCAA Division I-FBS,12298,14376,26674,1,"Public, 4-year or above",2,15,14,6487460,3474252,9961712,6487460,3474252,9961712,Basketball
117543,2019,216339,Temple University,Philadelphia,PA,19122,1,NCAA Division I-FBS,11802,14360,26162,1,"Public, 4-year or above",2,16,14,6432467,3460639,9893106,6432467,3460639,9893106,Basketball
14566,2015,221838,Tennessee State University,Nashville,TN,372091561,2,NCAA Division I-FCS,2487,3479,5966,1,"Public, 4-year or above",2,16,15,1228593,1203488,2432081,1312549,1140712,2453261,Basketball
32034,2016,221838,Tennessee State University,Nashville,TN,37209,2,NCAA Division I-FCS,2421,3275,5696,1,"Public, 4-year or above",2,16,15,1292581,1008011,2300592,1337428,962195,2299623,Basketball
49551,2017,221838,Tennessee State University,Nashville,TN,37209,2,NCAA Division I-FCS,2111,3314,5425,1,"Public, 4-year or above",2,15,16,1491227,906960,2398187,1415590,1013146,2428736,Basketball
67322,2018,221838,Tennessee State University,Nashville,TN,37209,2,NCAA Division I-FCS,1865,3159,5024,1,"Public, 4-year or above",2,14,16,1414097,974978,2389075,1330636,974978,2305614,Basketball
121021,2019,221838,Tennessee State University,Nashville,TN,37209,2,NCAA Division I-FCS,1782,3024,4806,1,"Public, 4-year or above",2,16,14,1376009,738837,2114846,1313643,909309,2222952,Basketball
14574,2015,221847,Tennessee Technological University,Cookeville,TN,385050001,2,NCAA Division I-FCS,4844,3794,8638,1,"Public, 4-year or above",2,14,13,1201935,1043746,2245681,1201935,1043746,2245681,Basketball
32042,2016,221847,Tennessee Technological University,Cookeville,TN,38505,2,NCAA Division I-FCS,4600,3786,8386,1,"Public, 4-year or above",2,14,11,1092486,926698,2019184,1092486,926698,2019184,Basketball
49559,2017,221847,Tennessee Technological University,Cookeville,TN,38505,2,NCAA Division I-FCS,4525,3692,8217,1,"Public, 4-year or above",2,14,15,1154344,1050530,2204874,1154344,1050530,2204874,Basketball
67330,2018,221847,Tennessee Technological University,Cookeville,TN,38505,2,NCAA Division I-FCS,4408,3568,7976,1,"Public, 4-year or above",2,17,15,1161305,1065541,2226846,1161305,1065541,2226846,Basketball
121029,2019,221847,Tennessee Technological University,Cookeville,TN,38505,2,NCAA Division I-FCS,4367,3607,7974,1,"Public, 4-year or above",2,17,15,1134816,1071992,2206808,1134816,1071992,2206808,Basketball
14886,2015,226152,Texas A & M International University,Laredo,TX,780411900,5,NCAA Division II without football,1917,2662,4579,1,"Public, 4-year or above",2,18,17,510224,419277,929501,510224,419277,929501,Basketball
32356,2016,226152,Texas A & M International University,Laredo,TX,78041,5,NCAA Division II without football,1980,2869,4849,1,"Public, 4-year or above",2,18,12,584700,321832,906532,584700,321832,906532,Basketball
49879,2017,226152,Texas A & M International University,Laredo,TX,78041,5,NCAA Division II without football,2047,3136,5183,1,"Public, 4-year or above",2,16,13,524137,448058,972195,524137,448058,972195,Basketball
67654,2018,226152,Texas A & M International University,Laredo,TX,78041,5,NCAA Division II without football,2121,3095,5216,1,"Public, 4-year or above",2,15,15,509778,426516,936294,509778,426516,936294,Basketball
122579,2019,226152,Texas A & M International University,Laredo,TX,78041,5,NCAA Division II without football,2190,3368,5558,1,"Public, 4-year or above",2,12,15,536278,471616,1007894,536278,471616,1007894,Basketball
15168,2015,228723,Texas A & M University-College Station,College Station,TX,778431248,1,NCAA Division I-FBS,21997,21413,43410,1,"Public, 4-year or above",2,16,30,9177326,1198832,10376158,9301170,5038990,14340160,Basketball
32638,2016,228723,Texas A & M University-College Station,College Station,TX,77843,1,NCAA Division I-FBS,22973,22002,44975,1,"Public, 4-year or above",2,16,31,8905402,1097933,10003335,8953278,5802610,14755888,Basketball
50164,2017,228723,Texas A & M University-College Station,College Station,TX,77843,1,NCAA Division I-FBS,24141,22451,46592,1,"Public, 4-year or above",2,18,31,9225600,1307809,10533409,10391815,5819165,16210980,Basketball
67940,2018,228723,Texas A & M University-College Station,College Station,TX,77843,1,NCAA Division I-FBS,24703,22550,47253,1,"Public, 4-year or above",2,19,31,12349705,3941753,16291458,11818860,5871696,17690556,Basketball
123868,2019,228723,Texas A & M University-College Station,College Station,TX,77843,1,NCAA Division I-FBS,24943,22594,47537,1,"Public, 4-year or above",2,16,25,14755380,926533,15681913,13412054,4812840,18224894,Basketball
14754,2015,224554,Texas A & M University-Commerce,Commerce,TX,754293011,4,NCAA Division II with football,2390,3361,5751,1,"Public, 4-year or above",2,18,17,637445,531775,1169220,637445,531775,1169220,Basketball
32224,2016,224554,Texas A & M University-Commerce,Commerce,TX,75429,4,NCAA Division II with football,2456,3551,6007,1,"Public, 4-year or above",2,16,16,720376,633194,1353570,720376,633194,1353570,Basketball
49747,2017,224554,Texas A & M University-Commerce,Commerce,TX,75429,4,NCAA Division II with football,2467,3593,6060,1,"Public, 4-year or above",2,13,17,818350,675655,1494005,818350,675655,1494005,Basketball
67521,2018,224554,Texas A & M University-Commerce,Commerce,TX,75429,4,NCAA Division II with football,2450,3620,6070,1,"Public, 4-year or above",2,17,14,803609,699361,1502970,953726,715766,1669492,Basketball
121808,2019,224554,Texas A & M University-Commerce,Commerce,TX,75429,4,NCAA Division II with football,2510,3631,6141,1,"Public, 4-year or above",2,18,16,699284,703238,1402522,803507,700847,1504354,Basketball
14714,2015,224147,Texas A & M University-Corpus Christi,Corpus Christi,TX,784125503,3,NCAA Division I without football,2982,4304,7286,1,"Public, 4-year or above",2,16,17,1680402,1166476,2846878,1680402,1166476,2846878,Basketball
32184,2016,224147,Texas A & M University-Corpus Christi,Corpus Christi,TX,78412,3,NCAA Division I without football,3439,4812,8251,1,"Public, 4-year or above",2,16,18,1789263,1226717,3015980,1789263,1226717,3015980,Basketball
49706,2017,224147,Texas A & M University-Corpus Christi,Corpus Christi,TX,78412,3,NCAA Division I without football,3512,4843,8355,1,"Public, 4-year or above",2,17,23,1806166,1296580,3102746,1806166,1296580,3102746,Basketball
67479,2018,224147,Texas A & M University-Corpus Christi,Corpus Christi,TX,78412,3,NCAA Division I without football,3123,4574,7697,1,"Public, 4-year or above",2,14,16,1901648,1407524,3309172,1901648,1407524,3309172,Basketball
121644,2019,224147,Texas A & M University-Corpus Christi,Corpus Christi,TX,78412,3,NCAA Division I without football,2863,4326,7189,1,"Public, 4-year or above",2,15,15,1868445,1338665,3207110,1868445,1338665,3207110,Basketball
15160,2015,228705,Texas A & M University-Kingsville,Kingsville,TX,78363,4,NCAA Division II with football,2766,2279,5045,1,"Public, 4-year or above",2,18,14,489683,434929,924612,489683,434929,924612,Basketball
32629,2016,228705,Texas A & M University-Kingsville,Kingsville,TX,78363,4,NCAA Division II with football,2756,2338,5094,1,"Public, 4-year or above",2,18,16,552673,460786,1013459,552673,460786,1013459,Basketball
50155,2017,228705,Texas A & M University-Kingsville,Kingsville,TX,78363,4,NCAA Division II with football,2682,2323,5005,1,"Public, 4-year or above",2,19,14,496466,498208,994674,496466,498208,994674,Basketball
67931,2018,228705,Texas A & M University-Kingsville,Kingsville,TX,78363,4,NCAA Division II with football,2704,2443,5147,1,"Public, 4-year or above",2,23,13,555966,462969,1018935,555966,462969,1018935,Basketball
123830,2019,228705,Texas A & M University-Kingsville,Kingsville,TX,78363,4,NCAA Division II with football,2387,2243,4630,1,"Public, 4-year or above",2,19,13,586756,468633,1055389,586756,468633,1055389,Basketball
15224,2015,228875,Texas Christian University,Fort Worth,TX,76129,1,NCAA Division I-FBS,3395,5179,8574,2,"Private nonprofit, 4-year or above",2,13,25,10398422,4215228,14613650,11256999,5376662,16633661,Basketball
32694,2016,228875,Texas Christian University,Fort Worth,TX,76129,1,NCAA Division I-FBS,3381,5210,8591,2,"Private nonprofit, 4-year or above",2,16,30,12889761,4121114,17010875,15168356,5916970,21085326,Basketball
50220,2017,228875,Texas Christian University,Fort Worth,TX,76129,1,NCAA Division I-FBS,3530,5197,8727,2,"Private nonprofit, 4-year or above",2,16,30,16239880,7675154,23915034,17007743,8714436,25722179,Basketball
67996,2018,228875,Texas Christian University,Fort Worth,TX,76129,1,NCAA Division I-FBS,3746,5403,9149,2,"Private nonprofit, 4-year or above",2,19,39,14852389,6441739,21294128,15718763,8425360,24144123,Basketball
124068,2019,228875,Texas Christian University,Fort Worth,TX,76129,1,NCAA Division I-FBS,3812,5395,9207,2,"Private nonprofit, 4-year or above",2,21,35,12557097,5718915,18276012,13447019,7003954,20450973,Basketball
15243,2015,228981,Texas Lutheran University,Seguin,TX,781555999,6,NCAA Division III with football,635,647,1282,2,"Private nonprofit, 4-year or above",2,18,19,199615,139931,339546,195822,139557,335379,Basketball
32713,2016,228981,Texas Lutheran University,Seguin,TX,78155,6,NCAA Division III with football,599,613,1212,2,"Private nonprofit, 4-year or above",2,21,19,206725,138441,345166,183833,135246,319079,Basketball
50240,2017,228981,Texas Lutheran University,Seguin,TX,78155,6,NCAA Division III with football,629,676,1305,2,"Private nonprofit, 4-year or above",2,16,19,157163,161395,318558,154908,145188,300096,Basketball
68016,2018,228981,Texas Lutheran University,Seguin,TX,78155,6,NCAA Division III with football,669,668,1337,2,"Private nonprofit, 4-year or above",2,22,24,182187,164340,346527,172924,164212,337136,Basketball
124114,2019,228981,Texas Lutheran University,Seguin,TX,78155,6,NCAA Division III with football,680,699,1379,2,"Private nonprofit, 4-year or above",2,15,18,179861,145012,324873,177589,145012,322601,Basketball
15270,2015,229063,Texas Southern University,Houston,TX,77004,2,NCAA Division I-FCS,2560,3324,5884,1,"Public, 4-year or above",2,14,13,1400553,952425,2352978,1400553,952425,2352978,Basketball
32742,2016,229063,Texas Southern University,Houston,TX,77004,2,NCAA Division I-FCS,2619,3157,5776,1,"Public, 4-year or above",2,17,14,1429460,941174,2370634,1429460,941174,2370634,Basketball
50270,2017,229063,Texas Southern University,Houston,TX,77004,2,NCAA Division I-FCS,2972,3723,6695,1,"Public, 4-year or above",2,15,14,1616260,906016,2522276,1616260,906016,2522276,Basketball
68045,2018,229063,Texas Southern University,Houston,TX,77004,2,NCAA Division I-FCS,2785,3718,6503,1,"Public, 4-year or above",2,15,15,1713806,960697,2674503,1696591,1012444,2709035,Basketball
124201,2019,229063,Texas Southern University,Houston,TX,77004,2,NCAA Division I-FCS,2452,3580,6032,1,"Public, 4-year or above",2,14,16,1781573,998685,2780258,1634270,1215335,2849605,Basketball
15124,2015,228459,Texas State University,San Marcos,TX,78666,1,NCAA Division I-FBS,11519,15850,27369,1,"Public, 4-year or above",2,15,21,1824046,1414227,3238273,1824046,1414227,3238273,Basketball
32593,2016,228459,Texas State University,San Marcos,TX,78666,1,NCAA Division I-FBS,11896,16284,28180,1,"Public, 4-year or above",2,14,19,1814763,1340276,3155039,1814763,1340276,3155039,Basketball
50119,2017,228459,Texas State University,San Marcos,TX,78666,1,NCAA Division I-FBS,11701,16318,28019,1,"Public, 4-year or above",2,15,12,1941262,1378102,3319364,1780065,1381730,3161795,Basketball
67897,2018,228459,Texas State University,San Marcos,TX,78666,1,NCAA Division I-FBS,11625,16417,28042,1,"Public, 4-year or above",2,15,12,1976474,1350513,3326987,1976474,1350513,3326987,Basketball
123728,2019,228459,Texas State University,San Marcos,TX,78666,1,NCAA Division I-FBS,11430,16493,27923,1,"Public, 4-year or above",2,14,14,1790209,1289596,3079805,1790209,1289596,3079805,Basketball
15281,2015,229115,Texas Tech University,Lubbock,TX,794095005,1,NCAA Division I-FBS,14314,11741,26055,1,"Public, 4-year or above",2,15,15,7057773,1000010,8057783,7348405,4130179,11478584,Basketball
32753,2016,229115,Texas Tech University,Lubbock,TX,79409,1,NCAA Division I-FBS,14522,12066,26588,1,"Public, 4-year or above",2,16,14,8005272,1011415,9016687,7027324,4249087,11276411,Basketball
50281,2017,229115,Texas Tech University,Lubbock,TX,79409,1,NCAA Division I-FBS,14524,12757,27281,1,"Public, 4-year or above",2,17,14,9889275,1410011,11299286,9020201,4983413,14003614,Basketball
68056,2018,229115,Texas Tech University,Lubbock,TX,79409,1,NCAA Division I-FBS,14631,12962,27593,1,"Public, 4-year or above",2,14,13,12382899,1110694,13493593,12338645,4291342,16629987,Basketball
124239,2019,229115,Texas Tech University,Lubbock,TX,79409,1,NCAA Division I-FBS,14529,13508,28037,1,"Public, 4-year or above",2,15,12,12123903,1196433,13320336,11578946,4114554,15693500,Basketball
15297,2015,229179,Texas Woman's University,Denton,TX,76201,5,NCAA Division II without football,710,6224,6934,1,"Public, 4-year or above",2,0,17,NA,554596,554596,NA,553329,553329,Basketball
32770,2016,229179,Texas Woman's University,Denton,TX,76204,5,NCAA Division II without football,668,6338,7006,1,"Public, 4-year or above",2,0,14,NA,536825,536825,NA,555013,555013,Basketball
50298,2017,229179,Texas Woman's University,Denton,TX,76204,5,NCAA Division II without football,681,6279,6960,1,"Public, 4-year or above",2,0,14,NA,518540,518540,NA,546579,546579,Basketball
68073,2018,229179,Texas Woman's University,Denton,TX,76204,5,NCAA Division II without football,673,6192,6865,1,"Public, 4-year or above",2,0,18,NA,516860,516860,NA,384555,384555,Basketball
124314,2019,229179,Texas Woman's University,Denton,TX,76204,5,NCAA Division II without football,695,6324,7019,1,"Public, 4-year or above",2,0,17,NA,537332,537332,NA,546287,546287,Basketball
79456,2019,131283,The Catholic University of America,Washington,DC,20064,6,NCAA Division III with football,1425,1738,3163,2,"Private nonprofit, 4-year or above",2,16,18,296577,250481,547058,265132,239628,504760,Basketball
9256,2015,187134,The College of New Jersey,Ewing,NJ,86287718,6,NCAA Division III with football,2601,3781,6382,1,"Public, 4-year or above",2,17,15,135784,183101,318885,135784,183101,318885,Basketball
26677,2016,187134,The College of New Jersey,Ewing,NJ,8628,6,NCAA Division III with football,2690,3729,6419,1,"Public, 4-year or above",2,17,15,120426,103811,224237,120426,103811,224237,Basketball
44172,2017,187134,The College of New Jersey,Ewing,NJ,8628,6,NCAA Division III with football,2828,3812,6640,1,"Public, 4-year or above",2,16,16,139586,120422,260008,139586,120422,260008,Basketball
61892,2018,187134,The College of New Jersey,Ewing,NJ,8628,6,NCAA Division III with football,2861,3864,6725,1,"Public, 4-year or above",2,16,14,167507,157552,325059,167507,157552,325059,Basketball
102874,2019,187134,The College of New Jersey,Ewing,NJ,8628,6,NCAA Division III with football,2794,3804,6598,1,"Public, 4-year or above",2,16,12,173678,153494,327172,173678,153494,327172,Basketball
10075,2015,193645,The College of New Rochelle,New Rochelle,NY,108052339,7,NCAA Division III without football,266,2267,2533,2,"Private nonprofit, 4-year or above",2,0,9,NA,30159,30159,NA,30159,30159,Basketball
27494,2016,193645,The College of New Rochelle,New Rochelle,NY,10805,7,NCAA Division III without football,299,2191,2490,2,"Private nonprofit, 4-year or above",2,18,13,66187,35564,101751,66187,35564,101751,Basketball
44983,2017,193645,The College of New Rochelle,New Rochelle,NY,10805,7,NCAA Division III without football,327,1897,2224,2,"Private nonprofit, 4-year or above",2,13,10,53752,31729,85481,53752,31729,85481,Basketball
10280,2015,195234,The College of Saint Rose,Albany,NY,122031490,5,NCAA Division II without football,866,1669,2535,2,"Private nonprofit, 4-year or above",2,17,15,639247,667094,1306341,636211,654669,1290880,Basketball
27702,2016,195234,The College of Saint Rose,Albany,NY,12203,5,NCAA Division II without football,833,1677,2510,2,"Private nonprofit, 4-year or above",2,15,14,698436,608276,1306712,698436,589532,1287968,Basketball
45189,2017,195234,The College of Saint Rose,Albany,NY,12203,5,NCAA Division II without football,790,1635,2425,2,"Private nonprofit, 4-year or above",2,14,12,618949,580906,1199855,618949,569439,1188388,Basketball
62897,2018,195234,The College of Saint Rose,Albany,NY,12203,5,NCAA Division II without football,791,1611,2402,2,"Private nonprofit, 4-year or above",2,15,12,473152,492074,965226,450387,482594,932981,Basketball
106121,2019,195234,The College of Saint Rose,Albany,NY,12203,5,NCAA Division II without football,810,1553,2363,2,"Private nonprofit, 4-year or above",2,14,10,519023,519726,1038749,489105,512122,1001227,Basketball
7797,2015,174899,The College of Saint Scholastica,Duluth,MN,558114199,6,NCAA Division III with football,695,1574,2269,2,"Private nonprofit, 4-year or above",2,18,16,163885,155354,319239,146592,121683,268275,Basketball
25211,2016,174899,The College of Saint Scholastica,Duluth,MN,55811,6,NCAA Division III with football,678,1571,2249,2,"Private nonprofit, 4-year or above",2,17,15,154867,165545,320412,136859,130447,267306,Basketball
42712,2017,174899,The College of Saint Scholastica,Duluth,MN,55811,6,NCAA Division III with football,664,1508,2172,2,"Private nonprofit, 4-year or above",2,13,18,151367,165588,316955,136382,135068,271450,Basketball
60418,2018,174899,The College of Saint Scholastica,Duluth,MN,55811,6,NCAA Division III with football,635,1426,2061,2,"Private nonprofit, 4-year or above",2,17,12,156848,172663,329511,146440,135053,281493,Basketball
97425,2019,174899,The College of Saint Scholastica,Duluth,MN,55811,6,NCAA Division III with football,642,1416,2058,2,"Private nonprofit, 4-year or above",2,18,15,166669,172045,338714,162709,133131,295840,Basketball
11982,2015,206589,The College of Wooster,Wooster,OH,44691,6,NCAA Division III with football,912,1104,2016,2,"Private nonprofit, 4-year or above",2,27,18,212579,116008,328587,193348,115639,308987,Basketball
29420,2016,206589,The College of Wooster,Wooster,OH,44691,6,NCAA Division III with football,899,1073,1972,2,"Private nonprofit, 4-year or above",2,23,16,206589,104614,311203,184512,104245,288757,Basketball
46928,2017,206589,The College of Wooster,Wooster,OH,44691,6,NCAA Division III with football,892,1067,1959,2,"Private nonprofit, 4-year or above",2,25,20,249134,98721,347855,230732,98721,329453,Basketball
64675,2018,206589,The College of Wooster,Wooster,OH,44691,6,NCAA Division III with football,916,1077,1993,2,"Private nonprofit, 4-year or above",2,23,16,318510,136210,454720,289112,131611,420723,Basketball
112029,2019,206589,The College of Wooster,Wooster,OH,44691,6,NCAA Division III with football,895,1039,1934,2,"Private nonprofit, 4-year or above",2,21,16,301972,140387,442359,278740,136809,415549,Basketball
13057,2015,213598,The Lincoln University,Lincoln University,PA,193520999,4,NCAA Division II with football,587,959,1546,1,"Public, 4-year or above",2,17,17,275442,268187,543629,275442,268187,543629,Basketball
10232,2015,195128,The Sage Colleges,Troy,NY,12180,7,NCAA Division III without football,282,1135,1417,2,"Private nonprofit, 4-year or above",2,13,14,82885,55364,138249,64468,57068,121536,Basketball
27654,2016,195128,The Sage Colleges,Troy,NY,12180,7,NCAA Division III without football,244,1033,1277,2,"Private nonprofit, 4-year or above",2,16,14,93927,59410,153337,93927,59410,153337,Basketball
45141,2017,195128,The Sage Colleges,Troy,NY,12180,7,NCAA Division III without football,228,928,1156,2,"Private nonprofit, 4-year or above",2,13,12,123154,113580,236734,122512,107894,230406,Basketball
62849,2018,195128,The Sage Colleges,Troy,NY,12180,7,NCAA Division III without football,280,1077,1357,2,"Private nonprofit, 4-year or above",2,17,15,136026,123254,259280,76583,79822,156405,Basketball
106017,2019,195128,The Sage Colleges,Troy,NY,12180,7,NCAA Division III without football,268,963,1231,2,"Private nonprofit, 4-year or above",2,15,13,158559,180300,338859,76286,109025,185311,Basketball
41,2015,100751,The University of Alabama,Tuscaloosa,AL,354870166,1,NCAA Division I-FBS,12929,15518,28447,1,"Public, 4-year or above",2,15,33,14446339,987004,15433343,8577428,3550880,12128308,Basketball
17387,2016,100751,The University of Alabama,Tuscaloosa,AL,35487,1,NCAA Division I-FBS,13038,16033,29071,1,"Public, 4-year or above",2,15,28,15003656,1013741,16017397,9681264,4042959,13724223,Basketball
34802,2017,100751,The University of Alabama,Tuscaloosa,AL,35487,1,NCAA Division I-FBS,13351,16471,29822,1,"Public, 4-year or above",2,17,30,15298808,998402,16297210,10276123,3737069,14013192,Basketball
52431,2018,100751,The University of Alabama,Tuscaloosa,AL,35487,1,NCAA Division I-FBS,13265,16223,29488,1,"Public, 4-year or above",2,16,27,16028795,1046269,17075064,15966875,3857300,19824175,Basketball
70287,2019,100751,The University of Alabama,Tuscaloosa,AL,35487,1,NCAA Division I-FBS,13112,15902,29014,1,"Public, 4-year or above",2,17,24,14722223,1008558,15730781,9429628,3805848,13235476,Basketball
11579,2015,202763,The University of Findlay,Findlay,OH,458403653,4,NCAA Division II with football,1000,1692,2692,2,"Private nonprofit, 4-year or above",2,26,32,694745,613170,1307915,659053,609674,1268727,Basketball
29016,2016,202763,The University of Findlay,Findlay,OH,45840,4,NCAA Division II with football,876,1685,2561,2,"Private nonprofit, 4-year or above",2,27,41,1289615,1196506,2486121,1264956,1190888,2455844,Basketball
46517,2017,202763,The University of Findlay,Findlay,OH,45840,4,NCAA Division II with football,824,1663,2487,2,"Private nonprofit, 4-year or above",2,31,27,693357,547201,1240558,646726,543567,1190293,Basketball
64242,2018,202763,The University of Findlay,Findlay,OH,45840,4,NCAA Division II with football,801,1617,2418,2,"Private nonprofit, 4-year or above",2,24,23,687649,623006,1310655,637109,619483,1256592,Basketball
110703,2019,202763,The University of Findlay,Findlay,OH,45840,4,NCAA Division II with football,716,1454,2170,2,"Private nonprofit, 4-year or above",2,30,28,778074,602615,1380689,744713,605970,1350683,Basketball
8517,2015,180489,The University of Montana,Missoula,MT,59812,2,NCAA Division I-FCS,3904,4694,8598,1,"Public, 4-year or above",2,16,14,1484257,838790,2323047,1678354,1347236,3025590,Basketball
25950,2016,180489,The University of Montana,Missoula,MT,59812,2,NCAA Division I-FCS,3586,4203,7789,1,"Public, 4-year or above",2,16,17,1645038,858594,2503632,1935268,1717133,3652401,Basketball
43440,2017,180489,The University of Montana,Missoula,MT,59812,2,NCAA Division I-FCS,3340,4051,7391,1,"Public, 4-year or above",2,16,15,1776525,950874,2727399,2275216,1535379,3810595,Basketball
61156,2018,180489,The University of Montana,Missoula,MT,59812,2,NCAA Division I-FCS,3017,3698,6715,1,"Public, 4-year or above",2,16,14,1974451,1413133,3387584,2452114,1413133,3865247,Basketball
100383,2019,180489,The University of Montana,Missoula,MT,59812,2,NCAA Division I-FCS,2726,3397,6123,1,"Public, 4-year or above",2,16,13,2390235,876304,3266539,2485860,1362393,3848253,Basketball
3075,2015,137847,The University of Tampa,Tampa,FL,336061490,5,NCAA Division II without football,2858,3960,6818,2,"Private nonprofit, 4-year or above",2,15,16,610900,640172,1251072,605675,644094,1249769,Basketball
20451,2016,137847,The University of Tampa,Tampa,FL,33606,5,NCAA Division II without football,2967,4157,7124,2,"Private nonprofit, 4-year or above",2,16,14,623982,677551,1301533,630171,652581,1282752,Basketball
37903,2017,137847,The University of Tampa,Tampa,FL,33606,5,NCAA Division II without football,3211,4517,7728,2,"Private nonprofit, 4-year or above",2,18,13,667623,679920,1347543,646674,669501,1316175,Basketball
55556,2018,137847,The University of Tampa,Tampa,FL,33606,5,NCAA Division II without football,3374,4771,8145,2,"Private nonprofit, 4-year or above",2,17,12,743593,721685,1465278,740818,703857,1444675,Basketball
81432,2019,137847,The University of Tampa,Tampa,FL,33606,5,NCAA Division II without football,3472,4968,8440,2,"Private nonprofit, 4-year or above",2,16,14,716883,702489,1419372,714203,681864,1396067,Basketball
14533,2015,221740,The University of Tennessee-Chattanooga,Chattanooga,TN,374032598,2,NCAA Division I-FCS,3781,4963,8744,1,"Public, 4-year or above",2,13,14,1793638,1437659,3231297,1793638,1437659,3231297,Basketball
31998,2016,221740,The University of Tennessee-Chattanooga,Chattanooga,TN,37403,2,NCAA Division I-FCS,3884,4984,8868,1,"Public, 4-year or above",2,15,15,1754295,1673511,3427806,1754295,1673511,3427806,Basketball
49518,2017,221740,The University of Tennessee-Chattanooga,Chattanooga,TN,37403,2,NCAA Division I-FCS,3878,5075,8953,1,"Public, 4-year or above",2,13,13,1760361,1278827,3039188,1760361,1278827,3039188,Basketball
67288,2018,221740,The University of Tennessee-Chattanooga,Chattanooga,TN,37403,2,NCAA Division I-FCS,3930,5160,9090,1,"Public, 4-year or above",2,12,14,1940945,1292068,3233013,1940945,1292068,3233013,Basketball
120957,2019,221740,The University of Tennessee-Chattanooga,Chattanooga,TN,37403,2,NCAA Division I-FCS,3980,5232,9212,1,"Public, 4-year or above",2,14,13,1936638,1231350,3167988,1936638,1231350,3167988,Basketball
14544,2015,221759,The University of Tennessee-Knoxville,Knoxville,TN,37996,1,NCAA Division I-FBS,10322,10145,20467,1,"Public, 4-year or above",2,15,25,18595510,4397709,22993219,6989935,5098213,12088148,Basketball
32009,2016,221759,The University of Tennessee-Knoxville,Knoxville,TN,37996,1,NCAA Division I-FBS,10476,10243,20719,1,"Public, 4-year or above",2,16,25,18322729,3944384,22267113,6977691,4583377,11561068,Basketball
49529,2017,221759,The University of Tennessee-Knoxville,Knoxville,TN,37996,1,NCAA Division I-FBS,10448,10461,20909,1,"Public, 4-year or above",2,16,26,15978734,3871125,19849859,8386526,4873207,13259733,Basketball
67299,2018,221759,The University of Tennessee-Knoxville,Knoxville,TN,37996,1,NCAA Division I-FBS,10485,10948,21433,1,"Public, 4-year or above",2,16,25,17003826,3504184,20508010,10554613,5136192,15690805,Basketball
120971,2019,221759,The University of Tennessee-Knoxville,Knoxville,TN,37996,1,NCAA Division I-FBS,10655,11317,21972,1,"Public, 4-year or above",2,17,33,16899321,3184798,20084119,10504401,5217050,15721451,Basketball
14555,2015,221768,The University of Tennessee-Martin,Martin,TN,382380002,2,NCAA Division I-FCS,2324,3057,5381,1,"Public, 4-year or above",2,14,14,1402526,939806,2342332,1340126,946601,2286727,Basketball
32020,2016,221768,The University of Tennessee-Martin,Martin,TN,38238,2,NCAA Division I-FCS,2156,2787,4943,1,"Public, 4-year or above",2,16,15,1089901,1033772,2123673,1149965,1090396,2240361,Basketball
49540,2017,221768,The University of Tennessee-Martin,Martin,TN,38238,2,NCAA Division I-FCS,2106,2829,4935,1,"Public, 4-year or above",2,13,14,1188617,1107662,2296279,1127522,1095190,2222712,Basketball
67310,2018,221768,The University of Tennessee-Martin,Martin,TN,38238,2,NCAA Division I-FCS,1992,2742,4734,1,"Public, 4-year or above",2,15,17,1270841,1290531,2561372,1119003,1212591,2331594,Basketball
121009,2019,221768,The University of Tennessee-Martin,Martin,TN,38238,2,NCAA Division I-FCS,1951,2792,4743,1,"Public, 4-year or above",2,15,18,1124225,1095660,2219885,1159933,1168240,2328173,Basketball
15179,2015,228769,The University of Texas at Arlington,Arlington,TX,76013,3,NCAA Division I without football,7963,8394,16357,1,"Public, 4-year or above",2,15,25,1549654,1280539,2830193,1549654,1280539,2830193,Basketball
32649,2016,228769,The University of Texas at Arlington,Arlington,TX,76013,3,NCAA Division I without football,8043,8620,16663,1,"Public, 4-year or above",2,15,24,1793780,1506501,3300281,1793780,1506501,3300281,Basketball
50175,2017,228769,The University of Texas at Arlington,Arlington,TX,76013,3,NCAA Division I without football,8542,9240,17782,1,"Public, 4-year or above",2,18,24,1943636,1633518,3577154,1943636,1633518,3577154,Basketball
67951,2018,228769,The University of Texas at Arlington,Arlington,TX,76013,3,NCAA Division I without football,8924,10378,19302,1,"Public, 4-year or above",2,16,26,2557576,1908696,4466272,2557576,1908696,4466272,Basketball
123906,2019,228769,The University of Texas at Arlington,Arlington,TX,76013,3,NCAA Division I without football,9038,10378,19416,1,"Public, 4-year or above",2,16,30,2264655,1777237,4041892,2264655,1777237,4041892,Basketball
15186,2015,228778,The University of Texas at Austin,Austin,TX,78712,1,NCAA Division I-FBS,17192,19165,36357,1,"Public, 4-year or above",2,15,40,17982782,1964453,19947235,10271419,5287394,15558813,Basketball
32656,2016,228778,The University of Texas at Austin,Austin,TX,78712,1,NCAA Division I-FBS,17325,19701,37026,1,"Public, 4-year or above",2,14,33,17567914,2689305,20257219,11430951,6273294,17704245,Basketball
50182,2017,228778,The University of Texas at Austin,Austin,TX,78712,1,NCAA Division I-FBS,17419,20091,37510,1,"Public, 4-year or above",2,15,28,18495410,2770515,21265925,11357338,5591029,16948367,Basketball
67958,2018,228778,The University of Texas at Austin,Austin,TX,78712,1,NCAA Division I-FBS,17313,20581,37894,1,"Public, 4-year or above",2,15,28,16493236,2305200,18798436,11649912,5335344,16985256,Basketball
123916,2019,228778,The University of Texas at Austin,Austin,TX,78712,1,NCAA Division I-FBS,16826,20536,37362,1,"Public, 4-year or above",2,18,29,13322731,1886797,15209528,10494885,7092327,17587212,Basketball
15197,2015,228787,The University of Texas at Dallas,Richardson,TX,750803021,7,NCAA Division III without football,7190,5548,12738,1,"Public, 4-year or above",2,22,22,196771,103782,300553,227209,210336,437545,Basketball
32667,2016,228787,The University of Texas at Dallas,Richardson,TX,75080,7,NCAA Division III without football,8140,6172,14312,1,"Public, 4-year or above",2,22,22,279650,254996,534646,263567,244640,508207,Basketball
50193,2017,228787,The University of Texas at Dallas,Richardson,TX,75080,7,NCAA Division III without football,8686,6590,15276,1,"Public, 4-year or above",2,20,23,261046,241321,502367,220449,202336,422785,Basketball
67969,2018,228787,The University of Texas at Dallas,Richardson,TX,75080,7,NCAA Division III without football,9457,7199,16656,1,"Public, 4-year or above",2,17,18,210744,194490,405234,169584,152457,322041,Basketball
123954,2019,228787,The University of Texas at Dallas,Richardson,TX,75080,7,NCAA Division III without football,10129,7790,17919,1,"Public, 4-year or above",2,18,19,239848,235248,475096,232602,214099,446701,Basketball
15204,2015,228796,The University of Texas at El Paso,El Paso,TX,799680691,1,NCAA Division I-FBS,6205,6892,13097,1,"Public, 4-year or above",2,17,17,4736010,1469013,6205023,3623777,2132342,5756119,Basketball
32674,2016,228796,The University of Texas at El Paso,El Paso,TX,79968,1,NCAA Division I-FBS,6451,6870,13321,1,"Public, 4-year or above",2,17,17,5157556,2428748,7586304,4135511,2560580,6696091,Basketball
50200,2017,228796,The University of Texas at El Paso,El Paso,TX,79968,1,NCAA Division I-FBS,6809,7205,14014,1,"Public, 4-year or above",2,19,13,4889206,2358579,7247785,4166643,2358578,6525221,Basketball
67976,2018,228796,The University of Texas at El Paso,El Paso,TX,79968,1,NCAA Division I-FBS,6693,7338,14031,1,"Public, 4-year or above",2,18,11,5016121,2367876,7383997,4247850,2623922,6871772,Basketball
123992,2019,228796,The University of Texas at El Paso,El Paso,TX,79968,1,NCAA Division I-FBS,6530,7310,13840,1,"Public, 4-year or above",2,18,14,4722860,1938914,6661774,3380983,1867232,5248215,Basketball
15261,2015,229027,The University of Texas at San Antonio,San Antonio,TX,782491644,1,NCAA Division I-FBS,9947,10092,20039,1,"Public, 4-year or above",2,15,16,1791403,1243745,3035148,1791403,1243745,3035148,Basketball
32733,2016,229027,The University of Texas at San Antonio,San Antonio,TX,78249,1,NCAA Division I-FBS,9781,10214,19995,1,"Public, 4-year or above",2,15,14,1993006,1298135,3291141,1993006,1298135,3291141,Basketball
50261,2017,229027,The University of Texas at San Antonio,San Antonio,TX,78249,1,NCAA Division I-FBS,10460,10804,21264,1,"Public, 4-year or above",2,15,14,2181947,1330272,3512219,2181947,1330272,3512219,Basketball
68036,2018,229027,The University of Texas at San Antonio,San Antonio,TX,78249,1,NCAA Division I-FBS,11010,11373,22383,1,"Public, 4-year or above",2,14,14,2239480,1342046,3581526,2239480,1342046,3581526,Basketball
124163,2019,229027,The University of Texas at San Antonio,San Antonio,TX,78249,1,NCAA Division I-FBS,10846,11439,22285,1,"Public, 4-year or above",2,14,14,2398192,1285558,3683750,2398192,1285558,3683750,Basketball
15214,2015,228802,The University of Texas at Tyler,Tyler,TX,757996699,7,NCAA Division III without football,1979,2590,4569,1,"Public, 4-year or above",2,20,24,234070,182365,416435,234070,182365,416435,Basketball
32684,2016,228802,The University of Texas at Tyler,Tyler,TX,75799,7,NCAA Division III without football,2089,2701,4790,1,"Public, 4-year or above",2,19,21,248120,183280,431400,205373,175157,380530,Basketball
50210,2017,228802,The University of Texas at Tyler,Tyler,TX,75799,7,NCAA Division III without football,2117,2670,4787,1,"Public, 4-year or above",2,14,18,241462,166393,407855,201078,152034,353112,Basketball
67986,2018,228802,The University of Texas at Tyler,Tyler,TX,75799,7,NCAA Division III without football,2052,2651,4703,1,"Public, 4-year or above",2,17,18,270287,219089,489376,270287,219089,489376,Basketball
124030,2019,228802,The University of Texas at Tyler,Tyler,TX,75799,5,NCAA Division II without football,2075,2688,4763,1,"Public, 4-year or above",2,18,21,592533,410259,1002792,592533,410259,1002792,Basketball
15253,2015,229018,The University of Texas of the Permian Basin,Odessa,TX,797620001,5,NCAA Division II without football,1021,1103,2124,1,"Public, 4-year or above",2,19,19,323660,248177,571837,323660,248177,571837,Basketball
32723,2016,229018,The University of Texas of the Permian Basin,Odessa,TX,79762,4,NCAA Division II with football,1027,1139,2166,1,"Public, 4-year or above",2,17,17,262854,241608,504462,262854,241608,504462,Basketball
50250,2017,229018,The University of Texas of the Permian Basin,Odessa,TX,79762,4,NCAA Division II with football,1010,1143,2153,1,"Public, 4-year or above",2,15,18,184557,128751,313308,302360,191223,493583,Basketball
68026,2018,229018,The University of Texas of the Permian Basin,Odessa,TX,79762,4,NCAA Division II with football,971,1027,1998,1,"Public, 4-year or above",2,15,20,340139,386949,727088,381991,445447,827438,Basketball
124125,2019,229018,The University of Texas of the Permian Basin,Odessa,TX,79762,4,NCAA Division II with football,893,962,1855,1,"Public, 4-year or above",2,17,21,490636,362119,852755,447749,359653,807402,Basketball
14987,2015,227368,The University of Texas Rio Grande Valley,Edinburg,TX,785392999,3,NCAA Division I without football,7600,9928,17528,1,"Public, 4-year or above",2,18,18,1404530,1258036,2662566,1404530,1258036,2662566,Basketball
32456,2016,227368,The University of Texas Rio Grande Valley,Edinburg,TX,78539,3,NCAA Division I without football,7703,10141,17844,1,"Public, 4-year or above",2,17,20,1410382,1168385,2578767,1410382,1168385,2578767,Basketball
49983,2017,227368,The University of Texas Rio Grande Valley,Edinburg,TX,78539,3,NCAA Division I without football,8056,10582,18638,1,"Public, 4-year or above",2,15,18,1589120,1375677,2964797,1589120,1375677,2964797,Basketball
67762,2018,227368,The University of Texas Rio Grande Valley,Edinburg,TX,78539,3,NCAA Division I without football,8182,10937,19119,1,"Public, 4-year or above",2,15,21,1652983,1269967,2922950,1652983,1269967,2922950,Basketball
123062,2019,227368,The University of Texas Rio Grande Valley,Edinburg,TX,78539,3,NCAA Division I without football,8343,11556,19899,1,"Public, 4-year or above",2,16,17,1710975,1112390,2823365,1710975,1112390,2823365,Basketball
120882,2019,221519,The University of the South,Sewanee,TN,37383,6,NCAA Division III with football,815,854,1669,2,"Private nonprofit, 4-year or above",2,15,12,167666,162892,330558,167666,162892,330558,Basketball
15873,2015,233897,The University of Virginia's College at Wise,Wise,VA,242934400,4,NCAA Division II with football,651,670,1321,1,"Public, 4-year or above",2,17,11,343904,325401,669305,343276,324699,667975,Basketball
33347,2016,233897,The University of Virginia's College at Wise,Wise,VA,24293,4,NCAA Division II with football,645,633,1278,1,"Public, 4-year or above",2,14,19,332180,338460,670640,332180,338460,670640,Basketball
50898,2017,233897,The University of Virginia's College at Wise,Wise,VA,24293,4,NCAA Division II with football,572,616,1188,1,"Public, 4-year or above",2,15,14,342709,315643,658352,342709,315643,658352,Basketball
68646,2018,233897,The University of Virginia's College at Wise,Wise,VA,24293,4,NCAA Division II with football,554,575,1129,1,"Public, 4-year or above",2,14,15,349776,341526,691302,349776,341526,691302,Basketball
126219,2019,233897,The University of Virginia's College at Wise,Wise,VA,24293,4,NCAA Division II with football,531,554,1085,1,"Public, 4-year or above",2,14,13,386655,323458,710113,386655,323458,710113,Basketball
3115,2015,138354,The University of West Florida,Pensacola,FL,325145750,5,NCAA Division II without football,3097,3928,7025,1,"Public, 4-year or above",2,14,15,526520,538240,1064760,526520,538240,1064760,Basketball
20489,2016,138354,The University of West Florida,Pensacola,FL,32514,4,NCAA Division II with football,3083,3914,6997,1,"Public, 4-year or above",2,14,13,544885,539989,1084874,539889,576473,1116362,Basketball
37947,2017,138354,The University of West Florida,Pensacola,FL,32514,4,NCAA Division II with football,3003,3781,6784,1,"Public, 4-year or above",2,13,15,580729,510590,1091319,603089,530295,1133384,Basketball
55599,2018,138354,The University of West Florida,Pensacola,FL,32514,4,NCAA Division II with football,2996,3674,6670,1,"Public, 4-year or above",2,15,13,567847,531917,1099764,580534,562145,1142679,Basketball
81599,2019,138354,The University of West Florida,Pensacola,FL,32514,4,NCAA Division II with football,2946,3576,6522,1,"Public, 4-year or above",2,13,12,575045,513099,1088144,575112,485287,1060399,Basketball
13606,2015,216357,Thiel College,Greenville,PA,161252181,6,NCAA Division III with football,479,387,866,2,"Private nonprofit, 4-year or above",2,11,18,124348,91470,215818,124348,91470,215818,Basketball
31065,2016,216357,Thiel College,Greenville,PA,16125,6,NCAA Division III with football,491,355,846,2,"Private nonprofit, 4-year or above",2,20,16,135863,88857,224720,135863,88857,224720,Basketball
48577,2017,216357,Thiel College,Greenville,PA,16125,6,NCAA Division III with football,427,306,733,2,"Private nonprofit, 4-year or above",2,18,13,130555,78780,209335,130555,78780,209335,Basketball
66319,2018,216357,Thiel College,Greenville,PA,16125,6,NCAA Division III with football,409,292,701,2,"Private nonprofit, 4-year or above",2,15,13,125547,108539,234086,125547,108539,234086,Basketball
117581,2019,216357,Thiel College,Greenville,PA,16125,6,NCAA Division III with football,372,317,689,2,"Private nonprofit, 4-year or above",2,12,10,126714,114422,241136,126714,114422,241136,Basketball
6025,2015,161563,Thomas College,Waterville,ME,49015097,7,NCAA Division III without football,424,384,808,2,"Private nonprofit, 4-year or above",2,24,9,111654,81136,192790,108559,79961,188520,Basketball
23412,2016,161563,Thomas College,Waterville,ME,4901,7,NCAA Division III without football,427,419,846,2,"Private nonprofit, 4-year or above",2,18,12,121158,96613,217771,110533,94456,204989,Basketball
40914,2017,161563,Thomas College,Waterville,ME,4901,7,NCAA Division III without football,424,350,774,2,"Private nonprofit, 4-year or above",2,21,13,116524,92552,209076,109839,89567,199406,Basketball
58603,2018,161563,Thomas College,Waterville,ME,4901,7,NCAA Division III without football,410,372,782,2,"Private nonprofit, 4-year or above",2,16,14,81617,70905,152522,80233,68171,148404,Basketball
91792,2019,161563,Thomas College,Waterville,ME,4901,7,NCAA Division III without football,371,353,724,2,"Private nonprofit, 4-year or above",2,10,13,74599,60932,135531,70075,59295,129370,Basketball
66330,2018,216366,Thomas Jefferson University,Philadelphia,PA,19107,4,NCAA Division II with football,831,2105,2936,2,"Private nonprofit, 4-year or above",2,13,12,490357,521890,1012247,485372,517533,1002905,Basketball
117619,2019,216366,Thomas Jefferson University,Philadelphia,PA,19107,5,NCAA Division II without football,844,2202,3046,2,"Private nonprofit, 4-year or above",2,14,14,489753,515779,1005532,577345,593612,1170957,Basketball
5672,2015,157809,Thomas More College,Crestview Hills,KY,410173495,6,NCAA Division III with football,605,667,1272,2,"Private nonprofit, 4-year or above",2,23,21,122784,174065,296849,109972,120548,230520,Basketball
23051,2016,157809,Thomas More College,Crestview Hills,KY,41017,6,NCAA Division III with football,700,674,1374,2,"Private nonprofit, 4-year or above",2,35,22,139552,131538,271090,114334,129665,243999,Basketball
40548,2017,157809,Thomas More College,Crestview Hills,KY,41017,6,NCAA Division III with football,693,662,1355,2,"Private nonprofit, 4-year or above",2,32,16,189315,159431,348746,150630,141874,292504,Basketball
58230,2018,157809,Thomas More College,Crestview Hills,KY,41017,6,NCAA Division III with football,716,684,1400,2,"Private nonprofit, 4-year or above",2,20,17,158584,155391,313975,116970,130962,247932,Basketball
11901,2015,206048,Tiffin University,Tiffin,OH,44883,4,NCAA Division II with football,959,835,1794,2,"Private nonprofit, 4-year or above",2,37,19,486552,389918,876470,481551,386917,868468,Basketball
29342,2016,206048,Tiffin University,Tiffin,OH,44883,4,NCAA Division II with football,1012,736,1748,2,"Private nonprofit, 4-year or above",2,25,14,557514,419883,977397,554859,419883,974742,Basketball
46845,2017,206048,Tiffin University,Tiffin,OH,44883,4,NCAA Division II with football,1000,762,1762,2,"Private nonprofit, 4-year or above",2,29,22,557688,470020,1027708,551493,468825,1020318,Basketball
64587,2018,206048,Tiffin University,Tiffin,OH,44883,4,NCAA Division II with football,928,780,1708,2,"Private nonprofit, 4-year or above",2,33,19,561755,476179,1037934,561755,476179,1037934,Basketball
111808,2019,206048,Tiffin University,Tiffin,OH,44883,4,NCAA Division II with football,878,756,1634,2,"Private nonprofit, 4-year or above",2,30,21,595090,530870,1125960,595090,530870,1125960,Basketball
6273,2015,164076,Towson University,Towson,MD,212520001,2,NCAA Division I-FCS,6579,10133,16712,1,"Public, 4-year or above",2,15,16,2016322,1576902,3593224,2016322,1576902,3593224,Basketball
23656,2016,164076,Towson University,Towson,MD,21252,2,NCAA Division I-FCS,6604,10223,16827,1,"Public, 4-year or above",2,14,15,1948144,1477223,3425367,1948144,1477223,3425367,Basketball
41160,2017,164076,Towson University,Towson,MD,21252,2,NCAA Division I-FCS,6751,10307,17058,1,"Public, 4-year or above",2,14,17,2112673,1490256,3602929,2112673,1490256,3602929,Basketball
58856,2018,164076,Towson University,Towson,MD,21252,2,NCAA Division I-FCS,6885,10419,17304,1,"Public, 4-year or above",2,14,17,2259918,1791891,4051809,2259918,1791891,4051809,Basketball
92694,2019,164076,Towson University,Towson,MD,21252,2,NCAA Division I-FCS,6871,10300,17171,1,"Public, 4-year or above",2,17,18,2411465,1972489,4383954,2411465,1972489,4383954,Basketball
5685,2015,157818,Transylvania University,Lexington,KY,405081797,7,NCAA Division III without football,437,609,1046,2,"Private nonprofit, 4-year or above",2,18,17,370777,264415,635192,370777,264415,635192,Basketball
23063,2016,157818,Transylvania University,Lexington,KY,40508,7,NCAA Division III without football,395,558,953,2,"Private nonprofit, 4-year or above",2,17,14,368084,257204,625288,368084,257204,625288,Basketball
40560,2017,157818,Transylvania University,Lexington,KY,40508,7,NCAA Division III without football,384,579,963,2,"Private nonprofit, 4-year or above",2,20,19,315702,302787,618489,315702,302787,618489,Basketball
58245,2018,157818,Transylvania University,Lexington,KY,40508,7,NCAA Division III without football,392,584,976,2,"Private nonprofit, 4-year or above",2,20,19,377882,303773,681655,377882,303773,681655,Basketball
90421,2019,157818,Transylvania University,Lexington,KY,40508,7,NCAA Division III without football,376,567,943,2,"Private nonprofit, 4-year or above",2,30,14,266841,233147,499988,266841,233147,499988,Basketball
14583,2015,221892,Trevecca Nazarene University,Nashville,TN,37210,5,NCAA Division II without football,537,707,1244,2,"Private nonprofit, 4-year or above",2,21,15,506396,464689,971085,506396,464689,971085,Basketball
32052,2016,221892,Trevecca Nazarene University,Nashville,TN,37210,5,NCAA Division II without football,503,748,1251,2,"Private nonprofit, 4-year or above",2,16,16,484461,463240,947701,481094,463240,944334,Basketball
49569,2017,221892,Trevecca Nazarene University,Nashville,TN,37210,5,NCAA Division II without football,523,794,1317,2,"Private nonprofit, 4-year or above",2,18,16,508805,526788,1035593,508801,519124,1027925,Basketball
67340,2018,221892,Trevecca Nazarene University,Nashville,TN,37210,5,NCAA Division II without football,697,1189,1886,2,"Private nonprofit, 4-year or above",2,24,15,613434,516158,1129592,613434,516158,1129592,Basketball
121067,2019,221892,Trevecca Nazarene University,Nashville,TN,37210,5,NCAA Division II without football,738,1175,1913,2,"Private nonprofit, 4-year or above",2,26,26,671604,610277,1281881,670451,597006,1267457,Basketball
4658,2015,152567,Trine University,Angola,IN,467031764,6,NCAA Division III with football,1215,463,1678,2,"Private nonprofit, 4-year or above",2,29,25,239865,150081,389946,235306,141841,377147,Basketball
22019,2016,152567,Trine University,Angola,IN,46703,6,NCAA Division III with football,1234,469,1703,2,"Private nonprofit, 4-year or above",2,26,18,264794,171595,436389,256959,165838,422797,Basketball
39490,2017,152567,Trine University,Angola,IN,46703,6,NCAA Division III with football,1349,551,1900,2,"Private nonprofit, 4-year or above",2,26,27,278811,205050,483861,240984,190215,431199,Basketball
57152,2018,152567,Trine University,Angola,IN,46703,6,NCAA Division III with football,1379,628,2007,2,"Private nonprofit, 4-year or above",2,27,23,290051,177087,467138,282444,206307,488751,Basketball
87111,2019,152567,Trine University,Angola,IN,46703,6,NCAA Division III with football,1383,704,2087,2,"Private nonprofit, 4-year or above",2,27,26,281236,253987,535223,287628,270460,558088,Basketball
2490,2015,130590,Trinity College,Hartford,CT,61063100,6,NCAA Division III with football,1124,1013,2137,2,"Private nonprofit, 4-year or above",2,19,17,183566,120037,303603,190875,149221,340096,Basketball
19860,2016,130590,Trinity College,Hartford,CT,6106,6,NCAA Division III with football,1104,1028,2132,2,"Private nonprofit, 4-year or above",2,17,16,221498,145536,367034,186751,153727,340478,Basketball
37299,2017,130590,Trinity College,Hartford,CT,6106,6,NCAA Division III with football,1033,1057,2090,2,"Private nonprofit, 4-year or above",2,16,17,236106,126721,362827,212428,170277,382705,Basketball
54936,2018,130590,Trinity College,Hartford,CT,6106,6,NCAA Division III with football,1052,1046,2098,2,"Private nonprofit, 4-year or above",2,18,13,274741,193202,467943,232804,193202,426006,Basketball
79194,2019,130590,Trinity College,Hartford,CT,6106,6,NCAA Division III with football,1057,1052,2109,2,"Private nonprofit, 4-year or above",2,17,13,320889,210724,531613,237756,206409,444165,Basketball
15303,2015,229267,Trinity University,San Antonio,TX,782127200,6,NCAA Division III with football,1041,1146,2187,2,"Private nonprofit, 4-year or above",2,22,16,222808,196578,419386,210534,176404,386938,Basketball
32776,2016,229267,Trinity University,San Antonio,TX,78212,6,NCAA Division III with football,1053,1191,2244,2,"Private nonprofit, 4-year or above",2,22,16,224557,210035,434592,217525,201139,418664,Basketball
50304,2017,229267,Trinity University,San Antonio,TX,78212,6,NCAA Division III with football,1095,1258,2353,2,"Private nonprofit, 4-year or above",2,18,16,275857,259831,535688,262398,258370,520768,Basketball
68079,2018,229267,Trinity University,San Antonio,TX,78212,6,NCAA Division III with football,1138,1293,2431,2,"Private nonprofit, 4-year or above",2,17,14,269865,257921,527786,266353,260887,527240,Basketball
124320,2019,229267,Trinity University,San Antonio,TX,78212,6,NCAA Division III with football,1139,1258,2397,2,"Private nonprofit, 4-year or above",2,19,19,257403,284899,542302,262912,271839,534751,Basketball
2683,2015,131876,Trinity Washington University,Washington,DC,200171094,7,NCAA Division III without football,11,1043,1054,2,"Private nonprofit, 4-year or above",2,0,10,NA,37559,37559,NA,37559,37559,Basketball
20056,2016,131876,Trinity Washington University,Washington,DC,20017,7,NCAA Division III without football,8,1063,1071,2,"Private nonprofit, 4-year or above",2,0,15,NA,36808,36808,NA,36808,36808,Basketball
37495,2017,131876,Trinity Washington University,Washington,DC,20017,7,NCAA Division III without football,9,1066,1075,2,"Private nonprofit, 4-year or above",2,0,8,NA,39348,39348,NA,39348,39348,Basketball
55139,2018,131876,Trinity Washington University,Washington,DC,20017,7,NCAA Division III without football,6,1000,1006,2,"Private nonprofit, 4-year or above",2,0,10,NA,49323,49323,NA,49323,49323,Basketball
79658,2019,131876,Trinity Washington University,Washington,DC,20017,7,NCAA Division III without football,9,978,987,2,"Private nonprofit, 4-year or above",2,0,9,NA,50085,50085,NA,50085,50085,Basketball
282,2015,102368,Troy University,Troy,AL,360820001,1,NCAA Division I-FBS,3530,5427,8957,1,"Public, 4-year or above",2,14,16,1353567,1098431,2451998,1355678,1080735,2436413,Basketball
17624,2016,102368,Troy University,Troy,AL,36082,1,NCAA Division I-FBS,3711,5618,9329,1,"Public, 4-year or above",2,15,16,2569292,2165077,4734369,2628993,2301390,4930383,Basketball
35037,2017,102368,Troy University,Troy,AL,36082,1,NCAA Division I-FBS,3790,5682,9472,1,"Public, 4-year or above",2,14,15,2176060,1961204,4137264,2775231,1960829,4736060,Basketball
52664,2018,102368,Troy University,Troy,AL,36082,1,NCAA Division I-FBS,3542,5584,9126,1,"Public, 4-year or above",2,15,15,2198323,1316628,3514951,2604565,2053677,4658242,Basketball
71479,2019,102368,Troy University,Troy,AL,36082,1,NCAA Division I-FBS,3281,5406,8687,1,"Public, 4-year or above",2,15,14,2486520,2347250,4833770,2021091,1865294,3886385,Basketball
8311,2015,178615,Truman State University,Kirksville,MO,635014221,4,NCAA Division II with football,2151,2988,5139,1,"Public, 4-year or above",2,16,17,406772,444585,851357,406772,444585,851357,Basketball
25742,2016,178615,Truman State University,Kirksville,MO,63501,4,NCAA Division II with football,2128,2996,5124,1,"Public, 4-year or above",2,17,15,461918,434938,896856,461918,434938,896856,Basketball
43232,2017,178615,Truman State University,Kirksville,MO,63501,4,NCAA Division II with football,2098,2995,5093,1,"Public, 4-year or above",2,18,18,492918,451725,944643,492918,451725,944643,Basketball
60951,2018,178615,Truman State University,Kirksville,MO,63501,4,NCAA Division II with football,1920,2814,4734,1,"Public, 4-year or above",2,18,15,447087,475600,922687,447087,475600,922687,Basketball
99471,2019,178615,Truman State University,Kirksville,MO,63501,4,NCAA Division II with football,1706,2545,4251,1,"Public, 4-year or above",2,20,15,512338,427747,940085,512338,427747,940085,Basketball
6877,2015,168148,Tufts University,Medford,MA,21555555,6,NCAA Division III with football,2595,2601,5196,2,"Private nonprofit, 4-year or above",2,15,15,150737,220262,370999,150737,190571,341308,Basketball
24268,2016,168148,Tufts University,Medford,MA,2155,6,NCAA Division III with football,2694,2720,5414,2,"Private nonprofit, 4-year or above",2,15,14,163848,180679,344527,163848,180891,344739,Basketball
41772,2017,168148,Tufts University,Medford,MA,2155,6,NCAA Division III with football,2682,2780,5462,2,"Private nonprofit, 4-year or above",2,14,17,203117,241858,444975,203117,215531,418648,Basketball
59465,2018,168148,Tufts University,Medford,MA,2155,6,NCAA Division III with football,2621,2867,5488,2,"Private nonprofit, 4-year or above",2,13,14,180793,257548,438341,186368,221566,407934,Basketball
94373,2019,168148,Tufts University,Medford,MA,2155,6,NCAA Division III with football,2674,3049,5723,2,"Private nonprofit, 4-year or above",2,15,14,226272,255669,481941,222294,205466,427760,Basketball
5875,2015,160755,Tulane University of Louisiana,New Orleans,LA,701185698,1,NCAA Division I-FBS,2667,3664,6331,2,"Private nonprofit, 4-year or above",2,14,14,295000,30000,325000,3987379,2471579,6458958,Basketball
23259,2016,160755,Tulane University of Louisiana,New Orleans,LA,70118,1,NCAA Division I-FBS,2717,3770,6487,2,"Private nonprofit, 4-year or above",2,17,13,4207110,2609724,6816834,4207110,2609724,6816834,Basketball
40757,2017,160755,Tulane University of Louisiana,New Orleans,LA,70118,1,NCAA Division I-FBS,2765,3951,6716,2,"Private nonprofit, 4-year or above",2,18,12,4366624,2517354,6883978,4366624,2517354,6883978,Basketball
58439,2018,160755,Tulane University of Louisiana,New Orleans,LA,70118,1,NCAA Division I-FBS,2817,4081,6898,2,"Private nonprofit, 4-year or above",2,14,14,4984520,2741125,7725645,4984520,2741125,7725645,Basketball
91244,2019,160755,Tulane University of Louisiana,New Orleans,LA,70118,1,NCAA Division I-FBS,3012,4248,7260,2,"Private nonprofit, 4-year or above",2,17,13,2718544,1150642,3869186,3711806,2140995,5852801,Basketball
14590,2015,221953,Tusculum College,Greeneville,TN,37743,4,NCAA Division II with football,674,831,1505,2,"Private nonprofit, 4-year or above",2,18,13,390819,370093,760912,383800,368924,752724,Basketball
32059,2016,221953,Tusculum College,Greeneville,TN,37743,4,NCAA Division II with football,696,721,1417,2,"Private nonprofit, 4-year or above",2,21,19,437102,405045,842147,423626,402289,825915,Basketball
49576,2017,221953,Tusculum College,Greeneville,TN,37743,4,NCAA Division II with football,688,687,1375,2,"Private nonprofit, 4-year or above",2,24,19,415736,405596,821332,414219,405596,819815,Basketball
67347,2018,221953,Tusculum College,Greeneville,TN,37743,4,NCAA Division II with football,588,635,1223,2,"Private nonprofit, 4-year or above",2,22,19,524081,434536,958617,521081,434536,955617,Basketball
121102,2019,221953,Tusculum University,Greeneville,TN,37743,4,NCAA Division II with football,588,635,1223,2,"Private nonprofit, 4-year or above",2,20,17,516579,497043,1013622,517829,461221,979050,Basketball
291,2015,102377,Tuskegee University,Tuskegee,AL,360881920,4,NCAA Division II with football,932,1498,2430,2,"Private nonprofit, 4-year or above",2,14,19,482490,397781,880271,482490,397781,880271,Basketball
17633,2016,102377,Tuskegee University,Tuskegee,AL,36088,4,NCAA Division II with football,870,1476,2346,2,"Private nonprofit, 4-year or above",2,12,17,539731,438479,978210,539731,438479,978210,Basketball
35046,2017,102377,Tuskegee University,Tuskegee,AL,36088,4,NCAA Division II with football,993,1729,2722,2,"Private nonprofit, 4-year or above",2,13,20,623119,586596,1209715,623119,586596,1209715,Basketball
52673,2018,102377,Tuskegee University,Tuskegee,AL,36088,4,NCAA Division II with football,881,1581,2462,2,"Private nonprofit, 4-year or above",2,15,18,423605,479093,902698,423605,479093,902698,Basketball
71517,2019,102377,Tuskegee University,Tuskegee,AL,36088,4,NCAA Division II with football,812,1442,2254,2,"Private nonprofit, 4-year or above",2,16,17,522225,465336,987561,522225,456336,978561,Basketball
10671,2015,196866,Union College,Schenectady,NY,123082311,6,NCAA Division III with football,1181,1019,2200,2,"Private nonprofit, 4-year or above",2,16,14,162498,137454,299952,144123,132000,276123,Basketball
28096,2016,196866,Union College,Schenectady,NY,12308,6,NCAA Division III with football,1143,971,2114,2,"Private nonprofit, 4-year or above",2,17,16,190174,143559,333733,190174,143421,333595,Basketball
45595,2017,196866,Union College,Schenectady,NY,12308,6,NCAA Division III with football,1157,1006,2163,2,"Private nonprofit, 4-year or above",2,19,13,183033,156962,339995,183204,156962,340166,Basketball
63303,2018,196866,Union College,Schenectady,NY,12308,6,NCAA Division III with football,1175,1003,2178,2,"Private nonprofit, 4-year or above",2,17,13,192077,162440,354517,161850,162971,324821,Basketball
107310,2019,196866,Union College,Schenectady,NY,12308,6,NCAA Division III with football,1156,1001,2157,2,"Private nonprofit, 4-year or above",2,17,15,207250,180304,387554,200687,166155,366842,Basketball
14600,2015,221971,Union University,Jackson,TN,383053697,5,NCAA Division II without football,693,1179,1872,2,"Private nonprofit, 4-year or above",2,14,21,642013,651573,1293586,631035,650736,1281771,Basketball
32069,2016,221971,Union University,Jackson,TN,38305,5,NCAA Division II without football,576,1043,1619,2,"Private nonprofit, 4-year or above",2,12,16,671703,756667,1428370,671754,754724,1426478,Basketball
49588,2017,221971,Union University,Jackson,TN,38305,5,NCAA Division II without football,554,1045,1599,2,"Private nonprofit, 4-year or above",2,12,14,735554,743209,1478763,735442,715060,1450502,Basketball
67358,2018,221971,Union University,Jackson,TN,38305,5,NCAA Division II without football,600,1178,1778,2,"Private nonprofit, 4-year or above",2,15,15,696168,865357,1561525,659649,865357,1525006,Basketball
121140,2019,221971,Union University,Jackson,TN,38305,5,NCAA Division II without football,603,1192,1795,2,"Private nonprofit, 4-year or above",2,14,14,784670,811904,1596574,741543,757807,1499350,Basketball
10685,2015,197027,United States Merchant Marine Academy,Kings Point,NY,110241699,6,NCAA Division III with football,749,155,904,1,"Public, 4-year or above",2,18,13,137983,178205,316188,129151,164988,294139,Basketball
28110,2016,197027,United States Merchant Marine Academy,Kings Point,NY,11024,6,NCAA Division III with football,735,169,904,1,"Public, 4-year or above",2,16,12,135861,139417,275278,122479,132443,254922,Basketball
45609,2017,197027,United States Merchant Marine Academy,Kings Point,NY,11024,6,NCAA Division III with football,794,160,954,1,"Public, 4-year or above",2,15,12,120755,159823,280578,102245,146448,248693,Basketball
63317,2018,197027,United States Merchant Marine Academy,Kings Point,NY,11024,6,NCAA Division III with football,814,182,996,1,"Public, 4-year or above",2,15,13,172732,194674,367406,155942,174124,330066,Basketball
107346,2019,197027,United States Merchant Marine Academy,Kings Point,NY,11024,6,NCAA Division III with football,792,215,1007,1,"Public, 4-year or above",2,13,13,184920,196992,381912,163888,180261,344149,Basketball
10468,2015,196088,University at Buffalo,Buffalo,NY,142601660,1,NCAA Division I-FBS,10372,7964,18336,1,"Public, 4-year or above",2,15,16,2054470,1596152,3650622,2054470,1596152,3650622,Basketball
27892,2016,196088,University at Buffalo,Buffalo,NY,14260,1,NCAA Division I-FBS,10798,7934,18732,1,"Public, 4-year or above",2,15,14,2214350,1518866,3733216,2214350,1518866,3733216,Basketball
45385,2017,196088,University at Buffalo,Buffalo,NY,14260,1,NCAA Division I-FBS,11138,8178,19316,1,"Public, 4-year or above",2,16,14,2653127,1720075,4373202,2653127,1720075,4373202,Basketball
63095,2018,196088,University at Buffalo,Buffalo,NY,14260,1,NCAA Division I-FBS,11396,8517,19913,1,"Public, 4-year or above",2,18,16,3093556,2007936,5101492,3093556,2007936,5101492,Basketball
106679,2019,196088,University at Buffalo,Buffalo,NY,14260,1,NCAA Division I-FBS,11538,8836,20374,1,"Public, 4-year or above",2,17,15,2516763,1929751,4446514,2516763,1929751,4446514,Basketball
11394,2015,200800,University of Akron Main Campus,Akron,OH,443254702,1,NCAA Division I-FBS,7930,6722,14652,1,"Public, 4-year or above",2,19,14,3088920,1516452,4605372,3088920,1516452,4605372,Basketball
28831,2016,200800,University of Akron Main Campus,Akron,OH,44325,1,NCAA Division I-FBS,7363,6004,13367,1,"Public, 4-year or above",2,16,15,2958089,1569908,4527997,2958089,1569908,4527997,Basketball
46332,2017,200800,University of Akron Main Campus,Akron,OH,44325,1,NCAA Division I-FBS,7144,5984,13128,1,"Public, 4-year or above",2,16,13,2934244,1546618,4480862,2934244,1546618,4480862,Basketball
64053,2018,200800,University of Akron Main Campus,Akron,OH,44325,1,NCAA Division I-FBS,6500,5474,11974,1,"Public, 4-year or above",2,16,12,3045115,1528158,4573273,3045115,1528158,4573273,Basketball
110107,2019,200800,University of Akron Main Campus,Akron,OH,44325,1,NCAA Division I-FBS,6104,5093,11197,1,"Public, 4-year or above",2,16,14,2990984,1487659,4478643,2990984,1487659,4478643,Basketball
12,2015,100663,University of Alabama at Birmingham,Birmingham,AL,352940110,1,NCAA Division I-FBS,3397,4862,8259,1,"Public, 4-year or above",2,13,20,4189826,1966556,6156382,4189826,1962579,6152405,Basketball
17357,2016,100663,University of Alabama at Birmingham,Birmingham,AL,35294,1,NCAA Division I-FBS,3668,5273,8941,1,"Public, 4-year or above",2,13,22,3369190,1714933,5084123,3357016,1712518,5069534,Basketball
34771,2017,100663,University of Alabama at Birmingham,Birmingham,AL,35294,1,NCAA Division I-FBS,3905,5725,9630,1,"Public, 4-year or above",2,13,19,3559862,1999358,5559220,3413518,1999358,5412876,Basketball
52400,2018,100663,University of Alabama at Birmingham,Birmingham,AL,35294,1,NCAA Division I-FBS,3954,6035,9989,1,"Public, 4-year or above",2,15,14,3628668,2087432,5716100,3533944,2087432,5621376,Basketball
70173,2019,100663,University of Alabama at Birmingham,Birmingham,AL,35294,1,NCAA Division I-FBS,4020,6252,10272,1,"Public, 4-year or above",2,16,15,3705028,1925441,5630469,3705028,1925441,5630469,Basketball
22,2015,100706,University of Alabama in Huntsville,Huntsville,AL,35899,5,NCAA Division II without football,2644,2071,4715,1,"Public, 4-year or above",2,19,13,612569,386007,998576,612569,386007,998576,Basketball
17368,2016,100706,University of Alabama in Huntsville,Huntsville,AL,35899,5,NCAA Division II without football,3023,2215,5238,1,"Public, 4-year or above",2,19,12,678342,379794,1058136,678342,379794,1058136,Basketball
34783,2017,100706,University of Alabama in Huntsville,Huntsville,AL,35899,5,NCAA Division II without football,3406,2476,5882,1,"Public, 4-year or above",2,20,15,685896,398744,1084640,685896,398744,1084640,Basketball
52412,2018,100706,University of Alabama in Huntsville,Huntsville,AL,35899,5,NCAA Division II without football,3670,2712,6382,1,"Public, 4-year or above",2,21,15,705934,415779,1121713,705934,415779,1121713,Basketball
70211,2019,100706,University of Alabama in Huntsville,Huntsville,AL,35899,5,NCAA Division II without football,3915,2818,6733,1,"Public, 4-year or above",2,20,14,572018,442794,1014812,572018,442794,1014812,Basketball
297,2015,102553,University of Alaska Anchorage,Anchorage,AK,99508,5,NCAA Division II without football,3215,3622,6837,1,"Public, 4-year or above",2,15,14,1505782,1107644,2613426,1505782,1107644,2613426,Basketball
17639,2016,102553,University of Alaska Anchorage,Anchorage,AK,99508,5,NCAA Division II without football,3099,3461,6560,1,"Public, 4-year or above",2,13,12,1537164,976586,2513750,1537164,976586,2513750,Basketball
35056,2017,102553,University of Alaska Anchorage,Anchorage,AK,99508,5,NCAA Division II without football,2955,3455,6410,1,"Public, 4-year or above",2,16,16,1695948,1080618,2776566,1695948,1080618,2776566,Basketball
52684,2018,102553,University of Alaska Anchorage,Anchorage,AK,99508,5,NCAA Division II without football,2683,3162,5845,1,"Public, 4-year or above",2,14,14,860013,948138,1808151,860013,948138,1808151,Basketball
71562,2019,102553,University of Alaska Anchorage,Anchorage,AK,99508,5,NCAA Division II without football,2339,2731,5070,1,"Public, 4-year or above",2,12,18,876737,999591,1876328,876737,999591,1876328,Basketball
305,2015,102614,University of Alaska Fairbanks,Fairbanks,AK,997757500,5,NCAA Division II without football,1690,1617,3307,1,"Public, 4-year or above",2,18,15,668389,564312,1232701,662480,561284,1223764,Basketball
17647,2016,102614,University of Alaska Fairbanks,Fairbanks,AK,99775,5,NCAA Division II without football,1570,1527,3097,1,"Public, 4-year or above",2,17,15,673510,559068,1232578,673510,559068,1232578,Basketball
35064,2017,102614,University of Alaska Fairbanks,Fairbanks,AK,99775,5,NCAA Division II without football,1441,1491,2932,1,"Public, 4-year or above",2,14,16,601366,589954,1191320,601366,589954,1191320,Basketball
52692,2018,102614,University of Alaska Fairbanks,Fairbanks,AK,99775,5,NCAA Division II without football,1344,1362,2706,1,"Public, 4-year or above",2,16,10,617706,507871,1125577,617706,507871,1125577,Basketball
71600,2019,102614,University of Alaska Fairbanks,Fairbanks,AK,99775,5,NCAA Division II without football,1220,1300,2520,1,"Public, 4-year or above",2,14,12,667180,557748,1224928,663874,558728,1222602,Basketball
334,2015,104179,University of Arizona,Tucson,AZ,857210066,1,NCAA Division I-FBS,14223,15222,29445,1,"Public, 4-year or above",2,15,15,21726050,557050,22283100,11761006,2776619,14537625,Basketball
17678,2016,104179,University of Arizona,Tucson,AZ,85721,1,NCAA Division I-FBS,13909,15140,29049,1,"Public, 4-year or above",2,15,14,23434825,571762,24006587,9852596,2808785,12661381,Basketball
35095,2017,104179,University of Arizona,Tucson,AZ,85721,1,NCAA Division I-FBS,13852,15397,29249,1,"Public, 4-year or above",2,18,15,22830561,656784,23487345,9827381,2807665,12635046,Basketball
52723,2018,104179,University of Arizona,Tucson,AZ,85721,1,NCAA Division I-FBS,13684,15289,28973,1,"Public, 4-year or above",2,16,14,22437254,1051972,23489226,10383630,3097878,13481508,Basketball
71693,2019,104179,University of Arizona,Tucson,AZ,85721,1,NCAA Division I-FBS,13334,15568,28902,1,"Public, 4-year or above",2,17,16,16890955,1282435,18173390,10371308,3369252,13740560,Basketball
482,2015,106397,University of Arkansas,Fayetteville,AR,72701,1,NCAA Division I-FBS,9179,10247,19426,1,"Public, 4-year or above",2,15,24,16043220,526332,16569552,8702745,4278379,12981124,Basketball
17828,2016,106397,University of Arkansas,Fayetteville,AR,72701,1,NCAA Division I-FBS,9277,10497,19774,1,"Public, 4-year or above",2,14,15,16332876,688848,17021724,9790947,4739786,14530733,Basketball
35256,2017,106397,University of Arkansas,Fayetteville,AR,72701,1,NCAA Division I-FBS,9529,10870,20399,1,"Public, 4-year or above",2,14,15,17275988,490353,17766341,9195260,5016553,14211813,Basketball
52875,2018,106397,University of Arkansas,Fayetteville,AR,72701,1,NCAA Division I-FBS,9697,11233,20930,1,"Public, 4-year or above",2,17,17,21424702,497775,21922477,10440326,5468462,15908788,Basketball
72301,2019,106397,University of Arkansas,Fayetteville,AR,72701,1,NCAA Division I-FBS,9374,11109,20483,1,"Public, 4-year or above",2,15,17,18727503,625151,19352654,9883016,4833897,14716913,Basketball
460,2015,106245,University of Arkansas at Little Rock,Little Rock,AR,72204,3,NCAA Division I without football,2023,2562,4585,1,"Public, 4-year or above",2,16,14,1722502,192264,1914766,2283345,1542390,3825735,Basketball
17806,2016,106245,University of Arkansas at Little Rock,Little Rock,AR,72204,3,NCAA Division I without football,1878,2546,4424,1,"Public, 4-year or above",2,17,15,1888655,330562,2219217,2196669,1650657,3847326,Basketball
35233,2017,106245,University of Arkansas at Little Rock,Little Rock,AR,72204,3,NCAA Division I without football,1754,2483,4237,1,"Public, 4-year or above",2,17,15,1071687,245237,1316924,2265863,1797395,4063258,Basketball
52851,2018,106245,University of Arkansas at Little Rock,Little Rock,AR,72204,3,NCAA Division I without football,1592,2264,3856,1,"Public, 4-year or above",2,15,14,1107986,417968,1525954,2126312,1837021,3963333,Basketball
72221,2019,106245,University of Arkansas at Little Rock,Little Rock,AR,72204,3,NCAA Division I without football,1468,2184,3652,1,"Public, 4-year or above",2,16,12,965696,325192,1290888,2081803,1623934,3705737,Basketball
519,2015,106485,University of Arkansas at Monticello,Monticello,AR,71656,4,NCAA Division II with football,1024,1059,2083,1,"Public, 4-year or above",2,14,14,329040,297175,626215,329040,297175,626215,Basketball
17865,2016,106485,University of Arkansas at Monticello,Monticello,AR,71656,4,NCAA Division II with football,1003,1159,2162,1,"Public, 4-year or above",2,14,13,348029,352281,700310,348029,352281,700310,Basketball
35293,2017,106485,University of Arkansas at Monticello,Monticello,AR,71656,4,NCAA Division II with football,1010,1168,2178,1,"Public, 4-year or above",2,14,12,359806,295825,655631,359806,295825,655631,Basketball
52912,2018,106485,University of Arkansas at Monticello,Monticello,AR,71656,4,NCAA Division II with football,951,1077,2028,1,"Public, 4-year or above",2,14,10,373342,280294,653636,373342,280294,653636,Basketball
72422,2019,106485,University of Arkansas at Monticello,Monticello,AR,71656,4,NCAA Division II with football,813,964,1777,1,"Public, 4-year or above",2,13,13,382300,309375,691675,382300,309375,691675,Basketball
493,2015,106412,University of Arkansas at Pine Bluff,Pine Bluff,AR,71601,2,NCAA Division I-FCS,1018,1293,2311,1,"Public, 4-year or above",2,15,15,507962,549531,1057493,507962,549531,1057493,Basketball
17839,2016,106412,University of Arkansas at Pine Bluff,Pine Bluff,AR,71601,2,NCAA Division I-FCS,1029,1473,2502,1,"Public, 4-year or above",2,15,20,853508,697793,1551301,853508,697793,1551301,Basketball
35267,2017,106412,University of Arkansas at Pine Bluff,Pine Bluff,AR,71601,2,NCAA Division I-FCS,965,1376,2341,1,"Public, 4-year or above",2,13,15,794976,575304,1370280,794976,575304,1370280,Basketball
52886,2018,106412,University of Arkansas at Pine Bluff,Pine Bluff,AR,71601,2,NCAA Division I-FCS,924,1326,2250,1,"Public, 4-year or above",2,20,15,833958,574850,1408808,833958,574850,1408808,Basketball
72337,2019,106412,University of Arkansas at Pine Bluff,Pine Bluff,AR,71601,2,NCAA Division I-FCS,886,1275,2161,1,"Public, 4-year or above",2,13,15,801214,782349,1583563,801214,782349,1583563,Basketball
625,2015,108092,University of Arkansas-Fort Smith,Fort Smith,AR,729133649,5,NCAA Division II without football,1946,2621,4567,1,"Public, 4-year or above",2,13,14,687121,580141,1267262,687121,580141,1267262,Basketball
17973,2016,108092,University of Arkansas-Fort Smith,Fort Smith,AR,72913,5,NCAA Division II without football,1821,2414,4235,1,"Public, 4-year or above",2,15,10,609873,508467,1118340,609873,508467,1118340,Basketball
35405,2017,108092,University of Arkansas-Fort Smith,Fort Smith,AR,72913,5,NCAA Division II without football,1847,2567,4414,1,"Public, 4-year or above",2,14,12,621107,530160,1151267,621107,530160,1151267,Basketball
53028,2018,108092,University of Arkansas-Fort Smith,Fort Smith,AR,72913,5,NCAA Division II without football,1662,2451,4113,1,"Public, 4-year or above",2,12,13,515919,460486,976405,515919,460486,976405,Basketball
73024,2019,108092,University of Arkansas-Fort Smith,Fort Smith,AR,72913,5,NCAA Division II without football,1526,2357,3883,1,"Public, 4-year or above",2,13,12,580536,462481,1043017,580536,462481,1043017,Basketball
2331,2015,128744,University of Bridgeport,Bridgeport,CT,66045620,5,NCAA Division II without football,858,1254,2112,2,"Private nonprofit, 4-year or above",2,20,15,674252,549529,1223781,667510,547463,1214973,Basketball
19703,2016,128744,University of Bridgeport,Bridgeport,CT,6604,5,NCAA Division II without football,863,1277,2140,2,"Private nonprofit, 4-year or above",2,18,16,727661,600244,1327905,719910,598025,1317935,Basketball
37142,2017,128744,University of Bridgeport,Bridgeport,CT,6604,5,NCAA Division II without football,875,1425,2300,2,"Private nonprofit, 4-year or above",2,17,13,697827,622587,1320414,686786,618312,1305098,Basketball
54779,2018,128744,University of Bridgeport,Bridgeport,CT,6604,5,NCAA Division II without football,872,1439,2311,2,"Private nonprofit, 4-year or above",2,18,15,703561,702547,1406108,703561,702547,1406108,Basketball
78810,2019,128744,University of Bridgeport,Bridgeport,CT,6604,5,NCAA Division II without football,763,1369,2132,2,"Private nonprofit, 4-year or above",2,18,15,615674,479025,1094699,611169,477272,1088441,Basketball
897,2015,110635,University of California-Berkeley,Berkeley,CA,94720,1,NCAA Division I-FBS,12756,13866,26622,1,"Public, 4-year or above",2,17,27,8316795,3373521,11690316,8658628,3373521,12032149,Basketball
18247,2016,110635,University of California-Berkeley,Berkeley,CA,94720,1,NCAA Division I-FBS,13574,14533,28107,1,"Public, 4-year or above",2,18,20,10443327,476890,10920217,7559603,3659544,11219147,Basketball
35682,2017,110635,University of California-Berkeley,Berkeley,CA,94720,1,NCAA Division I-FBS,14016,15335,29351,1,"Public, 4-year or above",2,18,28,8085222,491698,8576920,6444068,3898627,10342695,Basketball
53303,2018,110635,University of California-Berkeley,Berkeley,CA,94720,1,NCAA Division I-FBS,13997,15567,29564,1,"Public, 4-year or above",2,17,30,7840731,588318,8429049,6131940,4020718,10152658,Basketball
73910,2019,110635,University of California-Berkeley,Berkeley,CA,94720,1,NCAA Division I-FBS,13824,16164,29988,1,"Public, 4-year or above",2,17,22,7367945,502329,7870274,7177832,3722045,10899877,Basketball
914,2015,110644,University of California-Davis,Davis,CA,956168678,2,NCAA Division I-FCS,11215,16223,27438,1,"Public, 4-year or above",2,15,19,1862783,1340541,3203324,1862783,1340541,3203324,Basketball
18264,2016,110644,University of California-Davis,Davis,CA,95616,2,NCAA Division I-FCS,11582,16962,28544,1,"Public, 4-year or above",2,15,20,2211257,1606179,3817436,2211257,1606179,3817436,Basketball
35699,2017,110644,University of California-Davis,Davis,CA,95616,2,NCAA Division I-FCS,11823,17441,29264,1,"Public, 4-year or above",2,16,21,2191143,1830357,4021500,2191143,1830357,4021500,Basketball
53320,2018,110644,University of California-Davis,Davis,CA,95616,2,NCAA Division I-FCS,11799,18148,29947,1,"Public, 4-year or above",2,16,18,2395167,1845740,4240907,2395167,1845740,4240907,Basketball
73948,2019,110644,University of California-Davis,Davis,CA,95616,2,NCAA Division I-FCS,11780,18371,30151,1,"Public, 4-year or above",2,15,20,2322182,1819219,4141401,2322182,1819219,4141401,Basketball
928,2015,110653,University of California-Irvine,Irvine,CA,92697,3,NCAA Division I without football,11429,13414,24843,1,"Public, 4-year or above",2,16,13,2959823,1705464,4665287,2825452,1387771,4213223,Basketball
18278,2016,110653,University of California-Irvine,Irvine,CA,92697,3,NCAA Division I without football,12563,14313,26876,1,"Public, 4-year or above",2,16,17,2777164,1526335,4303499,2777164,1526335,4303499,Basketball
35713,2017,110653,University of California-Irvine,Irvine,CA,92697,3,NCAA Division I without football,13615,15228,28843,1,"Public, 4-year or above",2,16,15,2660967,1620939,4281906,2660967,1620939,4281906,Basketball
53336,2018,110653,University of California-Irvine,Irvine,CA,92697,3,NCAA Division I without football,14177,15060,29237,1,"Public, 4-year or above",2,16,12,2953537,1722114,4675651,2953537,1722114,4675651,Basketball
73986,2019,110653,University of California-Irvine,Irvine,CA,92697,3,NCAA Division I without football,14207,15579,29786,1,"Public, 4-year or above",2,16,14,3062930,1991512,5054442,2976189,2044344,5020533,Basketball
938,2015,110662,University of California-Los Angeles,Los Angeles,CA,900951405,1,NCAA Division I-FBS,12685,16315,29000,1,"Public, 4-year or above",2,16,34,11318447,1381233,12699680,9032540,3920292,12952832,Basketball
18288,2016,110662,University of California-Los Angeles,Los Angeles,CA,90095,1,NCAA Division I-FBS,13088,17241,30329,1,"Public, 4-year or above",2,15,30,13416856,933382,14350238,9856861,4386618,14243479,Basketball
35723,2017,110662,University of California-Los Angeles,Los Angeles,CA,90095,1,NCAA Division I-FBS,12930,17520,30450,1,"Public, 4-year or above",2,16,34,11325876,944962,12270838,9334174,4824009,14158183,Basketball
53346,2018,110662,University of California-Los Angeles,Los Angeles,CA,90095,1,NCAA Division I-FBS,12998,18002,31000,1,"Public, 4-year or above",2,16,32,11959355,1009216,12968571,15468381,5083116,20551497,Basketball
73997,2019,110662,University of California-Los Angeles,Los Angeles,CA,90095,1,NCAA Division I-FBS,12819,18144,30963,1,"Public, 4-year or above",2,15,26,11036275,902912,11939187,11510394,5441354,16951748,Basketball
952,2015,110671,University of California-Riverside,Riverside,CA,92521,3,NCAA Division I without football,8733,9536,18269,1,"Public, 4-year or above",2,16,15,1679974,1520186,3200160,1680520,1478646,3159166,Basketball
18302,2016,110671,University of California-Riverside,Riverside,CA,92521,3,NCAA Division I without football,9105,10428,19533,1,"Public, 4-year or above",2,15,16,1868891,1481379,3350270,1679645,1536694,3216339,Basketball
35737,2017,110671,University of California-Riverside,Riverside,CA,92521,3,NCAA Division I without football,9068,10637,19705,1,"Public, 4-year or above",2,16,13,2181523,1649743,3831266,2181523,1649743,3831266,Basketball
53360,2018,110671,University of California-Riverside,Riverside,CA,92521,3,NCAA Division I without football,9235,10974,20209,1,"Public, 4-year or above",2,15,14,2542300,1818737,4361037,2485812,1818737,4304549,Basketball
74011,2019,110671,University of California-Riverside,Riverside,CA,92521,3,NCAA Division I without football,9929,11707,21636,1,"Public, 4-year or above",2,16,14,2436746,1617058,4053804,990934,1593727,2584661,Basketball
960,2015,110680,University of California-San Diego,La Jolla,CA,92093,5,NCAA Division II without football,13573,12348,25921,1,"Public, 4-year or above",2,15,15,505287,434756,940043,505287,434756,940043,Basketball
18310,2016,110680,University of California-San Diego,La Jolla,CA,92093,5,NCAA Division II without football,14200,13186,27386,1,"Public, 4-year or above",2,16,19,1033685,887905,1921590,1033685,887905,1921590,Basketball
35745,2017,110680,University of California-San Diego,La Jolla,CA,92093,5,NCAA Division II without football,14140,13739,27879,1,"Public, 4-year or above",2,16,14,1201384,956752,2158136,1201384,952765,2154149,Basketball
53368,2018,110680,University of California-San Diego,La Jolla,CA,92093,5,NCAA Division II without football,14727,14763,29490,1,"Public, 4-year or above",2,16,14,1336221,1080753,2416974,1336221,1080753,2416974,Basketball
74049,2019,110680,University of California-San Diego,La Jolla,CA,92093,5,NCAA Division II without football,14919,15047,29966,1,"Public, 4-year or above",2,19,14,1668692,1583142,3251834,1668692,1583142,3251834,Basketball
972,2015,110705,University of California-Santa Barbara,Santa Barbara,CA,93106,3,NCAA Division I without football,9503,10739,20242,1,"Public, 4-year or above",2,19,17,2453112,1802933,4256045,2453112,1802933,4256045,Basketball
18322,2016,110705,University of California-Santa Barbara,Santa Barbara,CA,931062030,3,NCAA Division I without football,9840,11359,21199,1,"Public, 4-year or above",2,17,16,2511546,1913198,4424744,2511546,1913198,4424744,Basketball
35757,2017,110705,University of California-Santa Barbara,Santa Barbara,CA,93106,3,NCAA Division I without football,9957,11819,21776,1,"Public, 4-year or above",2,18,15,2699897,1897284,4597181,2699897,1897284,4597181,Basketball
53380,2018,110705,University of California-Santa Barbara,Santa Barbara,CA,93106,3,NCAA Division I without football,10240,12361,22601,1,"Public, 4-year or above",2,18,15,3202493,1746440,4948933,3202493,1746440,4948933,Basketball
74086,2019,110705,University of California-Santa Barbara,Santa Barbara,CA,93106,3,NCAA Division I without football,10319,12527,22846,1,"Public, 4-year or above",2,15,17,3212593,1974602,5187195,3212593,1974602,5187195,Basketball
983,2015,110714,University of California-Santa Cruz,Santa Cruz,CA,950641011,7,NCAA Division III without football,7522,8301,15823,1,"Public, 4-year or above",2,17,17,172885,129718,302603,170824,129718,300542,Basketball
18333,2016,110714,University of California-Santa Cruz,Santa Cruz,CA,95064,7,NCAA Division III without football,8098,8411,16509,1,"Public, 4-year or above",2,13,13,127663,145906,273569,127663,129377,257040,Basketball
35768,2017,110714,University of California-Santa Cruz,Santa Cruz,CA,95064,7,NCAA Division III without football,8523,8559,17082,1,"Public, 4-year or above",2,16,11,166552,166926,333478,166552,137354,303906,Basketball
53391,2018,110714,University of California-Santa Cruz,Santa Cruz,CA,95064,7,NCAA Division III without football,8878,8377,17255,1,"Public, 4-year or above",2,9,10,168387,164856,333243,160387,164856,325243,Basketball
74124,2019,110714,University of California-Santa Cruz,Santa Cruz,CA,95064,7,NCAA Division III without football,8835,8159,16994,1,"Public, 4-year or above",2,17,13,239168,233014,472182,243205,212713,455918,Basketball
526,2015,106704,University of Central Arkansas,Conway,AR,720350001,2,NCAA Division I-FCS,3270,4965,8235,1,"Public, 4-year or above",2,14,15,1095560,869477,1965037,1095560,869477,1965037,Basketball
17872,2016,106704,University of Central Arkansas,Conway,AR,72035,2,NCAA Division I-FCS,3169,4787,7956,1,"Public, 4-year or above",2,13,12,1109704,843535,1953239,1109704,843535,1953239,Basketball
35300,2017,106704,University of Central Arkansas,Conway,AR,72035,2,NCAA Division I-FCS,3209,4817,8026,1,"Public, 4-year or above",2,16,13,1270810,1035191,2306001,1270810,1035191,2306001,Basketball
52919,2018,106704,University of Central Arkansas,Conway,AR,72035,2,NCAA Division I-FCS,3059,4773,7832,1,"Public, 4-year or above",2,15,13,1295287,1008010,2303297,1295287,1008010,2303297,Basketball
72460,2019,106704,University of Central Arkansas,Conway,AR,72035,2,NCAA Division I-FCS,2913,4684,7597,1,"Public, 4-year or above",2,14,14,1257969,889671,2147640,1257969,889671,2147640,Basketball
2737,2015,132903,University of Central Florida,Orlando,FL,32816,1,NCAA Division I-FBS,17023,20488,37511,1,"Public, 4-year or above",2,14,12,3490569,1861394,5351963,3166282,1861394,5027676,Basketball
20112,2016,132903,University of Central Florida,Orlando,FL,32816,1,NCAA Division I-FBS,17364,20864,38228,1,"Public, 4-year or above",2,16,15,4155621,2044854,6200475,4425044,2044854,6469898,Basketball
37551,2017,132903,University of Central Florida,Orlando,FL,32816,1,NCAA Division I-FBS,18065,21620,39685,1,"Public, 4-year or above",2,18,16,3368085,660045,4028130,3892343,2436723,6329066,Basketball
55195,2018,132903,University of Central Florida,Orlando,FL,32816,1,NCAA Division I-FBS,19022,22578,41600,1,"Public, 4-year or above",2,19,17,3879707,2505784,6385491,4594025,2505784,7099809,Basketball
79871,2019,132903,University of Central Florida,Orlando,FL,32816,1,NCAA Division I-FBS,19221,22963,42184,1,"Public, 4-year or above",2,17,15,3585782,1247191,4832973,5515278,2934518,8449796,Basketball
8109,2015,176965,University of Central Missouri,Warrensburg,MO,64093,4,NCAA Division II with football,3638,4373,8011,1,"Public, 4-year or above",2,16,16,885257,621425,1506682,885257,621425,1506682,Basketball
25528,2016,176965,University of Central Missouri,Warrensburg,MO,64093,4,NCAA Division II with football,3519,4239,7758,1,"Public, 4-year or above",2,18,13,865613,631482,1497095,865613,631482,1497095,Basketball
43022,2017,176965,University of Central Missouri,Warrensburg,MO,64093,4,NCAA Division II with football,3424,4198,7622,1,"Public, 4-year or above",2,17,15,812008,655663,1467671,812008,655663,1467671,Basketball
60736,2018,176965,University of Central Missouri,Warrensburg,MO,64093,4,NCAA Division II with football,3254,3954,7208,1,"Public, 4-year or above",2,17,15,692466,708627,1401093,692466,708627,1401093,Basketball
98702,2019,176965,University of Central Missouri,Warrensburg,MO,64093,4,NCAA Division II with football,2978,3633,6611,1,"Public, 4-year or above",2,16,15,738911,733518,1472429,738911,733518,1472429,Basketball
12064,2015,206941,University of Central Oklahoma,Edmond,OK,73034,4,NCAA Division II with football,4424,6098,10522,1,"Public, 4-year or above",2,18,18,482252,453479,935731,472215,401544,873759,Basketball
29504,2016,206941,University of Central Oklahoma,Edmond,OK,73034,4,NCAA Division II with football,4339,6127,10466,1,"Public, 4-year or above",2,15,16,431503,457150,888653,415711,406761,822472,Basketball
47009,2017,206941,University of Central Oklahoma,Edmond,OK,73034,4,NCAA Division II with football,4255,6119,10374,1,"Public, 4-year or above",2,16,15,479528,447745,927273,444568,409543,854111,Basketball
64752,2018,206941,University of Central Oklahoma,Edmond,OK,73034,4,NCAA Division II with football,4043,5968,10011,1,"Public, 4-year or above",2,15,14,482762,487178,969940,460360,405014,865374,Basketball
112320,2019,206941,University of Central Oklahoma,Edmond,OK,73034,4,NCAA Division II with football,3825,5874,9699,1,"Public, 4-year or above",2,14,17,527235,460491,987726,490623,440029,930652,Basketball
16272,2015,237312,University of Charleston,Charleston,WV,25304,4,NCAA Division II with football,582,708,1290,2,"Private nonprofit, 4-year or above",2,18,17,548775,456862,1005637,514075,456012,970087,Basketball
33745,2016,237312,University of Charleston,Charleston,WV,25304,4,NCAA Division II with football,543,666,1209,2,"Private nonprofit, 4-year or above",2,18,19,562338,537901,1100239,536318,527467,1063785,Basketball
51297,2017,237312,University of Charleston,Charleston,WV,25304,4,NCAA Division II with football,523,697,1220,2,"Private nonprofit, 4-year or above",2,19,20,539293,503340,1042633,519743,489766,1009509,Basketball
69047,2018,237312,University of Charleston,Charleston,WV,25304,4,NCAA Division II with football,528,676,1204,2,"Private nonprofit, 4-year or above",2,19,19,565523,500622,1066145,545530,477253,1022783,Basketball
127992,2019,237312,University of Charleston,Charleston,WV,25304,4,NCAA Division II with football,508,664,1172,2,"Private nonprofit, 4-year or above",2,19,22,460277,502039,962316,432491,489944,922435,Basketball
3655,2015,144050,University of Chicago,Chicago,IL,60637,6,NCAA Division III with football,3049,2772,5821,2,"Private nonprofit, 4-year or above",2,19,14,379241,323810,703051,379241,323810,703051,Basketball
21025,2016,144050,University of Chicago,Chicago,IL,60637,6,NCAA Division III with football,3070,2886,5956,2,"Private nonprofit, 4-year or above",2,17,15,286607,245398,532005,286607,245398,532005,Basketball
38485,2017,144050,University of Chicago,Chicago,IL,60637,6,NCAA Division III with football,3204,3072,6276,2,"Private nonprofit, 4-year or above",2,17,15,273725,270396,544121,273725,270396,544121,Basketball
56138,2018,144050,University of Chicago,Chicago,IL,60637,6,NCAA Division III with football,3371,3228,6599,2,"Private nonprofit, 4-year or above",2,15,14,308141,278428,586569,308141,278428,586569,Basketball
83419,2019,144050,University of Chicago,Chicago,IL,60637,6,NCAA Division III with football,3471,3322,6793,2,"Private nonprofit, 4-year or above",2,13,18,306342,261241,567583,306342,261241,567583,Basketball
11491,2015,201885,University of Cincinnati-Main Campus,Cincinnati,OH,452210063,1,NCAA Division I-FBS,11017,9889,20906,1,"Public, 4-year or above",2,13,12,7421986,2304459,9726445,7421986,2304459,9726445,Basketball
28929,2016,201885,University of Cincinnati-Main Campus,Cincinnati,OH,45221,1,NCAA Division I-FBS,11318,10127,21445,1,"Public, 4-year or above",2,14,14,6970262,2406652,9376914,6970262,2406652,9376914,Basketball
46432,2017,201885,University of Cincinnati-Main Campus,Cincinnati,OH,45221,1,NCAA Division I-FBS,11897,10598,22495,1,"Public, 4-year or above",2,15,16,7465979,2855967,10321946,7465979,2855967,10321946,Basketball
64154,2018,201885,University of Cincinnati-Main Campus,Cincinnati,OH,45221,1,NCAA Division I-FBS,12060,10792,22852,1,"Public, 4-year or above",2,15,16,7644770,2790939,10435709,7644770,2790939,10435709,Basketball
110342,2019,201885,University of Cincinnati-Main Campus,Cincinnati,OH,45221,1,NCAA Division I-FBS,12348,11229,23577,1,"Public, 4-year or above",2,17,16,6245375,2795840,9041215,6245375,2795840,9041215,Basketball
2164,2015,126614,University of Colorado Boulder,Boulder,CO,803090017,1,NCAA Division I-FBS,13698,11194,24892,1,"Public, 4-year or above",2,17,12,8321985,407721,8729706,6138058,3309895,9447953,Basketball
19534,2016,126614,University of Colorado Boulder,Boulder,CO,80309,1,NCAA Division I-FBS,14251,11441,25692,1,"Public, 4-year or above",2,16,20,8374472,449302,8823774,6163776,3405160,9568936,Basketball
36972,2017,126614,University of Colorado Boulder,Boulder,CO,80309,1,NCAA Division I-FBS,14952,11932,26884,1,"Public, 4-year or above",2,15,19,9204900,429650,9634550,6325662,3598170,9923832,Basketball
54609,2018,126614,University of Colorado Boulder,Boulder,CO,80309,1,NCAA Division I-FBS,15325,12616,27941,1,"Public, 4-year or above",2,17,21,9310818,841178,10151996,7252987,3696622,10949609,Basketball
78158,2019,126614,University of Colorado Boulder,Boulder,CO,80309,1,NCAA Division I-FBS,15568,13223,28791,1,"Public, 4-year or above",2,17,23,9230097,563578,9793675,6568544,3044752,9613296,Basketball
2158,2015,126580,University of Colorado Colorado Springs,Colorado Springs,CO,80918,5,NCAA Division II without football,3661,3767,7428,1,"Public, 4-year or above",2,15,16,505947,386626,892573,503942,386616,890558,Basketball
19527,2016,126580,University of Colorado Colorado Springs,Colorado Springs,CO,80918,5,NCAA Division II without football,3917,4015,7932,1,"Public, 4-year or above",2,15,16,503554,411049,914603,503507,409884,913391,Basketball
36965,2017,126580,University of Colorado Colorado Springs,Colorado Springs,CO,80918,5,NCAA Division II without football,3973,4161,8134,1,"Public, 4-year or above",2,16,16,616877,424501,1041378,616877,423923,1040800,Basketball
54602,2018,126580,University of Colorado Colorado Springs,Colorado Springs,CO,80918,5,NCAA Division II without football,4077,4183,8260,1,"Public, 4-year or above",2,15,16,607999,443269,1051268,609664,442356,1052020,Basketball
78120,2019,126580,University of Colorado Colorado Springs,Colorado Springs,CO,80918,5,NCAA Division II without football,3973,4173,8146,1,"Public, 4-year or above",2,16,16,570134,509317,1079451,570134,508721,1078855,Basketball
2365,2015,129020,University of Connecticut,Storrs,CT,6269,1,NCAA Division I-FBS,8977,9012,17989,1,"Public, 4-year or above",2,21,13,10423801,8864132,19287933,9516308,7518348,17034656,Basketball
19737,2016,129020,University of Connecticut,Storrs,CT,6269,1,NCAA Division I-FBS,9191,9347,18538,1,"Public, 4-year or above",2,21,12,13798668,9032881,22831549,9575666,7839480,17415146,Basketball
37176,2017,129020,University of Connecticut,Storrs,CT,6269,1,NCAA Division I-FBS,9096,9347,18443,1,"Public, 4-year or above",2,18,13,8508130,7424409,15932539,8386802,7424409,15811211,Basketball
54812,2018,129020,University of Connecticut,Storrs,CT,6269,1,NCAA Division I-FBS,8998,9399,18397,1,"Public, 4-year or above",2,15,11,9325922,7853769,17179691,9325922,7853769,17179691,Basketball
78896,2019,129020,University of Connecticut,Storrs,CT,6269,1,NCAA Division I-FBS,8903,9248,18151,1,"Public, 4-year or above",2,15,11,9789117,7336001,17125118,10614320,7986676,18600996,Basketball
14734,2015,224323,University of Dallas,Irving,TX,750624736,7,NCAA Division III without football,579,736,1315,2,"Private nonprofit, 4-year or above",2,20,15,152087,117920,270007,152087,117920,270007,Basketball
32204,2016,224323,University of Dallas,Irving,TX,75062,7,NCAA Division III without football,622,749,1371,2,"Private nonprofit, 4-year or above",2,25,15,149921,138000,287921,149921,138000,287921,Basketball
49726,2017,224323,University of Dallas,Irving,TX,75062,7,NCAA Division III without football,658,763,1421,2,"Private nonprofit, 4-year or above",2,22,12,154374,118159,272533,154374,118159,272533,Basketball
67499,2018,224323,University of Dallas,Irving,TX,75062,7,NCAA Division III without football,680,766,1446,2,"Private nonprofit, 4-year or above",2,21,18,185937,144917,330854,185937,144917,330854,Basketball
121694,2019,224323,University of Dallas,Irving,TX,75062,7,NCAA Division III without football,669,773,1442,2,"Private nonprofit, 4-year or above",2,19,12,181164,115911,297075,181164,115911,297075,Basketball
11541,2015,202480,University of Dayton,Dayton,OH,45469,2,NCAA Division I-FCS,4303,3886,8189,2,"Private nonprofit, 4-year or above",2,18,15,13476297,1150138,14626435,5000454,2575745,7576199,Basketball
28979,2016,202480,University of Dayton,Dayton,OH,45469,2,NCAA Division I-FCS,4132,3735,7867,2,"Private nonprofit, 4-year or above",2,18,15,14031059,1253719,15284778,5637549,3258202,8895751,Basketball
46479,2017,202480,University of Dayton,Dayton,OH,45469,2,NCAA Division I-FCS,4202,3863,8065,2,"Private nonprofit, 4-year or above",2,16,15,14201764,1455432,15657196,7250208,3522868,10773076,Basketball
64202,2018,202480,University of Dayton,Dayton,OH,45469,2,NCAA Division I-FCS,4224,3910,8134,2,"Private nonprofit, 4-year or above",2,17,16,16281364,1428038,17709402,7434825,3888800,11323625,Basketball
110577,2019,202480,University of Dayton,Dayton,OH,45469,2,NCAA Division I-FCS,4165,3866,8031,2,"Private nonprofit, 4-year or above",2,17,16,12770091,1393017,14163108,8212991,3524840,11737831,Basketball
2570,2015,130943,University of Delaware,Newark,DE,19716,2,NCAA Division I-FCS,7430,10103,17533,1,"Public, 4-year or above",2,15,13,2328346,1682849,4011195,2328346,1682849,4011195,Basketball
19940,2016,130943,University of Delaware,Newark,DE,19716,2,NCAA Division I-FCS,7525,10211,17736,1,"Public, 4-year or above",2,14,14,2472966,2276155,4749121,2472966,2276155,4749121,Basketball
37379,2017,130943,University of Delaware,Newark,DE,19716,2,NCAA Division I-FCS,7707,10465,18172,1,"Public, 4-year or above",2,14,23,2697521,2475081,5172602,2697521,2475081,5172602,Basketball
55018,2018,130943,University of Delaware,Newark,DE,19716,2,NCAA Division I-FCS,7767,10567,18334,1,"Public, 4-year or above",2,16,30,2785559,2522440,5307999,2785559,2522440,5307999,Basketball
79342,2019,130943,University of Delaware,Newark,DE,19716,2,NCAA Division I-FCS,7738,10614,18352,1,"Public, 4-year or above",2,13,31,2681392,2522377,5203769,2681392,2522377,5203769,Basketball
2218,2015,127060,University of Denver,Denver,CO,80208,3,NCAA Division I without football,2518,2930,5448,2,"Private nonprofit, 4-year or above",2,17,18,3361111,1729128,5090239,3361111,1729128,5090239,Basketball
19587,2016,127060,University of Denver,Denver,CO,80208,3,NCAA Division I without football,2540,2938,5478,2,"Private nonprofit, 4-year or above",2,16,15,2456771,2037484,4494255,2456771,2037484,4494255,Basketball
37025,2017,127060,University of Denver,Denver,CO,80208,3,NCAA Division I without football,2547,2939,5486,2,"Private nonprofit, 4-year or above",2,15,16,2545906,2025030,4570936,2545906,2025030,4570936,Basketball
54663,2018,127060,University of Denver,Denver,CO,80208,3,NCAA Division I without football,2534,3022,5556,2,"Private nonprofit, 4-year or above",2,14,13,2532725,2002365,4535090,2532725,2002365,4535090,Basketball
78423,2019,127060,University of Denver,Denver,CO,80208,3,NCAA Division I without football,2490,2977,5467,2,"Private nonprofit, 4-year or above",2,16,12,2404397,2146459,4550856,2404397,2146459,4550856,Basketball
7116,2015,169716,University of Detroit Mercy,Detroit,MI,482213038,3,NCAA Division I without football,764,1309,2073,2,"Private nonprofit, 4-year or above",2,13,10,2845190,1511863,4357053,2467735,1511863,3979598,Basketball
24510,2016,169716,University of Detroit Mercy,Detroit,MI,48221,3,NCAA Division I without football,805,1355,2160,2,"Private nonprofit, 4-year or above",2,16,14,2502061,1535175,4037236,2350993,1535175,3886168,Basketball
42013,2017,169716,University of Detroit Mercy,Detroit,MI,48221,3,NCAA Division I without football,870,1459,2329,2,"Private nonprofit, 4-year or above",2,16,14,2673249,1552296,4225545,2673249,1552296,4225545,Basketball
59713,2018,169716,University of Detroit Mercy,Detroit,MI,48221,3,NCAA Division I without football,946,1539,2485,2,"Private nonprofit, 4-year or above",2,17,14,3276678,1332092,4608770,3276678,1332092,4608770,Basketball
95034,2019,169716,University of Detroit Mercy,Detroit,MI,48221,3,NCAA Division I without football,860,1489,2349,2,"Private nonprofit, 4-year or above",2,14,14,3140590,1441800,4582390,3140590,1441800,4582390,Basketball
4775,2015,153278,University of Dubuque,Dubuque,IA,52001,6,NCAA Division III with football,991,634,1625,2,"Private nonprofit, 4-year or above",2,30,25,235036,150833,385869,235036,150833,385869,Basketball
22140,2016,153278,University of Dubuque,Dubuque,IA,52001,6,NCAA Division III with football,1035,644,1679,2,"Private nonprofit, 4-year or above",2,24,27,258453,197746,456199,258453,197746,456199,Basketball
39611,2017,153278,University of Dubuque,Dubuque,IA,52001,6,NCAA Division III with football,1023,685,1708,2,"Private nonprofit, 4-year or above",2,31,24,235573,178496,414069,235573,178496,414069,Basketball
57274,2018,153278,University of Dubuque,Dubuque,IA,52001,6,NCAA Division III with football,974,700,1674,2,"Private nonprofit, 4-year or above",2,19,12,250111,171564,421675,250111,171564,421675,Basketball
87515,2019,153278,University of Dubuque,Dubuque,IA,52001,6,NCAA Division III with football,899,655,1554,2,"Private nonprofit, 4-year or above",2,17,15,231071,200325,431396,231071,200325,431396,Basketball
4385,2015,150534,University of Evansville,Evansville,IN,47722,3,NCAA Division I without football,950,1111,2061,2,"Private nonprofit, 4-year or above",2,14,14,2899667,1553613,4453280,2899667,1553613,4453280,Basketball
21756,2016,150534,University of Evansville,Evansville,IN,47722,3,NCAA Division I without football,922,1093,2015,2,"Private nonprofit, 4-year or above",2,14,13,2622979,1435970,4058949,2622979,1435970,4058949,Basketball
39224,2017,150534,University of Evansville,Evansville,IN,47722,3,NCAA Division I without football,869,1085,1954,2,"Private nonprofit, 4-year or above",2,12,11,3231007,1276428,4507435,3231007,1276428,4507435,Basketball
56884,2018,150534,University of Evansville,Evansville,IN,47722,3,NCAA Division I without football,831,1111,1942,2,"Private nonprofit, 4-year or above",2,15,13,2570477,1456245,4026722,2570477,1456245,4026722,Basketball
86135,2019,150534,University of Evansville,Evansville,IN,47722,3,NCAA Division I without football,753,1042,1795,2,"Private nonprofit, 4-year or above",2,15,15,2840462,1502268,4342730,2840462,1502268,4342730,Basketball
2871,2015,134130,University of Florida,Gainesville,FL,32611,1,NCAA Division I-FBS,13090,16772,29862,1,"Public, 4-year or above",2,16,13,13290354,88113,13378467,6718902,3685018,10403920,Basketball
20243,2016,134130,University of Florida,Gainesville,FL,32611,1,NCAA Division I-FBS,13390,17193,30583,1,"Public, 4-year or above",2,14,12,14200425,100738,14301163,7207469,4392831,11600300,Basketball
37690,2017,134130,University of Florida,Gainesville,FL,32611,1,NCAA Division I-FBS,13411,17476,30887,1,"Public, 4-year or above",2,15,14,11460512,70075,11530587,9018168,3468662,12486830,Basketball
55336,2018,134130,University of Florida,Gainesville,FL,32611,1,NCAA Division I-FBS,13633,18113,31746,1,"Public, 4-year or above",2,16,12,11943413,85038,12028451,9317385,3851609,13168994,Basketball
80383,2019,134130,University of Florida,Gainesville,FL,32611,1,NCAA Division I-FBS,13590,18135,31725,1,"Public, 4-year or above",2,14,14,11061415,182422,11243837,9443199,4100085,13543284,Basketball
3327,2015,139959,University of Georgia,Athens,GA,30602,1,NCAA Division I-FBS,10949,14788,25737,1,"Public, 4-year or above",2,14,14,9104434,901135,10005569,6338487,3838916,10177403,Basketball
20693,2016,139959,University of Georgia,Athens,GA,30602,1,NCAA Division I-FBS,11219,15033,26252,1,"Public, 4-year or above",2,15,12,9459251,860481,10319732,6237492,3530952,9768444,Basketball
38153,2017,139959,University of Georgia,Athens,GA,30602,1,NCAA Division I-FBS,11605,15454,27059,1,"Public, 4-year or above",2,15,12,10252418,1132276,11384694,8539387,4156331,12695718,Basketball
55805,2018,139959,University of Georgia,Athens,GA,30602,1,NCAA Division I-FBS,11922,15919,27841,1,"Public, 4-year or above",2,16,17,10693803,1110865,11804668,7756002,4106089,11862091,Basketball
82345,2019,139959,University of Georgia,Athens,GA,30602,1,NCAA Division I-FBS,11894,16197,28091,1,"Public, 4-year or above",2,15,25,9651731,933372,10585103,8304553,4364698,12669251,Basketball
2400,2015,129525,University of Hartford,West Hartford,CT,61171599,3,NCAA Division I without football,2281,2249,4530,2,"Private nonprofit, 4-year or above",2,15,15,2257904,2203624,4461528,2257904,2203624,4461528,Basketball
19772,2016,129525,University of Hartford,West Hartford,CT,6117,3,NCAA Division I without football,2240,2266,4506,2,"Private nonprofit, 4-year or above",2,14,12,1802793,1593566,3396359,1802793,1593566,3396359,Basketball
37211,2017,129525,University of Hartford,West Hartford,CT,6117,3,NCAA Division I without football,2202,2256,4458,2,"Private nonprofit, 4-year or above",2,16,11,1613063,1798937,3412000,1613063,1798937,3412000,Basketball
54847,2018,129525,University of Hartford,West Hartford,CT,6117,3,NCAA Division I without football,2199,2227,4426,2,"Private nonprofit, 4-year or above",2,17,15,2303817,2045795,4349612,2303817,2045795,4349612,Basketball
78981,2019,129525,University of Hartford,West Hartford,CT,6117,3,NCAA Division I without football,2034,2213,4247,2,"Private nonprofit, 4-year or above",2,15,14,2584087,2098386,4682473,2584087,2098386,4682473,Basketball
3494,2015,141565,University of Hawaii at Hilo,Hilo,HI,967204091,5,NCAA Division II without football,1015,1531,2546,1,"Public, 4-year or above",2,15,13,511248,558051,1069299,433354,428147,861501,Basketball
20864,2016,141565,University of Hawaii at Hilo,Hilo,HI,96720,5,NCAA Division II without football,953,1483,2436,1,"Public, 4-year or above",2,12,11,442483,465717,908200,442483,465717,908200,Basketball
38320,2017,141565,University of Hawaii at Hilo,Hilo,HI,96720,5,NCAA Division II without football,887,1448,2335,1,"Public, 4-year or above",2,17,13,538809,464219,1003028,538809,464219,1003028,Basketball
55973,2018,141565,University of Hawaii at Hilo,Hilo,HI,96720,5,NCAA Division II without football,800,1431,2231,1,"Public, 4-year or above",2,12,13,510379,465128,975507,510379,465128,975507,Basketball
82857,2019,141565,University of Hawaii at Hilo,Hilo,HI,96720,5,NCAA Division II without football,815,1388,2203,1,"Public, 4-year or above",2,13,11,520925,438202,959127,520925,438202,959127,Basketball
3502,2015,141574,University of Hawaii at Manoa,Honolulu,HI,968222217,1,NCAA Division I-FBS,5011,6201,11212,1,"Public, 4-year or above",2,15,13,2974160,1948920,4923080,2813078,1948920,4761998,Basketball
20872,2016,141574,University of Hawaii at Manoa,Honolulu,HI,96822,1,NCAA Division I-FBS,4759,5917,10676,1,"Public, 4-year or above",2,15,19,2790526,2074980,4865506,2790526,2074980,4865506,Basketball
38328,2017,141574,University of Hawaii at Manoa,Honolulu,HI,96822,1,NCAA Division I-FBS,4647,5903,10550,1,"Public, 4-year or above",2,15,24,2718051,2189601,4907652,2718051,2189601,4907652,Basketball
55981,2018,141574,University of Hawaii at Manoa,Honolulu,HI,96822,1,NCAA Division I-FBS,4529,6032,10561,1,"Public, 4-year or above",2,15,18,2960055,2348133,5308188,2960055,2348133,5308188,Basketball
82895,2019,141574,University of Hawaii at Manoa,Honolulu,HI,96822,1,NCAA Division I-FBS,4414,5970,10384,1,"Public, 4-year or above",2,15,19,1933823,985664,2919487,2827221,2123897,4951118,Basketball
14811,2015,225511,University of Houston,Houston,TX,772042018,1,NCAA Division I-FBS,12253,12231,24484,1,"Public, 4-year or above",2,13,14,6023125,2092510,8115635,6023125,2092510,8115635,Basketball
32281,2016,225511,University of Houston,Houston,TX,77204,1,NCAA Division I-FBS,12742,12657,25399,1,"Public, 4-year or above",2,13,16,4750737,2161583,6912320,4750737,2161583,6912320,Basketball
49806,2017,225511,University of Houston,Houston,TX,77204,1,NCAA Division I-FBS,13372,13383,26755,1,"Public, 4-year or above",2,15,29,5314928,2198927,7513855,5314928,2198927,7513855,Basketball
67581,2018,225511,University of Houston,Houston,TX,77204,1,NCAA Division I-FBS,13749,13933,27682,1,"Public, 4-year or above",2,14,20,9219796,2404717,11624513,9219796,2404717,11624513,Basketball
122193,2019,225511,University of Houston,Houston,TX,77204,1,NCAA Division I-FBS,13733,14305,28038,1,"Public, 4-year or above",2,13,14,7726259,2324673,10050932,7726259,2324673,10050932,Basketball
3543,2015,142285,University of Idaho,Moscow,ID,838442282,1,NCAA Division I-FBS,3871,3402,7273,1,"Public, 4-year or above",2,16,15,1821491,1419275,3240766,1821491,1419275,3240766,Basketball
20913,2016,142285,University of Idaho,Moscow,ID,83844,1,NCAA Division I-FBS,3880,3368,7248,1,"Public, 4-year or above",2,13,14,1680472,1353458,3033930,1680472,1353458,3033930,Basketball
38368,2017,142285,University of Idaho,Moscow,ID,83844,1,NCAA Division I-FBS,3737,3407,7144,1,"Public, 4-year or above",2,16,14,1716084,1258438,2974522,1716084,1258438,2974522,Basketball
56021,2018,142285,University of Idaho,Moscow,ID,83844,2,NCAA Division I-FCS,3613,3353,6966,1,"Public, 4-year or above",2,13,13,1729001,1414062,3143063,1729001,1414062,3143063,Basketball
83018,2019,142285,University of Idaho,Moscow,ID,83844,2,NCAA Division I-FCS,3433,3285,6718,1,"Public, 4-year or above",2,17,13,1457371,1355585,2812956,1457371,1355585,2812956,Basketball
3769,2015,145600,University of Illinois at Chicago,Chicago,IL,60607,3,NCAA Division I without football,7906,8109,16015,1,"Public, 4-year or above",2,15,17,1756512,938074,2694586,2231609,1553329,3784938,Basketball
21139,2016,145600,University of Illinois at Chicago,Chicago,IL,60607,3,NCAA Division I without football,8069,8339,16408,1,"Public, 4-year or above",2,17,15,2417955,1483023,3900978,2417955,1483023,3900978,Basketball
38594,2017,145600,University of Illinois at Chicago,Chicago,IL,60607,3,NCAA Division I without football,8593,9072,17665,1,"Public, 4-year or above",2,13,14,2335671,1547899,3883570,2335671,1547899,3883570,Basketball
56251,2018,145600,University of Illinois at Chicago,Chicago,IL,60607,3,NCAA Division I without football,9083,9845,18928,1,"Public, 4-year or above",2,14,14,2248503,1467498,3716001,2248503,1467498,3716001,Basketball
83984,2019,145600,University of Illinois at Chicago,Chicago,IL,60607,3,NCAA Division I without football,9471,10415,19886,1,"Public, 4-year or above",2,15,12,2203073,894044,3097117,2848259,1389204,4237463,Basketball
4198,2015,148654,University of Illinois at Springfield,Springfield,IL,627035407,5,NCAA Division II without football,836,1035,1871,1,"Public, 4-year or above",2,14,12,413010,310440,723450,413010,310440,723450,Basketball
21572,2016,148654,University of Illinois at Springfield,Springfield,IL,62703,5,NCAA Division II without football,838,1058,1896,1,"Public, 4-year or above",2,12,15,449434,372712,822146,449434,372712,822146,Basketball
39037,2017,148654,University of Illinois at Springfield,Springfield,IL,62703,5,NCAA Division II without football,864,1005,1869,1,"Public, 4-year or above",2,15,16,403786,389547,793333,403786,389547,793333,Basketball
56695,2018,148654,University of Illinois at Springfield,Springfield,IL,62703,5,NCAA Division II without football,836,937,1773,1,"Public, 4-year or above",2,18,15,428017,416047,844064,428017,416047,844064,Basketball
85461,2019,148654,University of Illinois at Springfield,Springfield,IL,62703,5,NCAA Division II without football,839,996,1835,1,"Public, 4-year or above",2,12,16,443961,426428,870389,443961,426428,870389,Basketball
3788,2015,145637,University of Illinois at Urbana-Champaign,Champaign,IL,618205711,1,NCAA Division I-FBS,17540,14012,31552,1,"Public, 4-year or above",2,16,23,16671800,554845,17226645,7341910,3314263,10656173,Basketball
21158,2016,145637,University of Illinois at Urbana-Champaign,Champaign,IL,61820,1,NCAA Division I-FBS,17529,14597,32126,1,"Public, 4-year or above",2,16,26,15827099,526115,16353214,10404451,3412639,13817090,Basketball
38613,2017,145637,University of Illinois at Urbana-Champaign,Champaign,IL,61820,1,NCAA Division I-FBS,17464,14746,32210,1,"Public, 4-year or above",2,16,36,25130930,660978,25791908,10703916,4716122,15420038,Basketball
56270,2018,145637,University of Illinois at Urbana-Champaign,Champaign,IL,61820,1,NCAA Division I-FBS,17413,14941,32354,1,"Public, 4-year or above",2,16,26,21419589,654776,22074365,10480939,4416303,14897242,Basketball
84060,2019,145637,University of Illinois at Urbana-Champaign,Champaign,IL,61820,1,NCAA Division I-FBS,17294,15114,32408,1,"Public, 4-year or above",2,16,28,21483602,715762,22199364,11607633,4692867,16300500,Basketball
4461,2015,151263,University of Indianapolis,Indianapolis,IN,462273697,4,NCAA Division II with football,1330,2137,3467,2,"Private nonprofit, 4-year or above",2,15,16,762356,644105,1406461,762356,644105,1406461,Basketball
21832,2016,151263,University of Indianapolis,Indianapolis,IN,46227,4,NCAA Division II with football,1348,2241,3589,2,"Private nonprofit, 4-year or above",2,15,16,835695,746474,1582169,835695,746474,1582169,Basketball
39305,2017,151263,University of Indianapolis,Indianapolis,IN,46227,4,NCAA Division II with football,1436,2388,3824,2,"Private nonprofit, 4-year or above",2,17,16,823114,684042,1507156,823114,684042,1507156,Basketball
56965,2018,151263,University of Indianapolis,Indianapolis,IN,46227,4,NCAA Division II with football,1511,2551,4062,2,"Private nonprofit, 4-year or above",2,15,14,891498,825059,1716557,891498,825059,1716557,Basketball
86452,2019,151263,University of Indianapolis,Indianapolis,IN,46227,4,NCAA Division II with football,1525,2541,4066,2,"Private nonprofit, 4-year or above",2,17,15,923141,812024,1735165,923141,812024,1735165,Basketball
4901,2015,153658,University of Iowa,Iowa City,IA,522421316,1,NCAA Division I-FBS,9394,10318,19712,1,"Public, 4-year or above",2,17,26,9097984,930406,10028390,7218539,4631921,11850460,Basketball
22262,2016,153658,University of Iowa,Iowa City,IA,52242,1,NCAA Division I-FBS,9801,10889,20690,1,"Public, 4-year or above",2,15,21,9707864,912427,10620291,7215672,4562262,11777934,Basketball
39738,2017,153658,University of Iowa,Iowa City,IA,52242,1,NCAA Division I-FBS,9899,11180,21079,1,"Public, 4-year or above",2,17,20,10828407,1469045,12297452,8113263,4872463,12985726,Basketball
57406,2018,153658,University of Iowa,Iowa City,IA,52242,1,NCAA Division I-FBS,10010,11546,21556,1,"Public, 4-year or above",2,16,23,12120342,1645981,13766323,8097014,5637527,13734541,Basketball
87999,2019,153658,University of Iowa,Iowa City,IA,52242,1,NCAA Division I-FBS,9652,11440,21092,1,"Public, 4-year or above",2,16,24,11163105,1033612,12196717,8557033,5483244,14040277,Basketball
5295,2015,155317,University of Kansas,Lawrence,KS,66045,1,NCAA Division I-FBS,8401,8545,16946,1,"Public, 4-year or above",2,17,27,18020944,120831,18141775,11636720,3446238,15082958,Basketball
22659,2016,155317,University of Kansas,Lawrence,KS,66045,1,NCAA Division I-FBS,8402,8585,16987,1,"Public, 4-year or above",2,15,31,18266319,115319,18381638,11126047,3702785,14828832,Basketball
40142,2017,155317,University of Kansas,Lawrence,KS,66045,1,NCAA Division I-FBS,8325,8721,17046,1,"Public, 4-year or above",2,14,22,18802173,102021,18904194,11859953,3433086,15293039,Basketball
57815,2018,155317,University of Kansas,Lawrence,KS,66045,1,NCAA Division I-FBS,8361,8889,17250,1,"Public, 4-year or above",2,16,28,18974009,85917,19059926,12547439,3736593,16284032,Basketball
89278,2019,155317,University of Kansas,Lawrence,KS,66045,1,NCAA Division I-FBS,8221,8936,17157,1,"Public, 4-year or above",2,15,13,16454643,67954,16522597,10968619,3367007,14335626,Basketball
5571,2015,157085,University of Kentucky,Lexington,KY,405060032,1,NCAA Division I-FBS,9775,11283,21058,1,"Public, 4-year or above",2,15,14,27239237,653435,27892672,18910412,5349631,24260043,Basketball
22946,2016,157085,University of Kentucky,Lexington,KY,40506,1,NCAA Division I-FBS,9420,11352,20772,1,"Public, 4-year or above",2,15,12,27965227,536393,28501620,19180059,5239432,24419491,Basketball
40441,2017,157085,University of Kentucky,Lexington,KY,40506,1,NCAA Division I-FBS,9218,11393,20611,1,"Public, 4-year or above",2,14,14,30743306,457885,31201191,18571056,5589939,24160995,Basketball
58122,2018,157085,University of Kentucky,Lexington,KY,40506,1,NCAA Division I-FBS,9010,11402,20412,1,"Public, 4-year or above",2,13,16,38829651,469223,39298874,20202558,6086548,26289106,Basketball
90078,2019,157085,University of Kentucky,Lexington,KY,40506,1,NCAA Division I-FBS,8985,11552,20537,1,"Public, 4-year or above",2,14,14,29307070,426694,29733764,18347857,5637097,23984954,Basketball
1367,2015,117140,University of La Verne,La Verne,CA,917504401,6,NCAA Division III with football,1586,2161,3747,2,"Private nonprofit, 4-year or above",2,21,16,151956,150400,302356,129036,133095,262131,Basketball
18727,2016,117140,University of La Verne,La Verne,CA,91750,6,NCAA Division III with football,1586,2226,3812,2,"Private nonprofit, 4-year or above",2,20,14,171739,158910,330649,149132,135628,284760,Basketball
36161,2017,117140,University of La Verne,La Verne,CA,91750,6,NCAA Division III with football,1576,2163,3739,2,"Private nonprofit, 4-year or above",2,19,19,178007,166848,344855,168679,143363,312042,Basketball
53786,2018,117140,University of La Verne,La Verne,CA,91750,6,NCAA Division III with football,1573,2154,3727,2,"Private nonprofit, 4-year or above",2,18,31,170119,174150,344269,150555,148571,299126,Basketball
75344,2019,117140,University of La Verne,La Verne,CA,91750,6,NCAA Division III with football,1402,1951,3353,2,"Private nonprofit, 4-year or above",2,18,30,147029,162466,309495,133482,155201,288683,Basketball
5866,2015,160658,University of Louisiana at Lafayette,Lafayette,LA,70503,1,NCAA Division I-FBS,5857,6995,12852,1,"Public, 4-year or above",2,20,16,2332684,1358082,3690766,2332684,1358082,3690766,Basketball
23250,2016,160658,University of Louisiana at Lafayette,Lafayette,LA,70503,1,NCAA Division I-FBS,5743,7116,12859,1,"Public, 4-year or above",2,19,19,2278475,1496863,3775338,2278475,1496863,3775338,Basketball
40748,2017,160658,University of Louisiana at Lafayette,Lafayette,LA,70503,1,NCAA Division I-FBS,5724,7018,12742,1,"Public, 4-year or above",2,15,15,2717629,1492725,4210354,2717628,1492725,4210353,Basketball
58430,2018,160658,University of Louisiana at Lafayette,Lafayette,LA,70503,1,NCAA Division I-FBS,5487,6911,12398,1,"Public, 4-year or above",2,16,12,2780548,1608902,4389450,2780548,1608902,4389450,Basketball
91206,2019,160658,University of Louisiana at Lafayette,Lafayette,LA,70503,1,NCAA Division I-FBS,5256,6645,11901,1,"Public, 4-year or above",2,15,15,2553140,1752361,4305501,2553140,1752361,4305501,Basketball
5824,2015,159993,University of Louisiana at Monroe,Monroe,LA,712090000,1,NCAA Division I-FBS,1767,3184,4951,1,"Public, 4-year or above",2,13,14,1157908,809240,1967148,1157908,809240,1967148,Basketball
23208,2016,159993,University of Louisiana at Monroe,Monroe,LA,71209,1,NCAA Division I-FBS,1844,3305,5149,1,"Public, 4-year or above",2,13,16,1382433,880800,2263233,1382433,880800,2263233,Basketball
40706,2017,159993,University of Louisiana at Monroe,Monroe,LA,71209,1,NCAA Division I-FBS,1876,3268,5144,1,"Public, 4-year or above",2,15,15,1349628,923577,2273205,1349628,923577,2273205,Basketball
58390,2018,159993,University of Louisiana at Monroe,Monroe,LA,71209,1,NCAA Division I-FBS,1866,3148,5014,1,"Public, 4-year or above",2,15,15,1469020,1307398,2776418,1469020,1307398,2776418,Basketball
91016,2019,159993,University of Louisiana at Monroe,Monroe,LA,71209,1,NCAA Division I-FBS,1723,3011,4734,1,"Public, 4-year or above",2,15,34,1356316,1190757,2547073,1356316,1190757,2547073,Basketball
5601,2015,157289,University of Louisville,Louisville,KY,402920001,1,NCAA Division I-FBS,5946,6268,12214,1,"Public, 4-year or above",2,15,13,45632816,1218690,46851506,17900031,4914320,22814351,Basketball
22978,2016,157289,University of Louisville,Louisville,KY,40292,1,NCAA Division I-FBS,5925,6400,12325,1,"Public, 4-year or above",2,15,15,43960492,1283617,45244109,17065364,4813071,21878435,Basketball
40474,2017,157289,University of Louisville,Louisville,KY,40292,1,NCAA Division I-FBS,5635,6329,11964,1,"Public, 4-year or above",2,15,11,43134625,1610281,44744906,21817723,5482652,27300375,Basketball
58155,2018,157289,University of Louisville,Louisville,KY,40292,1,NCAA Division I-FBS,5463,6410,11873,1,"Public, 4-year or above",2,14,30,42759248,5800173,48559421,19180078,5800173,24980251,Basketball
90192,2019,157289,University of Louisville,Louisville,KY,40292,1,NCAA Division I-FBS,5164,6335,11499,1,"Public, 4-year or above",2,16,16,40684042,1493218,42177260,19847347,5436075,25283422,Basketball
50739,2017,232609,University of Lynchburg,Lynchburg,VA,24501,7,NCAA Division III without football,764,1158,1922,2,"Private nonprofit, 4-year or above",2,20,12,268935,204286,473221,268935,204286,473221,Basketball
68488,2018,232609,University of Lynchburg,Lynchburg,VA,24501,7,NCAA Division III without football,775,1152,1927,2,"Private nonprofit, 4-year or above",2,19,12,245942,213955,459897,245942,213956,459898,Basketball
125780,2019,232609,University of Lynchburg,Lynchburg,VA,24501,7,NCAA Division III without football,708,1106,1814,2,"Private nonprofit, 4-year or above",2,20,14,255822,205379,461201,255822,205379,461201,Basketball
5962,2015,161253,University of Maine,Orono,ME,4469,2,NCAA Division I-FCS,4221,3780,8001,1,"Public, 4-year or above",2,19,17,1328389,1382353,2710742,1328389,1382353,2710742,Basketball
23349,2016,161253,University of Maine,Orono,ME,4469,2,NCAA Division I-FCS,4285,3797,8082,1,"Public, 4-year or above",2,17,17,1296517,1332831,2629348,1296517,1332831,2629348,Basketball
40849,2017,161253,University of Maine,Orono,ME,4469,2,NCAA Division I-FCS,4350,3811,8161,1,"Public, 4-year or above",2,17,13,1335678,1180588,2516266,1335678,1180588,2516266,Basketball
58536,2018,161253,University of Maine,Orono,ME,4469,2,NCAA Division I-FCS,4324,3802,8126,1,"Public, 4-year or above",2,16,13,1432766,1372435,2805201,1432766,1372435,2805201,Basketball
91532,2019,161253,University of Maine,Orono,ME,4469,2,NCAA Division I-FCS,4286,3742,8028,1,"Public, 4-year or above",2,15,14,1582184,1467993,3050177,1582184,1467993,3050177,Basketball
5947,2015,161226,University of Maine at Farmington,Farmington,ME,49389978,7,NCAA Division III without football,587,1093,1680,1,"Public, 4-year or above",2,13,16,78844,88239,167083,78844,88239,167083,Basketball
23334,2016,161226,University of Maine at Farmington,Farmington,ME,4938,7,NCAA Division III without football,575,1081,1656,1,"Public, 4-year or above",2,14,16,90294,85399,175693,90294,85399,175693,Basketball
40833,2017,161226,University of Maine at Farmington,Farmington,ME,4938,7,NCAA Division III without football,565,1099,1664,1,"Public, 4-year or above",2,15,14,89361,87340,176701,89361,87340,176701,Basketball
58519,2018,161226,University of Maine at Farmington,Farmington,ME,4938,7,NCAA Division III without football,527,1030,1557,1,"Public, 4-year or above",2,17,14,100662,95356,196018,100662,95356,196018,Basketball
91485,2019,161226,University of Maine at Farmington,Farmington,ME,4938,7,NCAA Division III without football,501,1002,1503,1,"Public, 4-year or above",2,16,17,106658,100200,206858,106658,100200,206858,Basketball
5978,2015,161341,University of Maine at Presque Isle,Presque Isle,ME,47692888,7,NCAA Division III without football,267,394,661,1,"Public, 4-year or above",2,11,13,81004,58343,139347,80004,57343,137347,Basketball
23365,2016,161341,University of Maine at Presque Isle,Presque Isle,ME,4769,7,NCAA Division III without football,248,399,647,1,"Public, 4-year or above",2,12,12,68248,39460,107708,68248,39460,107708,Basketball
40865,2017,161341,University of Maine at Presque Isle,Presque Isle,ME,4769,7,NCAA Division III without football,276,394,670,1,"Public, 4-year or above",2,12,10,79594,38281,117875,79594,38281,117875,Basketball
58553,2018,161341,University of Maine at Presque Isle,Presque Isle,ME,4769,7,NCAA Division III without football,247,374,621,1,"Public, 4-year or above",2,16,9,62729,48066,110795,62729,48066,110795,Basketball
91607,2019,161341,University of Maine at Presque Isle,Presque Isle,ME,4769,7,NCAA Division III without football,238,358,596,1,"Public, 4-year or above",2,19,11,57769,54709,112478,57769,54709,112478,Basketball
11323,2015,200217,University of Mary,Bismarck,ND,58504,4,NCAA Division II with football,586,1119,1705,2,"Private nonprofit, 4-year or above",2,16,17,492470,521322,1013792,492470,521322,1013792,Basketball
28761,2016,200217,University of Mary,Bismarck,ND,58504,4,NCAA Division II with football,607,1124,1731,2,"Private nonprofit, 4-year or above",2,18,16,505561,505263,1010824,505561,505263,1010824,Basketball
46264,2017,200217,University of Mary,Bismarck,ND,58504,4,NCAA Division II with football,663,1130,1793,2,"Private nonprofit, 4-year or above",2,16,17,489953,513425,1003378,489953,513425,1003378,Basketball
63984,2018,200217,University of Mary,Bismarck,ND,58504,4,NCAA Division II with football,725,1119,1844,2,"Private nonprofit, 4-year or above",2,17,17,536539,520370,1056909,536539,520370,1056909,Basketball
109712,2019,200217,University of Mary,Bismarck,ND,58504,4,NCAA Division II with football,756,1105,1861,2,"Private nonprofit, 4-year or above",2,16,15,501451,509133,1010584,501451,509133,1010584,Basketball
14910,2015,226471,University of Mary Hardin-Baylor,Belton,TX,765132599,6,NCAA Division III with football,1086,1844,2930,2,"Private nonprofit, 4-year or above",2,18,20,262499,219844,482343,262499,219844,482343,Basketball
32380,2016,226471,University of Mary Hardin-Baylor,Belton,TX,76513,6,NCAA Division III with football,1098,1896,2994,2,"Private nonprofit, 4-year or above",2,18,20,267924,240206,508130,267924,240206,508130,Basketball
49905,2017,226471,University of Mary Hardin-Baylor,Belton,TX,76513,6,NCAA Division III with football,1104,1941,3045,2,"Private nonprofit, 4-year or above",2,20,20,275487,212461,487948,275487,212461,487948,Basketball
67683,2018,226471,University of Mary Hardin-Baylor,Belton,TX,76513,6,NCAA Division III with football,1134,2046,3180,2,"Private nonprofit, 4-year or above",2,14,26,275541,275714,551255,275541,275714,551255,Basketball
122699,2019,226471,University of Mary Hardin-Baylor,Belton,TX,76513,6,NCAA Division III with football,1099,2013,3112,2,"Private nonprofit, 4-year or above",2,18,23,311528,287801,599329,311528,287801,599329,Basketball
15741,2015,232681,University of Mary Washington,Fredericksburg,VA,224015300,7,NCAA Division III without football,1357,2432,3789,1,"Public, 4-year or above",2,17,12,182338,199928,382266,170493,198971,369464,Basketball
33214,2016,232681,University of Mary Washington,Fredericksburg,VA,22401,7,NCAA Division III without football,1380,2470,3850,1,"Public, 4-year or above",2,12,15,195913,211100,407013,191016,208516,399532,Basketball
50757,2017,232681,University of Mary Washington,Fredericksburg,VA,22401,7,NCAA Division III without football,1409,2486,3895,1,"Public, 4-year or above",2,18,14,183958,182038,365996,183484,181424,364908,Basketball
68504,2018,232681,University of Mary Washington,Fredericksburg,VA,22401,7,NCAA Division III without football,1392,2472,3864,1,"Public, 4-year or above",2,18,13,205909,195166,401075,203565,193404,396969,Basketball
125803,2019,232681,University of Mary Washington,Fredericksburg,VA,22401,7,NCAA Division III without football,1330,2357,3687,1,"Public, 4-year or above",2,13,15,245617,242800,488417,245608,211013,456621,Basketball
6208,2015,163338,University of Maryland Eastern Shore,Princess Anne,MD,218531299,3,NCAA Division I without football,1480,1810,3290,1,"Public, 4-year or above",2,15,16,1764427,1045073,2809500,1135732,981378,2117110,Basketball
23590,2016,163338,University of Maryland Eastern Shore,Princess Anne,MD,21853,3,NCAA Division I without football,1312,1605,2917,1,"Public, 4-year or above",2,17,15,1139072,882212,2021284,1064879,790104,1854983,Basketball
41093,2017,163338,University of Maryland Eastern Shore,Princess Anne,MD,21853,3,NCAA Division I without football,1150,1423,2573,1,"Public, 4-year or above",2,15,16,1484690,873405,2358095,994690,923405,1918095,Basketball
58786,2018,163338,University of Maryland Eastern Shore,Princess Anne,MD,21853,3,NCAA Division I without football,1041,1319,2360,1,"Public, 4-year or above",2,12,15,1438650,880000,2318650,1000683,937506,1938189,Basketball
92478,2019,163338,University of Maryland Eastern Shore,Princess Anne,MD,21853,3,NCAA Division I without football,938,1157,2095,1,"Public, 4-year or above",2,15,17,1055870,1032908,2088778,1097866,1071436,2169302,Basketball
6185,2015,163268,University of Maryland-Baltimore County,Baltimore,MD,21250,3,NCAA Division I without football,5221,4356,9577,1,"Public, 4-year or above",2,14,15,1485381,1361512,2846893,1485381,1361512,2846893,Basketball
23568,2016,163268,University of Maryland-Baltimore County,Baltimore,MD,21250,3,NCAA Division I without football,5260,4214,9474,1,"Public, 4-year or above",2,13,16,1548500,1511948,3060448,1548500,1511948,3060448,Basketball
41071,2017,163268,University of Maryland-Baltimore County,Baltimore,MD,21250,3,NCAA Division I without football,5286,4241,9527,1,"Public, 4-year or above",2,16,16,1766581,1468469,3235050,1766581,1468469,3235050,Basketball
58764,2018,163268,University of Maryland-Baltimore County,Baltimore,MD,21250,3,NCAA Division I without football,5332,4277,9609,1,"Public, 4-year or above",2,14,16,2461304,1474287,3935591,2222771,1445287,3668058,Basketball
92402,2019,163268,University of Maryland-Baltimore County,Baltimore,MD,21250,3,NCAA Division I without football,5226,4196,9422,1,"Public, 4-year or above",2,14,14,2370056,1620557,3990613,2370056,1620557,3990613,Basketball
6194,2015,163286,University of Maryland-College Park,College Park,MD,20742,1,NCAA Division I-FBS,13500,11772,25272,1,"Public, 4-year or above",2,15,13,17144695,1182995,18327690,7622707,4456893,12079600,Basketball
23576,2016,163286,University of Maryland-College Park,College Park,MD,20742,1,NCAA Division I-FBS,13815,12359,26174,1,"Public, 4-year or above",2,16,14,17741322,1373321,19114643,7442558,4892206,12334764,Basketball
41079,2017,163286,University of Maryland-College Park,College Park,MD,20742,1,NCAA Division I-FBS,14594,12944,27538,1,"Public, 4-year or above",2,16,10,14157452,960805,15118257,8375834,4471243,12847077,Basketball
58772,2018,163286,University of Maryland-College Park,College Park,MD,20742,1,NCAA Division I-FBS,14934,13408,28342,1,"Public, 4-year or above",2,15,10,14059425,677530,14736955,9163793,4402238,13566031,Basketball
92440,2019,163286,University of Maryland-College Park,College Park,MD,20742,1,NCAA Division I-FBS,14602,13626,28228,1,"Public, 4-year or above",2,17,13,14082391,799135,14881526,8563323,5057959,13621282,Basketball
6647,2015,166629,University of Massachusetts-Amherst,Amherst,MA,1003,1,NCAA Division I-FBS,10879,10083,20962,1,"Public, 4-year or above",2,14,20,4064482,2513632,6578114,4064482,2513632,6578114,Basketball
24033,2016,166629,University of Massachusetts-Amherst,Amherst,MA,1003,1,NCAA Division I-FBS,11102,10238,21340,1,"Public, 4-year or above",2,15,22,5324089,2062898,7386987,5324089,2062898,7386987,Basketball
41545,2017,166629,University of Massachusetts-Amherst,Amherst,MA,1003,1,NCAA Division I-FBS,10958,10523,21481,1,"Public, 4-year or above",2,18,20,4345060,2364378,6709438,4345060,2364378,6709438,Basketball
59242,2018,166629,University of Massachusetts-Amherst,Amherst,MA,1003,1,NCAA Division I-FBS,11047,10659,21706,1,"Public, 4-year or above",2,16,35,4025395,2449196,6474591,4025395,2449196,6474591,Basketball
93864,2019,166629,University of Massachusetts-Amherst,Amherst,MA,1003,1,NCAA Division I-FBS,11419,10998,22417,1,"Public, 4-year or above",2,15,30,4302474,2463158,6765632,4302474,2463158,6765632,Basketball
6659,2015,166638,University of Massachusetts-Boston,Boston,MA,21253393,7,NCAA Division III without football,4271,4990,9261,1,"Public, 4-year or above",2,18,15,137233,148480,285713,137233,148480,285713,Basketball
24045,2016,166638,University of Massachusetts-Boston,Boston,MA,2125,7,NCAA Division III without football,4281,4858,9139,1,"Public, 4-year or above",2,17,13,135841,137904,273745,135841,137904,273745,Basketball
41557,2017,166638,University of Massachusetts-Boston,Boston,MA,2125,7,NCAA Division III without football,4481,4959,9440,1,"Public, 4-year or above",2,16,18,172789,141612,314401,172789,141612,314401,Basketball
59254,2018,166638,University of Massachusetts-Boston,Boston,MA,2125,7,NCAA Division III without football,4536,5361,9897,1,"Public, 4-year or above",2,19,17,154927,150365,305292,154927,150365,305292,Basketball
93902,2019,166638,University of Massachusetts-Boston,Boston,MA,2125,7,NCAA Division III without football,4375,5515,9890,1,"Public, 4-year or above",2,16,18,168672,167017,335689,168672,167017,335689,Basketball
6838,2015,167987,University of Massachusetts-Dartmouth,North Dartmouth,MA,27472300,6,NCAA Division III with football,3312,2899,6211,1,"Public, 4-year or above",2,15,15,101050,65595,166645,88426,74478,162904,Basketball
24229,2016,167987,University of Massachusetts-Dartmouth,North Dartmouth,MA,2747,6,NCAA Division III with football,3093,2860,5953,1,"Public, 4-year or above",2,15,14,96449,110347,206796,82477,109296,191773,Basketball
41733,2017,167987,University of Massachusetts-Dartmouth,North Dartmouth,MA,2747,6,NCAA Division III with football,3059,2694,5753,1,"Public, 4-year or above",2,15,14,124400,148765,273165,94790,99816,194606,Basketball
59424,2018,167987,University of Massachusetts-Dartmouth,North Dartmouth,MA,2747,6,NCAA Division III with football,3068,2793,5861,1,"Public, 4-year or above",2,14,12,112913,105840,218753,86602,94527,181129,Basketball
94300,2019,167987,University of Massachusetts-Dartmouth,North Dartmouth,MA,2747,6,NCAA Division III with football,2790,2649,5439,1,"Public, 4-year or above",2,13,10,108749,101704,210453,82898,91781,174679,Basketball
6637,2015,166513,University of Massachusetts-Lowell,Lowell,MA,18545104,3,NCAA Division I without football,6088,3598,9686,1,"Public, 4-year or above",2,14,13,1821405,1262637,3084042,1506032,1262637,2768669,Basketball
24024,2016,166513,University of Massachusetts-Lowell,Lowell,MA,1854,3,NCAA Division I without football,6195,3711,9906,1,"Public, 4-year or above",2,13,15,1916767,1383842,3300609,1835892,1383842,3219734,Basketball
41536,2017,166513,University of Massachusetts-Lowell,Lowell,MA,1854,3,NCAA Division I without football,6522,3893,10415,1,"Public, 4-year or above",2,13,15,1868040,1722654,3590694,1868040,1703280,3571320,Basketball
59233,2018,166513,University of Massachusetts-Lowell,Lowell,MA,1854,3,NCAA Division I without football,6558,4027,10585,1,"Public, 4-year or above",2,13,14,2001656,1578140,3579796,1882325,1578140,3460465,Basketball
93826,2019,166513,University of Massachusetts-Lowell,Lowell,MA,1854,3,NCAA Division I without football,6537,4257,10794,1,"Public, 4-year or above",2,14,15,2142404,1566323,3708727,2058834,1566323,3625157,Basketball
14468,2015,220862,University of Memphis,Memphis,TN,38152,1,NCAA Division I-FBS,5024,6989,12013,1,"Public, 4-year or above",2,17,27,11226419,2691208,13917627,11226419,2691208,13917627,Basketball
31933,2016,220862,University of Memphis,Memphis,TN,38152,1,NCAA Division I-FBS,5278,7094,12372,1,"Public, 4-year or above",2,13,12,9725710,2335389,12061099,9725710,2335389,12061099,Basketball
49451,2017,220862,University of Memphis,Memphis,TN,38152,1,NCAA Division I-FBS,5243,7127,12370,1,"Public, 4-year or above",2,16,13,11859500,2567407,14426907,11859500,2567407,14426907,Basketball
67220,2018,220862,University of Memphis,Memphis,TN,38152,1,NCAA Division I-FBS,5090,6934,12024,1,"Public, 4-year or above",2,14,12,8217757,2670945,10888702,8217757,2670945,10888702,Basketball
120717,2019,220862,University of Memphis,Memphis,TN,38152,1,NCAA Division I-FBS,5022,7010,12032,1,"Public, 4-year or above",2,12,13,11932656,2907618,14840274,11932656,2907618,14840274,Basketball
2929,2015,135726,University of Miami,Coral Gables,FL,33146,1,NCAA Division I-FBS,5025,5252,10277,2,"Private nonprofit, 4-year or above",2,13,18,6475314,1048464,7523778,7118296,4545007,11663303,Basketball
20303,2016,135726,University of Miami,Coral Gables,FL,33146,1,NCAA Division I-FBS,4832,5270,10102,2,"Private nonprofit, 4-year or above",2,13,23,10868814,4836983,15705797,7547589,4836983,12384572,Basketball
37752,2017,135726,University of Miami,Coral Gables,FL,33146,1,NCAA Division I-FBS,4874,5260,10134,2,"Private nonprofit, 4-year or above",2,15,21,8603153,5252552,13855705,8240615,5252552,13493167,Basketball
55402,2018,135726,University of Miami,Coral Gables,FL,33146,1,NCAA Division I-FBS,4959,5453,10412,2,"Private nonprofit, 4-year or above",2,13,22,9988284,5723586,15711870,8895333,5723586,14618919,Basketball
80745,2019,135726,University of Miami,Coral Gables,FL,33146,1,NCAA Division I-FBS,4946,5678,10624,2,"Private nonprofit, 4-year or above",2,13,21,9209237,5734665,14943902,9209237,5734665,14943902,Basketball
7284,2015,170976,University of Michigan-Ann Arbor,Ann Arbor,MI,48109,1,NCAA Division I-FBS,13642,13519,27161,1,"Public, 4-year or above",2,16,41,16776377,328219,17104596,8920109,3700917,12621026,Basketball
24687,2016,170976,University of Michigan-Ann Arbor,Ann Arbor,MI,48109,1,NCAA Division I-FBS,13891,13942,27833,1,"Public, 4-year or above",2,17,43,16913194,407722,17320916,8800186,4042791,12842977,Basketball
42184,2017,170976,University of Michigan-Ann Arbor,Ann Arbor,MI,48109,1,NCAA Division I-FBS,14205,14314,28519,1,"Public, 4-year or above",2,16,40,20027574,438156,20465730,9982947,4213879,14196826,Basketball
59886,2018,170976,University of Michigan-Ann Arbor,Ann Arbor,MI,48109,1,NCAA Division I-FBS,14503,14581,29084,1,"Public, 4-year or above",2,15,43,21114322,466499,21580821,9874360,4940745,14815105,Basketball
95735,2019,170976,University of Michigan-Ann Arbor,Ann Arbor,MI,48109,1,NCAA Division I-FBS,14934,15123,30057,1,"Public, 4-year or above",2,15,43,17759785,403614,18163399,7469435,4390878,11860313,Basketball
7665,2015,174075,University of Minnesota-Crookston,Crookston,MN,567165001,4,NCAA Division II with football,599,583,1182,1,"Public, 4-year or above",2,15,16,421581,447225,868806,421581,447225,868806,Basketball
25079,2016,174075,University of Minnesota-Crookston,Crookston,MN,56716,4,NCAA Division II with football,598,545,1143,1,"Public, 4-year or above",2,16,12,464556,449856,914412,464556,449856,914412,Basketball
42575,2017,174075,University of Minnesota-Crookston,Crookston,MN,56716,4,NCAA Division II with football,566,558,1124,1,"Public, 4-year or above",2,15,12,501828,491607,993435,501828,484594,986422,Basketball
60282,2018,174075,University of Minnesota-Crookston,Crookston,MN,56716,4,NCAA Division II with football,558,598,1156,1,"Public, 4-year or above",2,16,16,483294,544025,1027319,504760,523669,1028429,Basketball
96943,2019,174075,University of Minnesota-Crookston,Crookston,MN,56716,4,NCAA Division II with football,556,609,1165,1,"Public, 4-year or above",2,14,16,528425,535796,1064221,518628,533208,1051836,Basketball
7674,2015,174233,University of Minnesota-Duluth,Duluth,MN,55812,4,NCAA Division II with football,4630,3858,8488,1,"Public, 4-year or above",2,15,14,341503,466695,808198,542064,466695,1008759,Basketball
25088,2016,174233,University of Minnesota-Duluth,Duluth,MN,55812,4,NCAA Division II with football,4717,3903,8620,1,"Public, 4-year or above",2,16,17,494941,507481,1002422,494941,507481,1002422,Basketball
42584,2017,174233,University of Minnesota-Duluth,Duluth,MN,55812,4,NCAA Division II with football,4688,4081,8769,1,"Public, 4-year or above",2,17,16,665033,622209,1287242,665033,622209,1287242,Basketball
60291,2018,174233,University of Minnesota-Duluth,Duluth,MN,55812,4,NCAA Division II with football,4553,4122,8675,1,"Public, 4-year or above",2,15,14,327245,529130,856375,529004,529130,1058134,Basketball
96953,2019,174233,University of Minnesota-Duluth,Duluth,MN,55812,4,NCAA Division II with football,4398,4013,8411,1,"Public, 4-year or above",2,14,13,680361,551495,1231856,680361,551495,1231856,Basketball
7683,2015,174251,University of Minnesota-Morris,Morris,MN,56267,6,NCAA Division III with football,762,912,1674,1,"Public, 4-year or above",2,14,11,103932,110117,214049,93530,101608,195138,Basketball
25097,2016,174251,University of Minnesota-Morris,Morris,MN,56267,6,NCAA Division III with football,716,902,1618,1,"Public, 4-year or above",2,11,11,102416,98976,201392,96894,93754,190648,Basketball
42593,2017,174251,University of Minnesota-Morris,Morris,MN,56267,6,NCAA Division III with football,651,843,1494,1,"Public, 4-year or above",2,10,12,97155,98068,195223,97155,98068,195223,Basketball
60300,2018,174251,University of Minnesota-Morris,Morris,MN,56267,6,NCAA Division III with football,618,821,1439,1,"Public, 4-year or above",2,14,13,101372,95932,197304,98981,90566,189547,Basketball
96991,2019,174251,University of Minnesota-Morris,Morris,MN,56267,6,NCAA Division III with football,566,783,1349,1,"Public, 4-year or above",2,17,15,97081,104572,201653,97358,104181,201539,Basketball
7651,2015,174066,University of Minnesota-Twin Cities,Minneapolis,MN,554550213,1,NCAA Division I-FBS,13666,14540,28206,1,"Public, 4-year or above",2,16,27,12588830,454476,13043306,8156541,4261784,12418325,Basketball
25065,2016,174066,University of Minnesota-Twin Cities,Minneapolis,MN,55455,1,NCAA Division I-FBS,13827,14955,28782,1,"Public, 4-year or above",2,16,39,14172048,873842,15045890,7997511,4016362,12013873,Basketball
42561,2017,174066,University of Minnesota-Twin Cities,Minneapolis,MN,55455,1,NCAA Division I-FBS,13884,15428,29312,1,"Public, 4-year or above",2,17,35,17454711,584434,18039145,8765442,4365859,13131301,Basketball
60268,2018,174066,University of Minnesota-Twin Cities,Minneapolis,MN,55455,1,NCAA Division I-FBS,13569,15658,29227,1,"Public, 4-year or above",2,16,30,18835871,1089358,19925229,9115817,4539092,13654909,Basketball
96905,2019,174066,University of Minnesota-Twin Cities,Minneapolis,MN,55455,1,NCAA Division I-FBS,13559,15677,29236,1,"Public, 4-year or above",2,14,31,14768976,645266,15414242,8435194,4458578,12893772,Basketball
7984,2015,176017,University of Mississippi,University,MS,386771848,1,NCAA Division I-FBS,7460,9660,17120,1,"Public, 4-year or above",2,15,13,9358733,178339,9537072,7127529,3781496,10909025,Basketball
25401,2016,176017,University of Mississippi,University,MS,38677,1,NCAA Division I-FBS,7716,9933,17649,1,"Public, 4-year or above",2,15,12,10700408,398756,11099164,7588764,4363401,11952165,Basketball
42898,2017,176017,University of Mississippi,University,MS,38677,1,NCAA Division I-FBS,7653,9708,17361,1,"Public, 4-year or above",2,16,13,10572245,368352,10940597,12547833,5338894,17886727,Basketball
60602,2018,176017,University of Mississippi,University,MS,38677,1,NCAA Division I-FBS,7087,9392,16479,1,"Public, 4-year or above",2,18,14,11224450,4681389,15905839,9432295,4681389,14113684,Basketball
98161,2019,176017,University of Mississippi,University,MS,38677,1,NCAA Division I-FBS,6770,8973,15743,1,"Public, 4-year or above",2,18,13,10199917,605616,10805533,9804101,4623182,14427283,Basketball
8274,2015,178396,University of Missouri-Columbia,Columbia,MO,65211,1,NCAA Division I-FBS,12370,13539,25909,1,"Public, 4-year or above",2,18,14,9338577,3532361,12870938,5963284,3532361,9495645,Basketball
25706,2016,178396,University of Missouri-Columbia,Columbia,MO,65211,1,NCAA Division I-FBS,11470,12590,24060,1,"Public, 4-year or above",2,15,14,10065698,3541721,13607419,10065698,3541721,13607419,Basketball
43195,2017,178396,University of Missouri-Columbia,Columbia,MO,65211,1,NCAA Division I-FBS,10597,11534,22131,1,"Public, 4-year or above",2,19,14,13772989,3777261,17550250,8387295,3777261,12164556,Basketball
60914,2018,178396,University of Missouri-Columbia,Columbia,MO,65211,1,NCAA Division I-FBS,9734,10933,20667,1,"Public, 4-year or above",2,16,14,12586990,4416682,17003672,8255259,4416682,12671941,Basketball
99309,2019,178396,University of Missouri-Columbia,Columbia,MO,65211,1,NCAA Division I-FBS,9670,10967,20637,1,"Public, 4-year or above",2,16,14,10818454,3799945,14618399,9118566,3799945,12918511,Basketball
8285,2015,178402,University of Missouri-Kansas City,Kansas City,MO,64110,3,NCAA Division I without football,2793,3687,6480,1,"Public, 4-year or above",2,15,14,1815762,1339625,3155387,1815762,1339625,3155387,Basketball
25717,2016,178402,University of Missouri-Kansas City,Kansas City,MO,64110,3,NCAA Division I without football,2783,3745,6528,1,"Public, 4-year or above",2,17,15,2207560,1397252,3604812,2207560,1397252,3604812,Basketball
43206,2017,178402,University of Missouri-Kansas City,Kansas City,MO,64110,3,NCAA Division I without football,2871,3795,6666,1,"Public, 4-year or above",2,15,14,1859426,1309554,3168980,1859426,1309554,3168980,Basketball
60925,2018,178402,University of Missouri-Kansas City,Kansas City,MO,64110,3,NCAA Division I without football,2786,3724,6510,1,"Public, 4-year or above",2,23,18,3902606,1366828,5269434,2246404,1296062,3542466,Basketball
99347,2019,178402,University of Missouri-Kansas City,Kansas City,MO,64110,3,NCAA Division I without football,2715,3650,6365,1,"Public, 4-year or above",2,17,13,2141662,1466006,3607668,2067217,1443800,3511017,Basketball
8301,2015,178420,University of Missouri-St Louis,Saint Louis,MO,631214400,5,NCAA Division II without football,2401,3140,5541,1,"Public, 4-year or above",2,18,14,618308,534125,1152433,614951,535510,1150461,Basketball
25733,2016,178420,University of Missouri-St Louis,Saint Louis,MO,63121,5,NCAA Division II without football,2277,2972,5249,1,"Public, 4-year or above",2,15,13,648882,576650,1225532,648882,576650,1225532,Basketball
43223,2017,178420,University of Missouri-St Louis,Saint Louis,MO,63121,5,NCAA Division II without football,2326,2919,5245,1,"Public, 4-year or above",2,14,12,594697,549792,1144489,594697,549792,1144489,Basketball
60942,2018,178420,University of Missouri-St Louis,Saint Louis,MO,63121,5,NCAA Division II without football,2280,2828,5108,1,"Public, 4-year or above",2,16,13,616556,595188,1211744,616556,595188,1211744,Basketball
99423,2019,178420,University of Missouri-St Louis,Saint Louis,MO,63121,5,NCAA Division II without football,2105,2695,4800,1,"Public, 4-year or above",2,15,13,672154,595234,1267388,672154,595234,1267388,Basketball
201,2015,101709,University of Montevallo,Montevallo,AL,351156000,5,NCAA Division II without football,742,1557,2299,1,"Public, 4-year or above",2,14,14,605176,466122,1071298,605176,466122,1071298,Basketball
17548,2016,101709,University of Montevallo,Montevallo,AL,35115,5,NCAA Division II without football,689,1488,2177,1,"Public, 4-year or above",2,15,13,600081,502249,1102330,600081,502249,1102330,Basketball
34958,2017,101709,University of Montevallo,Montevallo,AL,35115,5,NCAA Division II without football,685,1414,2099,1,"Public, 4-year or above",2,15,18,577555,461983,1039538,577555,461983,1039538,Basketball
52588,2018,101709,University of Montevallo,Montevallo,AL,35115,5,NCAA Division II without football,683,1379,2062,1,"Public, 4-year or above",2,13,14,663482,542743,1206225,663482,542743,1206225,Basketball
71086,2019,101709,University of Montevallo,Montevallo,AL,35115,5,NCAA Division II without football,687,1308,1995,1,"Public, 4-year or above",2,16,16,491774,497549,989323,491774,497549,989323,Basketball
11051,2015,199069,University of Mount Olive,Mount Olive,NC,283650919,5,NCAA Division II without football,575,817,1392,2,"Private nonprofit, 4-year or above",2,24,26,430717,338143,768860,408142,328007,736149,Basketball
28490,2016,199069,University of Mount Olive,Mount Olive,NC,28365,5,NCAA Division II without football,577,869,1446,2,"Private nonprofit, 4-year or above",2,24,28,381859,359963,741822,369367,357411,726778,Basketball
45983,2017,199069,University of Mount Olive,Mount Olive,NC,28365,5,NCAA Division II without football,611,855,1466,2,"Private nonprofit, 4-year or above",2,30,23,432539,392191,824730,418947,379426,798373,Basketball
63703,2018,199069,University of Mount Olive,Mount Olive,NC,28365,5,NCAA Division II without football,578,787,1365,2,"Private nonprofit, 4-year or above",2,25,21,435301,385373,820674,388026,380923,768949,Basketball
108652,2019,199069,University of Mount Olive,Mount Olive,NC,28365,5,NCAA Division II without football,577,911,1488,2,"Private nonprofit, 4-year or above",2,30,29,458755,489736,948491,447218,483890,931108,Basketball
11712,2015,204185,University of Mount Union,Alliance,OH,446013993,6,NCAA Division III with football,1025,1019,2044,2,"Private nonprofit, 4-year or above",2,29,32,202504,192987,395491,202504,192987,395491,Basketball
29154,2016,204185,University of Mount Union,Alliance,OH,44601,6,NCAA Division III with football,1097,1003,2100,2,"Private nonprofit, 4-year or above",2,30,27,182308,173003,355311,182308,173003,355311,Basketball
46656,2017,204185,University of Mount Union,Alliance,OH,44601,6,NCAA Division III with football,1060,974,2034,2,"Private nonprofit, 4-year or above",2,38,27,208311,172877,381188,208311,172877,381188,Basketball
64391,2018,204185,University of Mount Union,Alliance,OH,44601,6,NCAA Division III with football,1188,962,2150,2,"Private nonprofit, 4-year or above",2,30,30,203688,187814,391502,203688,187814,391502,Basketball
111163,2019,204185,University of Mount Union,Alliance,OH,44601,6,NCAA Division III with football,1024,954,1978,2,"Private nonprofit, 4-year or above",2,28,22,278792,206034,484826,278792,206034,484826,Basketball
8613,2015,181215,University of Nebraska at Kearney,Kearney,NE,688491212,4,NCAA Division II with football,1855,2505,4360,1,"Public, 4-year or above",2,13,18,429451,395615,825066,479306,440238,919544,Basketball
26044,2016,181215,University of Nebraska at Kearney,Kearney,NE,68849,4,NCAA Division II with football,1807,2410,4217,1,"Public, 4-year or above",2,13,17,530581,481179,1011760,530581,481179,1011760,Basketball
43533,2017,181215,University of Nebraska at Kearney,Kearney,NE,68849,4,NCAA Division II with football,1715,2280,3995,1,"Public, 4-year or above",2,12,14,517861,513405,1031266,517861,513405,1031266,Basketball
61251,2018,181215,University of Nebraska at Kearney,Kearney,NE,68849,4,NCAA Division II with football,1599,2289,3888,1,"Public, 4-year or above",2,14,13,514456,558857,1073313,514456,558857,1073313,Basketball
100731,2019,181215,University of Nebraska at Kearney,Kearney,NE,68849,4,NCAA Division II with football,1527,2255,3782,1,"Public, 4-year or above",2,15,15,521789,651087,1172876,506835,648759,1155594,Basketball
8644,2015,181394,University of Nebraska at Omaha,Omaha,NE,681820225,3,NCAA Division I without football,4478,5059,9537,1,"Public, 4-year or above",2,12,14,1288481,818990,2107471,1288481,818990,2107471,Basketball
26076,2016,181394,University of Nebraska at Omaha,Omaha,NE,68182,3,NCAA Division I without football,4639,5181,9820,1,"Public, 4-year or above",2,16,13,940790,770586,1711376,940790,770586,1711376,Basketball
43568,2017,181394,University of Nebraska at Omaha,Omaha,NE,68182,3,NCAA Division I without football,4573,5199,9772,1,"Public, 4-year or above",2,13,13,1244937,957449,2202386,1244937,957449,2202386,Basketball
61286,2018,181394,University of Nebraska at Omaha,Omaha,NE,68182,3,NCAA Division I without football,4514,5313,9827,1,"Public, 4-year or above",2,12,14,1262543,1086231,2348774,1262543,1086231,2348774,Basketball
100823,2019,181394,University of Nebraska at Omaha,Omaha,NE,68182,3,NCAA Division I without football,4441,5428,9869,1,"Public, 4-year or above",2,14,14,1214302,1131001,2345303,1371389,1205628,2577017,Basketball
8664,2015,181464,University of Nebraska-Lincoln,Lincoln,NE,68588,1,NCAA Division I-FBS,9905,8912,18817,1,"Public, 4-year or above",2,15,25,10441267,1798454,12239721,7329386,5673073,13002459,Basketball
26098,2016,181464,University of Nebraska-Lincoln,Lincoln,NE,68588,1,NCAA Division I-FBS,10022,9359,19381,1,"Public, 4-year or above",2,14,23,9812781,1474287,11287068,7448108,4040964,11489072,Basketball
43592,2017,181464,University of Nebraska-Lincoln,Lincoln,NE,68588,1,NCAA Division I-FBS,10175,9359,19534,1,"Public, 4-year or above",2,16,28,19340390,2712745,22053135,7771106,4094428,11865534,Basketball
61309,2018,181464,University of Nebraska-Lincoln,Lincoln,NE,68588,1,NCAA Division I-FBS,10207,9255,19462,1,"Public, 4-year or above",2,16,37,15042854,1463633,16506487,9180631,4210011,13390642,Basketball
100872,2019,181464,University of Nebraska-Lincoln,Lincoln,NE,68588,1,NCAA Division I-FBS,9941,9189,19130,1,"Public, 4-year or above",2,20,37,13517159,1501609,15018768,10930019,4534428,15464447,Basketball
8726,2015,182281,University of Nevada-Las Vegas,Las Vegas,NV,89154,1,NCAA Division I-FBS,7601,9930,17531,1,"Public, 4-year or above",2,16,13,5386263,1599428,6985691,5386263,1599428,6985691,Basketball
26163,2016,182281,University of Nevada-Las Vegas,Las Vegas,NV,89154,1,NCAA Division I-FBS,7778,10459,18237,1,"Public, 4-year or above",2,15,13,5888664,1605255,7493919,5888664,1605255,7493919,Basketball
43658,2017,182281,University of Nevada-Las Vegas,Las Vegas,NV,89154,1,NCAA Division I-FBS,8031,10831,18862,1,"Public, 4-year or above",2,15,14,5763010,1593982,7356992,5763010,1593982,7356992,Basketball
61377,2018,182281,University of Nevada-Las Vegas,Las Vegas,NV,89154,1,NCAA Division I-FBS,8021,10628,18649,1,"Public, 4-year or above",2,17,19,5795483,1789108,7584591,5795483,1789108,7584591,Basketball
101158,2019,182281,University of Nevada-Las Vegas,Las Vegas,NV,89154,1,NCAA Division I-FBS,8282,11145,19427,1,"Public, 4-year or above",2,15,29,5172024,2109736,7281760,5172024,2109736,7281760,Basketball
8738,2015,182290,University of Nevada-Reno,Reno,NV,89557,1,NCAA Division I-FBS,7000,7844,14844,1,"Public, 4-year or above",2,18,16,4530695,1431232,5961927,2288942,1431232,3720174,Basketball
26175,2016,182290,University of Nevada-Reno,Reno,NV,89557,1,NCAA Division I-FBS,7206,8184,15390,1,"Public, 4-year or above",2,16,14,5653559,1837668,7491227,3396777,1837668,5234445,Basketball
43670,2017,182290,University of Nevada-Reno,Reno,NV,89557,1,NCAA Division I-FBS,7308,8235,15543,1,"Public, 4-year or above",2,16,14,4746053,1945748,6691801,4746053,1945748,6691801,Basketball
61389,2018,182290,University of Nevada-Reno,Reno,NV,89557,1,NCAA Division I-FBS,7202,7966,15168,1,"Public, 4-year or above",2,17,13,4706010,2115279,6821289,4706010,2115279,6821289,Basketball
101196,2019,182290,University of Nevada-Reno,Reno,NV,89557,1,NCAA Division I-FBS,6936,7815,14751,1,"Public, 4-year or above",2,16,15,7601863,2272175,9874038,3897923,2276416,6174339,Basketball
5985,2015,161457,University of New England,Biddeford,ME,40059599,7,NCAA Division III without football,653,1589,2242,2,"Private nonprofit, 4-year or above",2,20,12,166303,175564,341867,147229,166312,313541,Basketball
23371,2016,161457,University of New England,Biddeford,ME,4005,7,NCAA Division III without football,639,1698,2337,2,"Private nonprofit, 4-year or above",2,17,12,158393,151030,309423,144984,143062,288046,Basketball
40873,2017,161457,University of New England,Biddeford,ME,4005,7,NCAA Division III without football,686,1639,2325,2,"Private nonprofit, 4-year or above",2,20,15,200377,182631,383008,189755,181170,370925,Basketball
58561,2018,161457,University of New England,Biddeford,ME,4005,6,NCAA Division III with football,707,1634,2341,2,"Private nonprofit, 4-year or above",2,22,15,185021,164499,349520,173022,156853,329875,Basketball
91643,2019,161457,University of New England,Biddeford,ME,4005,6,NCAA Division III with football,740,1669,2409,2,"Private nonprofit, 4-year or above",2,19,14,169676,174567,344243,168165,171859,340024,Basketball
8832,2015,183044,University of New Hampshire-Main Campus,Durham,NH,38243547,2,NCAA Division I-FCS,5749,6840,12589,1,"Public, 4-year or above",2,14,15,1534596,1376090,2910686,1534596,1376090,2910686,Basketball
26259,2016,183044,University of New Hampshire-Main Campus,Durham,NH,3824,2,NCAA Division I-FCS,5616,6799,12415,1,"Public, 4-year or above",2,15,15,1616010,1423294,3039304,1616010,1423294,3039304,Basketball
43756,2017,183044,University of New Hampshire-Main Campus,Durham,NH,3824,2,NCAA Division I-FCS,5654,6976,12630,1,"Public, 4-year or above",2,15,14,1629898,1399158,3029056,1629898,1399158,3029056,Basketball
61473,2018,183044,University of New Hampshire-Main Campus,Durham,NH,3824,2,NCAA Division I-FCS,5624,6838,12462,1,"Public, 4-year or above",2,14,13,1601005,1347430,2948435,1601005,1347430,2948435,Basketball
101450,2019,183044,University of New Hampshire-Main Campus,Durham,NH,3824,2,NCAA Division I-FCS,5256,6644,11900,1,"Public, 4-year or above",2,14,16,1614693,1367791,2982484,1614693,1367791,2982484,Basketball
2418,2015,129941,University of New Haven,West Haven,CT,65161916,4,NCAA Division II with football,2291,2320,4611,2,"Private nonprofit, 4-year or above",2,13,13,709503,603773,1313276,696733,590148,1286881,Basketball
19788,2016,129941,University of New Haven,West Haven,CT,6516,4,NCAA Division II with football,2219,2332,4551,2,"Private nonprofit, 4-year or above",2,14,14,731602,618176,1349778,708663,609623,1318286,Basketball
37227,2017,129941,University of New Haven,West Haven,CT,6516,4,NCAA Division II with football,2256,2574,4830,2,"Private nonprofit, 4-year or above",2,14,17,730612,750092,1480704,723549,733040,1456589,Basketball
54863,2018,129941,University of New Haven,West Haven,CT,6516,4,NCAA Division II with football,2172,2596,4768,2,"Private nonprofit, 4-year or above",2,13,15,710549,744515,1455064,703200,741495,1444695,Basketball
79027,2019,129941,University of New Haven,West Haven,CT,6516,4,NCAA Division II with football,2033,2592,4625,2,"Private nonprofit, 4-year or above",2,14,13,706930,714671,1421601,700041,708243,1408284,Basketball
9317,2015,187985,University of New Mexico-Main Campus,Albuquerque,NM,87106,1,NCAA Division I-FBS,7150,8702,15852,1,"Public, 4-year or above",2,16,28,5961717,2012319,7974036,3736179,2012319,5748498,Basketball
26738,2016,187985,University of New Mexico-Main Campus,Albuquerque,NM,87106,1,NCAA Division I-FBS,7090,8642,15732,1,"Public, 4-year or above",2,16,23,4130599,2370067,6500666,4130599,2370067,6500666,Basketball
44233,2017,187985,University of New Mexico-Main Campus,Albuquerque,NM,87106,1,NCAA Division I-FBS,6629,8273,14902,1,"Public, 4-year or above",2,16,24,4423352,2108089,6531441,4390791,2094963,6485754,Basketball
61955,2018,187985,University of New Mexico-Main Campus,Albuquerque,NM,87106,1,NCAA Division I-FBS,5963,7509,13472,1,"Public, 4-year or above",2,16,19,4206654,2483241,6689895,4206654,2438241,6644895,Basketball
103066,2019,187985,University of New Mexico-Main Campus,Albuquerque,NM,87106,1,NCAA Division I-FBS,5554,7006,12560,1,"Public, 4-year or above",2,17,20,4178669,2519135,6697804,4176344,2519135,6695479,Basketball
5805,2015,159939,University of New Orleans,New Orleans,LA,70148,3,NCAA Division I without football,2379,2410,4789,1,"Public, 4-year or above",2,16,15,954002,710492,1664494,954002,710492,1664494,Basketball
23189,2016,159939,University of New Orleans,New Orleans,LA,70148,3,NCAA Division I without football,2270,2374,4644,1,"Public, 4-year or above",2,17,16,983254,721162,1704416,983254,721162,1704416,Basketball
40687,2017,159939,University of New Orleans,New Orleans,LA,70148,3,NCAA Division I without football,2379,2328,4707,1,"Public, 4-year or above",2,15,16,951785,865200,1816985,951785,865200,1816985,Basketball
58373,2018,159939,University of New Orleans,New Orleans,LA,70148,3,NCAA Division I without football,2404,2383,4787,1,"Public, 4-year or above",2,13,14,1052459,847651,1900110,1052459,847651,1900110,Basketball
90968,2019,159939,University of New Orleans,New Orleans,LA,70148,3,NCAA Division I without football,2406,2449,4855,1,"Public, 4-year or above",2,15,16,1009631,877459,1887090,1009631,877459,1887090,Basketball
210,2015,101879,University of North Alabama,Florence,AL,356320001,4,NCAA Division II with football,2079,2894,4973,1,"Public, 4-year or above",2,14,15,475790,416613,892403,475790,416613,892403,Basketball
17557,2016,101879,University of North Alabama,Florence,AL,35632,4,NCAA Division II with football,2100,3043,5143,1,"Public, 4-year or above",2,15,14,528229,439637,967866,528229,439637,967866,Basketball
34967,2017,101879,University of North Alabama,Florence,AL,35632,4,NCAA Division II with football,2059,3061,5120,1,"Public, 4-year or above",2,16,14,829018,570697,1399715,829017,570697,1399714,Basketball
52597,2018,101879,University of North Alabama,Florence,AL,35632,2,NCAA Division I-FCS,1953,3061,5014,1,"Public, 4-year or above",2,13,13,1159508,947406,2106914,1159508,947406,2106914,Basketball
71124,2019,101879,University of North Alabama,Florence,AL,35630,2,NCAA Division I-FCS,1802,3037,4839,1,"Public, 4-year or above",2,13,12,1219139,905317,2124456,1219144,905317,2124461,Basketball
11069,2015,199111,University of North Carolina at Asheville,Asheville,NC,288048510,3,NCAA Division I without football,1409,1782,3191,1,"Public, 4-year or above",2,14,18,934569,858820,1793389,934569,858820,1793389,Basketball
28508,2016,199111,University of North Carolina at Asheville,Asheville,NC,28804,3,NCAA Division I without football,1298,1829,3127,1,"Public, 4-year or above",2,16,19,1108175,984327,2092502,1108175,984327,2092502,Basketball
46001,2017,199111,University of North Carolina at Asheville,Asheville,NC,28804,3,NCAA Division I without football,1356,1845,3201,1,"Public, 4-year or above",2,14,19,1305922,1042034,2347956,1305922,1042034,2347956,Basketball
63721,2018,199111,University of North Carolina at Asheville,Asheville,NC,28804,3,NCAA Division I without football,1315,1854,3169,1,"Public, 4-year or above",2,16,19,1183573,1108615,2292188,1183573,1108615,2292188,Basketball
108728,2019,199111,University of North Carolina at Asheville,Asheville,NC,28804,3,NCAA Division I without football,1247,1743,2990,1,"Public, 4-year or above",2,14,19,1241395,1070622,2312017,1241395,1070622,2312017,Basketball
11076,2015,199120,University of North Carolina at Chapel Hill,Chapel Hill,NC,27599,1,NCAA Division I-FBS,7295,10311,17606,1,"Public, 4-year or above",2,20,13,21342328,496787,21839115,8667111,3279794,11946905,Basketball
28516,2016,199120,University of North Carolina at Chapel Hill,Chapel Hill,NC,27599,1,NCAA Division I-FBS,7361,10467,17828,1,"Public, 4-year or above",2,18,39,21408475,479649,21888124,10293415,3418621,13712036,Basketball
46009,2017,199120,University of North Carolina at Chapel Hill,Chapel Hill,NC,27599,1,NCAA Division I-FBS,7464,10811,18275,1,"Public, 4-year or above",2,19,39,24660258,694589,25354847,9728533,3579947,13308480,Basketball
63729,2018,199120,University of North Carolina at Chapel Hill,Chapel Hill,NC,27599,1,NCAA Division I-FBS,7462,11049,18511,1,"Public, 4-year or above",2,37,18,27076307,818663,27894970,11204115,4628719,15832834,Basketball
108766,2019,199120,University of North Carolina at Chapel Hill,Chapel Hill,NC,27599,1,NCAA Division I-FBS,7425,11091,18516,1,"Public, 4-year or above",2,33,30,26230915,925571,27156486,9156512,3867351,13023863,Basketball
11092,2015,199139,University of North Carolina at Charlotte,Charlotte,NC,282230001,1,NCAA Division I-FBS,10413,9332,19745,1,"Public, 4-year or above",2,16,18,3280507,1880267,5160774,3280507,1880267,5160774,Basketball
28532,2016,199139,University of North Carolina at Charlotte,Charlotte,NC,28223,1,NCAA Division I-FBS,10733,9524,20257,1,"Public, 4-year or above",2,16,17,2771813,1791757,4563570,2771813,1791757,4563570,Basketball
46025,2017,199139,University of North Carolina at Charlotte,Charlotte,NC,28223,1,NCAA Division I-FBS,11060,9532,20592,1,"Public, 4-year or above",2,13,21,2718767,1934069,4652836,2718767,1934069,4652836,Basketball
63745,2018,199139,University of North Carolina at Charlotte,Charlotte,NC,28223,1,NCAA Division I-FBS,11236,9692,20928,1,"Public, 4-year or above",2,14,13,3295523,2117951,5413474,3295523,2117951,5413474,Basketball
108804,2019,199139,University of North Carolina at Charlotte,Charlotte,NC,28223,1,NCAA Division I-FBS,11117,9685,20802,1,"Public, 4-year or above",2,15,18,3685899,1965176,5651075,3685899,1965176,5651075,Basketball
11101,2015,199148,University of North Carolina at Greensboro,Greensboro,NC,274026170,3,NCAA Division I without football,4567,8719,13286,1,"Public, 4-year or above",2,17,17,1506556,1163720,2670276,1506556,1163718,2670274,Basketball
28541,2016,199148,University of North Carolina at Greensboro,Greensboro,NC,27402,3,NCAA Division I without football,4789,9115,13904,1,"Public, 4-year or above",2,18,18,1567728,1307260,2874988,1567728,1307261,2874989,Basketball
46034,2017,199148,University of North Carolina at Greensboro,Greensboro,NC,27402,3,NCAA Division I without football,4792,9190,13982,1,"Public, 4-year or above",2,18,14,1756768,1303726,3060494,1756758,1303726,3060484,Basketball
63754,2018,199148,University of North Carolina at Greensboro,Greensboro,NC,27402,3,NCAA Division I without football,4797,9334,14131,1,"Public, 4-year or above",2,17,16,2275162,1374981,3650143,2275162,1374981,3650143,Basketball
108842,2019,199148,University of North Carolina at Greensboro,Greensboro,NC,27402,3,NCAA Division I without football,4633,9242,13875,1,"Public, 4-year or above",2,17,16,2482153,1304433,3786586,2355335,1296956,3652291,Basketball
11157,2015,199281,University of North Carolina at Pembroke,Pembroke,NC,283721510,4,NCAA Division II with football,1894,2645,4539,1,"Public, 4-year or above",2,19,14,411075,283585,694660,369002,253659,622661,Basketball
28597,2016,199281,University of North Carolina at Pembroke,Pembroke,NC,28372,4,NCAA Division II with football,1844,2634,4478,1,"Public, 4-year or above",2,14,14,452302,323525,775827,395373,291440,686813,Basketball
46093,2017,199281,University of North Carolina at Pembroke,Pembroke,NC,28372,4,NCAA Division II with football,1845,2615,4460,1,"Public, 4-year or above",2,16,16,480309,316560,796869,427051,291807,718858,Basketball
63814,2018,199281,University of North Carolina at Pembroke,Pembroke,NC,28372,4,NCAA Division II with football,1966,2961,4927,1,"Public, 4-year or above",2,16,15,370244,316119,686363,346136,289679,635815,Basketball
108987,2019,199281,University of North Carolina at Pembroke,Pembroke,NC,28372,4,NCAA Division II with football,2031,3066,5097,1,"Public, 4-year or above",2,15,15,391482,303281,694763,390844,275173,666017,Basketball
11139,2015,199218,University of North Carolina Wilmington,Wilmington,NC,284035963,3,NCAA Division I without football,4602,6981,11583,1,"Public, 4-year or above",2,17,12,2257718,1321114,3578832,2257718,1321114,3578832,Basketball
28579,2016,199218,University of North Carolina Wilmington,Wilmington,NC,28403,3,NCAA Division I without football,4791,7122,11913,1,"Public, 4-year or above",2,15,17,2981003,1431498,4412501,2981003,1431498,4412501,Basketball
46073,2017,199218,University of North Carolina Wilmington,Wilmington,NC,28403,3,NCAA Division I without football,4907,7326,12233,1,"Public, 4-year or above",2,14,18,2121315,1528765,3650080,2121315,1528765,3650080,Basketball
63793,2018,199218,University of North Carolina Wilmington,Wilmington,NC,28403,3,NCAA Division I without football,4800,7190,11990,1,"Public, 4-year or above",2,16,17,2317837,1519557,3837394,2317837,1519557,3837394,Basketball
108937,2019,199218,University of North Carolina Wilmington,Wilmington,NC,28403,3,NCAA Division I without football,4785,7498,12283,1,"Public, 4-year or above",2,13,17,2983319,1352739,4336058,2983319,1352739,4336058,Basketball
11346,2015,200280,University of North Dakota,Grand Forks,ND,582028193,2,NCAA Division I-FCS,4902,4159,9061,1,"Public, 4-year or above",2,15,19,1579108,1593549,3172657,1579108,1593549,3172657,Basketball
28784,2016,200280,University of North Dakota,Grand Forks,ND,58202,2,NCAA Division I-FCS,4729,4058,8787,1,"Public, 4-year or above",2,15,19,1645344,1602482,3247826,1645344,1602482,3247826,Basketball
46287,2017,200280,University of North Dakota,Grand Forks,ND,58202,2,NCAA Division I-FCS,4516,3984,8500,1,"Public, 4-year or above",2,15,21,1824580,1787444,3612024,1824580,1787444,3612024,Basketball
64007,2018,200280,University of North Dakota,Grand Forks,ND,58202,2,NCAA Division I-FCS,4357,3804,8161,1,"Public, 4-year or above",2,18,22,1943907,1860378,3804285,1943907,1860378,3804285,Basketball
109765,2019,200280,University of North Dakota,Grand Forks,ND,58202,2,NCAA Division I-FCS,4117,3492,7609,1,"Public, 4-year or above",2,15,24,2030890,1874642,3905532,2030890,1874642,3905532,Basketball
2940,2015,136172,University of North Florida,Jacksonville,FL,322247699,3,NCAA Division I without football,4231,5238,9469,1,"Public, 4-year or above",2,14,17,1538518,1150206,2688724,1538518,1150206,2688724,Basketball
20314,2016,136172,University of North Florida,Jacksonville,FL,32224,3,NCAA Division I without football,4213,5416,9629,1,"Public, 4-year or above",2,15,19,1456345,1114078,2570423,1456345,1114078,2570423,Basketball
37763,2017,136172,University of North Florida,Jacksonville,FL,32224,3,NCAA Division I without football,4428,5719,10147,1,"Public, 4-year or above",2,12,12,1420651,1080211,2500862,1420651,1080211,2500862,Basketball
55413,2018,136172,University of North Florida,Jacksonville,FL,32224,3,NCAA Division I without football,4546,5841,10387,1,"Public, 4-year or above",2,14,15,1532649,1235739,2768388,1532649,1235739,2768388,Basketball
80756,2019,136172,University of North Florida,Jacksonville,FL,32224,3,NCAA Division I without football,4593,6096,10689,1,"Public, 4-year or above",2,14,13,1554410,1148429,2702839,1554410,1148429,2702839,Basketball
17278,2015,482680,University of North Georgia,Dahlonega,GA,30597,5,NCAA Division II without football,5242,6358,11600,1,"Public, 4-year or above",2,17,13,536509,428403,964912,470443,393717,864160,Basketball
34686,2016,482680,University of North Georgia,Dahlonega,GA,30597,5,NCAA Division II without football,5580,6769,12349,1,"Public, 4-year or above",2,14,15,524958,429609,954567,465524,422459,887983,Basketball
52301,2017,482680,University of North Georgia,Dahlonega,GA,30597,5,NCAA Division II without football,5525,6905,12430,1,"Public, 4-year or above",2,14,16,574925,483010,1057935,497571,456109,953680,Basketball
70067,2018,482680,University of North Georgia,Dahlonega,GA,30597,5,NCAA Division II without football,5676,7266,12942,1,"Public, 4-year or above",2,17,12,570582,498609,1069191,570582,498609,1069191,Basketball
131984,2019,482680,University of North Georgia,Dahlonega,GA,30597,5,NCAA Division II without football,5633,7171,12804,1,"Public, 4-year or above",2,15,13,496818,416345,913163,509209,494853,1004062,Basketball
14957,2015,227216,University of North Texas,Denton,TX,762031277,1,NCAA Division I-FBS,11765,13153,24918,1,"Public, 4-year or above",2,15,15,2807582,2286173,5093755,2433472,1816619,4250091,Basketball
32427,2016,227216,University of North Texas,Denton,TX,76203,1,NCAA Division I-FBS,11990,13496,25486,1,"Public, 4-year or above",2,15,15,3281375,1809049,5090424,3281375,1809049,5090424,Basketball
49954,2017,227216,University of North Texas,Denton,TX,76203,1,NCAA Division I-FBS,12055,13537,25592,1,"Public, 4-year or above",2,17,26,3276255,1740546,5016801,3276255,1740546,5016801,Basketball
67733,2018,227216,University of North Texas,Denton,TX,76203,1,NCAA Division I-FBS,11888,13506,25394,1,"Public, 4-year or above",2,15,22,2847662,1819974,4667636,2847662,1819974,4667636,Basketball
123003,2019,227216,University of North Texas,Denton,TX,76203,1,NCAA Division I-FBS,12112,13943,26055,1,"Public, 4-year or above",2,15,15,3029265,1708827,4738092,3029265,1708827,4738092,Basketball
2273,2015,127741,University of Northern Colorado,Greeley,CO,80639,2,NCAA Division I-FCS,3032,5087,8119,1,"Public, 4-year or above",2,17,14,1490726,1103670,2594396,1490726,1103669,2594395,Basketball
19643,2016,127741,University of Northern Colorado,Greeley,CO,80639,2,NCAA Division I-FCS,3021,5221,8242,1,"Public, 4-year or above",2,17,13,1606319,1184302,2790621,1606319,1184302,2790621,Basketball
37082,2017,127741,University of Northern Colorado,Greeley,CO,80639,2,NCAA Division I-FCS,2915,5332,8247,1,"Public, 4-year or above",2,15,16,1701421,1110191,2811612,1701421,1110191,2811612,Basketball
54718,2018,127741,University of Northern Colorado,Greeley,CO,80639,2,NCAA Division I-FCS,2851,5133,7984,1,"Public, 4-year or above",2,15,20,1538837,1251349,2790186,1538837,1251349,2790186,Basketball
78619,2019,127741,University of Northern Colorado,Greeley,CO,80639,2,NCAA Division I-FCS,2623,5053,7676,1,"Public, 4-year or above",2,15,15,1507119,1220086,2727205,1507119,1220086,2727205,Basketball
4986,2015,154095,University of Northern Iowa,Cedar Falls,IA,506140005,2,NCAA Division I-FCS,3819,5254,9073,1,"Public, 4-year or above",2,15,26,2899699,1163525,4063224,2899699,1163525,4063224,Basketball
22342,2016,154095,University of Northern Iowa,Cedar Falls,IA,50614,2,NCAA Division I-FCS,3856,5263,9119,1,"Public, 4-year or above",2,16,23,2856369,1128187,3984556,2856369,1128187,3984556,Basketball
39818,2017,154095,University of Northern Iowa,Cedar Falls,IA,50614,2,NCAA Division I-FCS,3779,5176,8955,1,"Public, 4-year or above",2,18,26,3024333,1198739,4223072,3024333,1198739,4223072,Basketball
57486,2018,154095,University of Northern Iowa,Cedar Falls,IA,50614,2,NCAA Division I-FCS,3551,5166,8717,1,"Public, 4-year or above",2,16,25,3550793,1231707,4782500,3550793,1231707,4782500,Basketball
88227,2019,154095,University of Northern Iowa,Cedar Falls,IA,50614,2,NCAA Division I-FCS,3336,4880,8216,1,"Public, 4-year or above",2,18,29,3258224,1235551,4493775,3258224,1235551,4493775,Basketball
7718,2015,174491,University of Northwestern-St Paul,Saint Paul,MN,551131598,6,NCAA Division III with football,713,971,1684,2,"Private nonprofit, 4-year or above",2,22,17,70207,68250,138457,66703,66150,132853,Basketball
25134,2016,174491,University of Northwestern-St Paul,Saint Paul,MN,55113,6,NCAA Division III with football,666,947,1613,2,"Private nonprofit, 4-year or above",2,24,17,80896,75924,156820,77365,73564,150929,Basketball
42630,2017,174491,University of Northwestern-St Paul,Saint Paul,MN,55113,6,NCAA Division III with football,672,911,1583,2,"Private nonprofit, 4-year or above",2,21,17,89119,77138,166257,85981,74745,160726,Basketball
60337,2018,174491,University of Northwestern-St Paul,Saint Paul,MN,55113,6,NCAA Division III with football,644,946,1590,2,"Private nonprofit, 4-year or above",2,23,17,89412,82980,172392,85842,80889,166731,Basketball
97111,2019,174491,University of Northwestern-St Paul,Saint Paul,MN,55113,6,NCAA Division III with football,673,930,1603,2,"Private nonprofit, 4-year or above",2,20,13,85002,80353,165355,81498,78253,159751,Basketball
4575,2015,152080,University of Notre Dame,Notre Dame,IN,46556,1,NCAA Division I-FBS,4386,4027,8413,2,"Private nonprofit, 4-year or above",2,14,13,3358680,1430198,4788878,6816663,5759103,12575766,Basketball
21950,2016,152080,University of Notre Dame,Notre Dame,IN,46556,1,NCAA Division I-FBS,4472,4008,8480,2,"Private nonprofit, 4-year or above",2,14,11,3896784,1473148,5369932,6793853,5996845,12790698,Basketball
39429,2017,152080,University of Notre Dame,Notre Dame,IN,46556,1,NCAA Division I-FBS,4467,4042,8509,2,"Private nonprofit, 4-year or above",2,13,13,3577881,1736921,5314802,6876483,6738371,13614854,Basketball
57090,2018,152080,University of Notre Dame,Notre Dame,IN,46556,1,NCAA Division I-FBS,4477,4081,8558,2,"Private nonprofit, 4-year or above",2,13,14,4153208,2017752,6170960,8331273,7632092,15963365,Basketball
86914,2019,152080,University of Notre Dame,Notre Dame,IN,46556,1,NCAA Division I-FBS,4509,4156,8665,2,"Private nonprofit, 4-year or above",2,12,13,3926701,1371293,5297994,8627166,6344618,14971784,Basketball
12188,2015,207500,University of Oklahoma-Norman Campus,Norman,OK,730193072,1,NCAA Division I-FBS,9029,8864,17893,1,"Public, 4-year or above",2,15,19,12030130,2084098,14114228,10582714,6239607,16822321,Basketball
29628,2016,207500,University of Oklahoma-Norman Campus,Norman,OK,73019,1,NCAA Division I-FBS,9219,8999,18218,1,"Public, 4-year or above",2,16,25,13190742,3703885,16894627,9201538,6372082,15573620,Basketball
47133,2017,207500,University of Oklahoma-Norman Campus,Norman,OK,73019,1,NCAA Division I-FBS,9455,9397,18852,1,"Public, 4-year or above",2,15,19,13473566,3251438,16725004,10205245,6221340,16426585,Basketball
64878,2018,207500,University of Oklahoma-Norman Campus,Norman,OK,73019,1,NCAA Division I-FBS,9248,9608,18856,1,"Public, 4-year or above",2,16,26,12355263,2854726,15209989,10072404,6403803,16476207,Basketball
112805,2019,207500,University of Oklahoma-Norman Campus,Norman,OK,73019,1,NCAA Division I-FBS,9170,9650,18820,1,"Public, 4-year or above",2,15,22,8477462,2064744,10542206,9669952,6393611,16063563,Basketball
12398,2015,209551,University of Oregon,Eugene,OR,97403,1,NCAA Division I-FBS,8696,9908,18604,1,"Public, 4-year or above",2,15,22,8955456,571185,9526641,7785909,3244275,11030184,Basketball
29845,2016,209551,University of Oregon,Eugene,OR,97403,1,NCAA Division I-FBS,8472,9837,18309,1,"Public, 4-year or above",2,18,23,11149777,732760,11882537,9229004,3831372,13060376,Basketball
47339,2017,209551,University of Oregon,Eugene,OR,97403,1,NCAA Division I-FBS,8221,9567,17788,1,"Public, 4-year or above",2,13,24,11384188,1254031,12638219,9287092,4299073,13586165,Basketball
65085,2018,209551,University of Oregon,Eugene,OR,97403,1,NCAA Division I-FBS,8054,9486,17540,1,"Public, 4-year or above",2,13,21,10918131,1858179,12776310,10348633,4563669,14912302,Basketball
113707,2019,209551,University of Oregon,Eugene,OR,97403,1,NCAA Division I-FBS,7938,9475,17413,1,"Public, 4-year or above",2,18,25,10518656,2263973,12782629,10232394,4742211,14974605,Basketball
13370,2015,215062,University of Pennsylvania,Philadelphia,PA,191046303,2,NCAA Division I-FCS,4946,5273,10219,2,"Private nonprofit, 4-year or above",2,16,15,1546923,928975,2475898,1546923,928975,2475898,Basketball
30829,2016,215062,University of Pennsylvania,Philadelphia,PA,19104,2,NCAA Division I-FCS,4933,5298,10231,2,"Private nonprofit, 4-year or above",2,19,17,1798822,969486,2768308,1798822,969486,2768308,Basketball
48337,2017,215062,University of Pennsylvania,Philadelphia,PA,19104,2,NCAA Division I-FCS,4908,5354,10262,2,"Private nonprofit, 4-year or above",2,21,17,2129321,960434,3089755,2129321,960434,3089755,Basketball
66089,2018,215062,University of Pennsylvania,Philadelphia,PA,19104,2,NCAA Division I-FCS,4857,5499,10356,2,"Private nonprofit, 4-year or above",2,20,18,2049825,1158008,3207833,2049825,1158008,3207833,Basketball
116931,2019,215062,University of Pennsylvania,Philadelphia,PA,19104,2,NCAA Division I-FCS,4741,5454,10195,2,"Private nonprofit, 4-year or above",2,17,19,1948109,1054406,3002515,1948109,1054406,3002515,Basketball
13418,2015,215266,University of Pittsburgh-Bradford,Bradford,PA,16701,7,NCAA Division III without football,614,714,1328,1,"Public, 4-year or above",2,16,12,103131,96143,199274,95777,94873,190650,Basketball
30876,2016,215266,University of Pittsburgh-Bradford,Bradford,PA,16701,7,NCAA Division III without football,632,714,1346,1,"Public, 4-year or above",2,15,11,76385,91971,168356,76385,91971,168356,Basketball
48385,2017,215266,University of Pittsburgh-Bradford,Bradford,PA,16701,7,NCAA Division III without football,560,665,1225,1,"Public, 4-year or above",2,18,10,151311,153790,305101,151311,153790,305101,Basketball
66126,2018,215266,University of Pittsburgh-Bradford,Bradford,PA,16701,7,NCAA Division III without football,538,658,1196,1,"Public, 4-year or above",2,11,10,143297,149699,292996,143297,149699,292996,Basketball
117083,2019,215266,University of Pittsburgh-Bradford,Bradford,PA,16701,7,NCAA Division III without football,546,702,1248,1,"Public, 4-year or above",2,15,13,163126,115231,278357,163126,115231,278357,Basketball
13428,2015,215275,University of Pittsburgh-Greensburg,Greensburg,PA,156015860,7,NCAA Division III without football,706,762,1468,1,"Public, 4-year or above",2,15,11,76720,66001,142721,73940,61243,135183,Basketball
30885,2016,215275,University of Pittsburgh-Greensburg,Greensburg,PA,15601,7,NCAA Division III without football,687,748,1435,1,"Public, 4-year or above",2,15,9,70788,57719,128507,68663,54789,123452,Basketball
48394,2017,215275,University of Pittsburgh-Greensburg,Greensburg,PA,15601,7,NCAA Division III without football,660,774,1434,1,"Public, 4-year or above",2,14,8,72168,78241,150409,71393,68419,139812,Basketball
66136,2018,215275,University of Pittsburgh-Greensburg,Greensburg,PA,15601,7,NCAA Division III without football,639,785,1424,1,"Public, 4-year or above",2,15,9,65614,78545,144159,64059,66435,130494,Basketball
117121,2019,215275,University of Pittsburgh-Greensburg,Greensburg,PA,15601,7,NCAA Division III without football,597,758,1355,1,"Public, 4-year or above",2,17,14,79793,100370,180163,79593,90142,169735,Basketball
13436,2015,215284,University of Pittsburgh-Johnstown,Johnstown,PA,15904,5,NCAA Division II without football,1511,1232,2743,1,"Public, 4-year or above",2,15,13,337788,319679,657467,337788,319679,657467,Basketball
30893,2016,215284,University of Pittsburgh-Johnstown,Johnstown,PA,15904,5,NCAA Division II without football,1521,1185,2706,1,"Public, 4-year or above",2,14,13,326239,292497,618736,326239,292497,618736,Basketball
48402,2017,215284,University of Pittsburgh-Johnstown,Johnstown,PA,15904,5,NCAA Division II without football,1503,1208,2711,1,"Public, 4-year or above",2,12,15,364358,330367,694725,364358,330367,694725,Basketball
66144,2018,215284,University of Pittsburgh-Johnstown,Johnstown,PA,15904,5,NCAA Division II without football,1422,1118,2540,1,"Public, 4-year or above",2,16,13,375898,318187,694085,375898,318187,694085,Basketball
117159,2019,215284,University of Pittsburgh-Johnstown,Johnstown,PA,15904,5,NCAA Division II without football,1340,1060,2400,1,"Public, 4-year or above",2,13,13,514450,327732,842182,514450,327732,842182,Basketball
13444,2015,215293,University of Pittsburgh-Pittsburgh Campus,Pittsburgh,PA,15260,1,NCAA Division I-FBS,8734,9081,17815,1,"Public, 4-year or above",2,16,18,15794627,2662952,18457579,8799110,4184889,12983999,Basketball
30901,2016,215293,University of Pittsburgh-Pittsburgh Campus,Pittsburgh,PA,15260,1,NCAA Division I-FBS,8716,9413,18129,1,"Public, 4-year or above",2,14,19,12994273,3815579,16809852,9565259,4341694,13906953,Basketball
48410,2017,215293,University of Pittsburgh-Pittsburgh Campus,Pittsburgh,PA,15260,1,NCAA Division I-FBS,8877,9475,18352,1,"Public, 4-year or above",2,16,23,12102078,4848904,16950982,12102078,4848904,16950982,Basketball
66152,2018,215293,University of Pittsburgh-Pittsburgh Campus,Pittsburgh,PA,15260,1,NCAA Division I-FBS,8732,9659,18391,1,"Public, 4-year or above",2,17,27,13220336,5945873,19166209,11013283,5945873,16959156,Basketball
117197,2019,215293,University of Pittsburgh-Pittsburgh Campus,Pittsburgh,PA,15260,1,NCAA Division I-FBS,8458,9852,18310,1,"Public, 4-year or above",2,17,26,10821278,3807120,14628398,10023053,3807120,13830173,Basketball
12435,2015,209825,University of Portland,Portland,OR,972035798,3,NCAA Division I without football,1522,2176,3698,2,"Private nonprofit, 4-year or above",2,14,12,3570559,1388330,4958889,3570559,1388330,4958889,Basketball
29882,2016,209825,University of Portland,Portland,OR,97203,3,NCAA Division I without football,1497,2211,3708,2,"Private nonprofit, 4-year or above",2,15,13,3184946,1447880,4632826,3184946,1447880,4632826,Basketball
47376,2017,209825,University of Portland,Portland,OR,97203,3,NCAA Division I without football,1518,2274,3792,2,"Private nonprofit, 4-year or above",2,15,14,2977505,1656699,4634204,2977505,1656699,4634204,Basketball
65122,2018,209825,University of Portland,Portland,OR,97203,3,NCAA Division I without football,1467,2235,3702,2,"Private nonprofit, 4-year or above",2,16,23,3599607,1941079,5540686,3599607,1941079,5540686,Basketball
113859,2019,209825,University of Portland,Portland,OR,97203,3,NCAA Division I without football,1461,2282,3743,2,"Private nonprofit, 4-year or above",2,15,15,3125380,1895642,5021022,3125380,1895642,5021022,Basketball
16894,2015,243133,University of Puerto Rico-Bayamon,Bayamon,PR,959,5,NCAA Division II without football,2047,2237,4284,1,"Public, 4-year or above",2,14,19,129529,155472,285001,129529,155472,285001,Basketball
34372,2016,243133,University of Puerto Rico-Bayamon,Bayamon,PR,959,5,NCAA Division II without football,2096,2186,4282,1,"Public, 4-year or above",2,19,18,94347,108157,202504,94347,108157,202504,Basketball
51917,2017,243133,University of Puerto Rico-Bayamon,Bayamon,PR,959,5,NCAA Division II without football,1956,1963,3919,1,"Public, 4-year or above",2,22,17,67971,80864,148835,67971,80864,148835,Basketball
69669,2018,243133,University of Puerto Rico-Bayamon,Bayamon,PR,959,4,NCAA Division II with football,1793,1850,3643,1,"Public, 4-year or above",2,15,15,72537,108081,180618,72537,108081,180618,Basketball
129964,2019,243133,University of Puerto Rico-Bayamon,Bayamon,PR,959,5,NCAA Division II without football,1709,1735,3444,1,"Public, 4-year or above",2,15,15,63048,72525,135573,63048,72525,135573,Basketball
16946,2015,243197,University of Puerto Rico-Mayaguez,Mayaguez,PR,681,5,NCAA Division II without football,5867,4985,10852,1,"Public, 4-year or above",2,15,15,27400,27400,54800,27400,27400,54800,Basketball
51960,2017,243197,University of Puerto Rico-Mayaguez,Mayaguez,PR,681,5,NCAA Division II without football,6127,5317,11444,1,"Public, 4-year or above",2,15,15,38320,34835,73155,38320,34835,73155,Basketball
69710,2018,243197,University of Puerto Rico-Mayaguez,Mayaguez,PR,681,5,NCAA Division II without football,6065,5242,11307,1,"Public, 4-year or above",2,15,15,77242,88236,165478,77242,88236,165478,Basketball
130094,2019,243197,University of Puerto Rico-Mayaguez,Mayaguez,PR,681,5,NCAA Division II without football,5975,5166,11141,1,"Public, 4-year or above",2,18,15,68615,93544,162159,68615,93544,162159,Basketball
16961,2015,243221,University of Puerto Rico-Rio Piedras,San Juan,PR,9310000,5,NCAA Division II without football,4295,7075,11370,1,"Public, 4-year or above",2,23,20,88449,76730,165179,88449,76730,165179,Basketball
51972,2017,243221,University of Puerto Rico-Rio Piedras,San Juan,PR,9252526,5,NCAA Division II without football,3935,6581,10516,1,"Public, 4-year or above",2,18,15,51815,47093,98908,51815,47093,98908,Basketball
69727,2018,243221,University of Puerto Rico-Rio Piedras,San Juan,PR,9252526,5,NCAA Division II without football,3810,6365,10175,1,"Public, 4-year or above",2,20,14,58278,60797,119075,58278,60797,119075,Basketball
130135,2019,243221,University of Puerto Rico-Rio Piedras,San Juan,PR,9252526,5,NCAA Division II without football,3623,6259,9882,1,"Public, 4-year or above",2,15,16,50419,53533,103952,50419,53533,103952,Basketball
16097,2015,236328,University of Puget Sound,Tacoma,WA,98416,6,NCAA Division III with football,1011,1448,2459,2,"Private nonprofit, 4-year or above",2,18,15,159022,152684,311706,159022,152684,311706,Basketball
33571,2016,236328,University of Puget Sound,Tacoma,WA,98416,6,NCAA Division III with football,999,1488,2487,2,"Private nonprofit, 4-year or above",2,19,18,172513,175691,348204,172513,175691,348204,Basketball
51126,2017,236328,University of Puget Sound,Tacoma,WA,98416,6,NCAA Division III with football,951,1439,2390,2,"Private nonprofit, 4-year or above",2,19,13,184564,159408,343972,184564,159408,343972,Basketball
68873,2018,236328,University of Puget Sound,Tacoma,WA,98416,6,NCAA Division III with football,940,1408,2348,2,"Private nonprofit, 4-year or above",2,17,16,243580,188069,431649,243580,188069,431649,Basketball
127241,2019,236328,University of Puget Sound,Tacoma,WA,98416,6,NCAA Division III with football,923,1348,2271,2,"Private nonprofit, 4-year or above",2,20,14,181664,165975,347639,181664,165975,347639,Basketball
1714,2015,121691,University of Redlands,Redlands,CA,923730999,6,NCAA Division III with football,1133,1565,2698,2,"Private nonprofit, 4-year or above",2,17,16,183127,140654,323781,209235,133903,343138,Basketball
19077,2016,121691,University of Redlands,Redlands,CA,92373,6,NCAA Division III with football,1044,1447,2491,2,"Private nonprofit, 4-year or above",2,18,15,176780,177626,354406,164006,175484,339490,Basketball
36512,2017,121691,University of Redlands,Redlands,CA,92373,6,NCAA Division III with football,1037,1473,2510,2,"Private nonprofit, 4-year or above",2,18,18,184457,152974,337431,161614,146101,307715,Basketball
54143,2018,121691,University of Redlands,Redlands,CA,92373,6,NCAA Division III with football,1013,1483,2496,2,"Private nonprofit, 4-year or above",2,14,16,202161,187721,389882,198872,182579,381451,Basketball
76618,2019,121691,University of Redlands,Redlands,CA,92373,6,NCAA Division III with football,1046,1596,2642,2,"Private nonprofit, 4-year or above",2,16,13,228506,180873,409379,279660,187024,466684,Basketball
13852,2015,217484,University of Rhode Island,Kingston,RI,2881,2,NCAA Division I-FCS,5570,6643,12213,1,"Public, 4-year or above",2,14,15,4286329,2312238,6598567,4286329,2312958,6599287,Basketball
31306,2016,217484,University of Rhode Island,Kingston,RI,2881,2,NCAA Division I-FCS,5535,6887,12422,1,"Public, 4-year or above",2,15,15,4832740,2253570,7086310,4713547,2253570,6967117,Basketball
48817,2017,217484,University of Rhode Island,Kingston,RI,2881,2,NCAA Division I-FCS,5588,7004,12592,1,"Public, 4-year or above",2,15,16,5459313,2363278,7822591,5459313,2363278,7822591,Basketball
66571,2018,217484,University of Rhode Island,Kingston,RI,2881,2,NCAA Division I-FCS,5528,6907,12435,1,"Public, 4-year or above",2,14,18,4799098,2710476,7509574,4745208,2710477,7455685,Basketball
118243,2019,217484,University of Rhode Island,Kingston,RI,2881,2,NCAA Division I-FCS,5600,6959,12559,1,"Public, 4-year or above",2,14,15,4488258,2047635,6535893,4345286,2152591,6497877,Basketball
15828,2015,233374,University of Richmond,University of Richmond,VA,23173,2,NCAA Division I-FCS,1397,1566,2963,2,"Private nonprofit, 4-year or above",2,15,13,4849596,2103629,6953225,4849596,2103629,6953225,Basketball
33302,2016,233374,University of Richmond,University of Richmond,VA,23173,2,NCAA Division I-FCS,1437,1561,2998,2,"Private nonprofit, 4-year or above",2,16,15,4878508,2149113,7027621,4878508,2149113,7027621,Basketball
50850,2017,233374,University of Richmond,University of Richmond,VA,23173,2,NCAA Division I-FCS,1401,1559,2960,2,"Private nonprofit, 4-year or above",2,17,13,4746842,2074604,6821446,4746842,2074604,6821446,Basketball
68598,2018,233374,University of Richmond,University of Richmond,VA,23173,2,NCAA Division I-FCS,1437,1544,2981,2,"Private nonprofit, 4-year or above",2,16,15,4782542,2532669,7315211,4782542,2532669,7315211,Basketball
126081,2019,233374,University of Richmond,University of Richmond,VA,23173,2,NCAA Division I-FCS,1424,1513,2937,2,"Private nonprofit, 4-year or above",2,15,17,4897831,2590373,7488204,4897831,2590373,7488204,Basketball
10212,2015,195030,University of Rochester,Rochester,NY,146270011,6,NCAA Division III with football,3065,2948,6013,2,"Private nonprofit, 4-year or above",2,18,19,267827,323328,591155,267827,323328,591155,Basketball
27634,2016,195030,University of Rochester,Rochester,NY,14627,6,NCAA Division III with football,3115,3023,6138,2,"Private nonprofit, 4-year or above",2,17,18,318913,253478,572391,318913,253478,572391,Basketball
45122,2017,195030,University of Rochester,Rochester,NY,14627,6,NCAA Division III with football,3191,3036,6227,2,"Private nonprofit, 4-year or above",2,16,20,349996,277015,627011,349996,277015,627011,Basketball
62829,2018,195030,University of Rochester,Rochester,NY,14627,6,NCAA Division III with football,3194,3070,6264,2,"Private nonprofit, 4-year or above",2,15,17,298274,270670,568944,298274,270670,568944,Basketball
105972,2019,195030,University of Rochester,Rochester,NY,14627,6,NCAA Division III with football,3198,3173,6371,2,"Private nonprofit, 4-year or above",2,17,18,282217,320737,602954,282217,320737,602954,Basketball
2469,2015,130314,University of Saint Joseph,West Hartford,CT,6117,7,NCAA Division III without football,10,757,767,2,"Private nonprofit, 4-year or above",2,0,9,NA,44503,44503,NA,44503,44503,Basketball
19839,2016,130314,University of Saint Joseph,West Hartford,CT,6117,7,NCAA Division III without football,6,717,723,2,"Private nonprofit, 4-year or above",2,0,8,NA,52600,52600,NA,52600,52600,Basketball
37278,2017,130314,University of Saint Joseph,West Hartford,CT,6117,7,NCAA Division III without football,8,644,652,2,"Private nonprofit, 4-year or above",2,0,13,NA,75124,75124,NA,75124,75124,Basketball
54914,2018,130314,University of Saint Joseph,West Hartford,CT,6117,7,NCAA Division III without football,100,664,764,2,"Private nonprofit, 4-year or above",2,20,11,479127,124699,603826,479127,124699,603826,Basketball
79105,2019,130314,University of Saint Joseph,West Hartford,CT,6117,7,NCAA Division III without football,161,633,794,2,"Private nonprofit, 4-year or above",2,16,14,436891,148633,585524,436891,148633,585524,Basketball
1821,2015,122436,University of San Diego,San Diego,CA,921102492,2,NCAA Division I-FCS,2444,2946,5390,2,"Private nonprofit, 4-year or above",2,14,19,2513504,1814889,4328393,2513504,1814889,4328393,Basketball
19184,2016,122436,University of San Diego,San Diego,CA,92110,2,NCAA Division I-FCS,2490,2943,5433,2,"Private nonprofit, 4-year or above",2,15,26,2613793,1833417,4447210,2613793,1833417,4447210,Basketball
36621,2017,122436,University of San Diego,San Diego,CA,92110,2,NCAA Division I-FCS,2509,3030,5539,2,"Private nonprofit, 4-year or above",2,20,24,3060591,1929280,4989871,3060591,1929280,4989871,Basketball
54253,2018,122436,University of San Diego,San Diego,CA,92110,2,NCAA Division I-FCS,2514,3091,5605,2,"Private nonprofit, 4-year or above",2,19,23,3120907,2034732,5155639,3120907,2034732,5155639,Basketball
76998,2019,122436,University of San Diego,San Diego,CA,92110,2,NCAA Division I-FCS,2517,3174,5691,2,"Private nonprofit, 4-year or above",2,16,16,2929756,2119338,5049094,2929756,2119338,5049094,Basketball
1842,2015,122612,University of San Francisco,San Francisco,CA,941171080,3,NCAA Division I without football,2426,3972,6398,2,"Private nonprofit, 4-year or above",2,18,23,4205606,2587723,6793329,4205606,2587723,6793329,Basketball
19205,2016,122612,University of San Francisco,San Francisco,CA,94117,3,NCAA Division I without football,2442,3971,6413,2,"Private nonprofit, 4-year or above",2,15,15,4254947,2483636,6738583,4254947,2483636,6738583,Basketball
36642,2017,122612,University of San Francisco,San Francisco,CA,94117,3,NCAA Division I without football,2456,4111,6567,2,"Private nonprofit, 4-year or above",2,16,13,3873389,2507042,6380431,3873389,2507042,6380431,Basketball
54274,2018,122612,University of San Francisco,San Francisco,CA,94117,3,NCAA Division I without football,2356,4061,6417,2,"Private nonprofit, 4-year or above",2,16,13,4071649,2334119,6405768,4071649,2334119,6405768,Basketball
77073,2019,122612,University of San Francisco,San Francisco,CA,94117,3,NCAA Division I without football,2330,3981,6311,2,"Private nonprofit, 4-year or above",2,15,16,4294860,2651894,6946754,4294860,2651894,6946754,Basketball
13517,2015,215929,University of Scranton,Scranton,PA,185104629,7,NCAA Division III without football,1545,2140,3685,2,"Private nonprofit, 4-year or above",2,15,15,263340,215059,478399,263340,215059,478399,Basketball
30976,2016,215929,University of Scranton,Scranton,PA,18510,7,NCAA Division III without football,1518,2140,3658,2,"Private nonprofit, 4-year or above",2,15,15,273504,257844,531348,273504,257844,531348,Basketball
48486,2017,215929,University of Scranton,Scranton,PA,18510,7,NCAA Division III without football,1516,2099,3615,2,"Private nonprofit, 4-year or above",2,16,14,279822,277485,557307,279822,277485,557307,Basketball
66228,2018,215929,University of Scranton,Scranton,PA,18510,7,NCAA Division III without football,1513,2037,3550,2,"Private nonprofit, 4-year or above",2,16,14,346191,278348,624539,346191,278348,624539,Basketball
117385,2019,215929,University of Scranton,Scranton,PA,18510,7,NCAA Division III without football,1533,2078,3611,2,"Private nonprofit, 4-year or above",2,17,14,325652,260014,585666,325652,260014,585666,Basketball
14255,2015,219383,University of Sioux Falls,Sioux Falls,SD,571051699,4,NCAA Division II with football,402,603,1005,2,"Private nonprofit, 4-year or above",2,19,19,615971,589149,1205120,615971,589149,1205120,Basketball
31716,2016,219383,University of Sioux Falls,Sioux Falls,SD,57105,4,NCAA Division II with football,400,631,1031,2,"Private nonprofit, 4-year or above",2,16,16,688854,528612,1217466,688854,528612,1217466,Basketball
49230,2017,219383,University of Sioux Falls,Sioux Falls,SD,57105,4,NCAA Division II with football,375,658,1033,2,"Private nonprofit, 4-year or above",2,18,21,645156,606344,1251500,641667,601658,1243325,Basketball
66996,2018,219383,University of Sioux Falls,Sioux Falls,SD,57105,4,NCAA Division II with football,420,717,1137,2,"Private nonprofit, 4-year or above",2,17,18,564320,533400,1097720,546866,526403,1073269,Basketball
119792,2019,219383,University of Sioux Falls,Sioux Falls,SD,57105,4,NCAA Division II with football,436,770,1206,2,"Private nonprofit, 4-year or above",2,14,18,541121,545853,1086974,541121,545853,1086974,Basketball
248,2015,102094,University of South Alabama,Mobile,AL,366880002,1,NCAA Division I-FBS,4151,5222,9373,1,"Public, 4-year or above",2,16,14,1947489,1292169,3239658,1754970,1311340,3066310,Basketball
17596,2016,102094,University of South Alabama,Mobile,AL,36688,1,NCAA Division I-FBS,4446,5150,9596,1,"Public, 4-year or above",2,17,14,2054100,1292557,3346657,1818722,1322244,3140966,Basketball
35008,2017,102094,University of South Alabama,Mobile,AL,36688,1,NCAA Division I-FBS,3989,5087,9076,1,"Public, 4-year or above",2,15,15,2154353,1405858,3560211,1957503,1432027,3389530,Basketball
52633,2018,102094,University of South Alabama,Mobile,AL,36688,1,NCAA Division I-FBS,3516,5101,8617,1,"Public, 4-year or above",2,14,14,2313701,1444903,3758604,2052778,1463319,3516097,Basketball
71390,2019,102094,University of South Alabama,Mobile,AL,36688,1,NCAA Division I-FBS,3199,4858,8057,1,"Public, 4-year or above",2,15,15,2218080,1491776,3709856,2054576,1491776,3546352,Basketball
119023,2019,218645,University of South Carolina Aiken,Aiken,SC,29801,5,NCAA Division II without football,895,1684,2579,1,"Public, 4-year or above",2,13,10,544929,476955,1021884,543830,476751,1020581,Basketball
14086,2015,218645,University of South Carolina-Aiken,Aiken,SC,29801,5,NCAA Division II without football,931,1644,2575,1,"Public, 4-year or above",2,12,14,440556,470057,910613,440556,470057,910613,Basketball
31543,2016,218645,University of South Carolina-Aiken,Aiken,SC,29801,5,NCAA Division II without football,1023,1795,2818,1,"Public, 4-year or above",2,13,14,570842,562300,1133142,573274,574746,1148020,Basketball
49055,2017,218645,University of South Carolina-Aiken,Aiken,SC,29801,5,NCAA Division II without football,953,1750,2703,1,"Public, 4-year or above",2,13,14,468161,479499,947660,468161,479499,947660,Basketball
66817,2018,218645,University of South Carolina-Aiken,Aiken,SC,29801,5,NCAA Division II without football,919,1746,2665,1,"Public, 4-year or above",2,13,13,515976,462157,978133,515622,462157,977779,Basketball
14100,2015,218663,University of South Carolina-Columbia,Columbia,SC,29208,1,NCAA Division I-FBS,10694,12634,23328,1,"Public, 4-year or above",2,16,31,9647770,1530532,11178302,7080820,5407201,12488021,Basketball
31557,2016,218663,University of South Carolina-Columbia,Columbia,SC,29208,1,NCAA Division I-FBS,11018,12929,23947,1,"Public, 4-year or above",2,17,29,11948781,2046234,13995015,9282730,7086553,16369283,Basketball
49069,2017,218663,University of South Carolina-Columbia,Columbia,SC,29208,1,NCAA Division I-FBS,11221,13357,24578,1,"Public, 4-year or above",2,16,30,11112728,2598370,13711098,9969479,8497345,18466824,Basketball
66830,2018,218663,University of South Carolina-Columbia,Columbia,SC,29208,1,NCAA Division I-FBS,11772,13540,25312,1,"Public, 4-year or above",2,16,31,11093661,2207171,13300832,8561964,6833386,15395350,Basketball
119099,2019,218663,University of South Carolina-Columbia,Columbia,SC,29208,1,NCAA Division I-FBS,12029,14090,26119,1,"Public, 4-year or above",2,16,31,10267956,3089470,13357426,8230497,6925738,15156235,Basketball
14140,2015,218742,University of South Carolina-Upstate,Spartanburg,SC,293034999,3,NCAA Division I without football,1452,2696,4148,1,"Public, 4-year or above",2,15,14,987517,815477,1802994,987517,815477,1802994,Basketball
31598,2016,218742,University of South Carolina-Upstate,Spartanburg,SC,29303,3,NCAA Division I without football,1514,2889,4403,1,"Public, 4-year or above",2,16,16,924768,772208,1696976,924768,772208,1696976,Basketball
49114,2017,218742,University of South Carolina-Upstate,Spartanburg,SC,29303,3,NCAA Division I without football,1521,2960,4481,1,"Public, 4-year or above",2,16,16,1130013,842322,1972335,1130013,842322,1972335,Basketball
66876,2018,218742,University of South Carolina-Upstate,Spartanburg,SC,29303,3,NCAA Division I without football,1555,3130,4685,1,"Public, 4-year or above",2,14,13,1167592,850314,2017906,1167592,850314,2017906,Basketball
119364,2019,218742,University of South Carolina-Upstate,Spartanburg,SC,29303,3,NCAA Division I without football,1480,3090,4570,1,"Public, 4-year or above",2,15,16,1138604,919150,2057754,1138604,919150,2057754,Basketball
14263,2015,219471,University of South Dakota,Vermillion,SD,570692390,2,NCAA Division I-FCS,1963,2976,4939,1,"Public, 4-year or above",2,17,15,1156551,1114914,2271465,1156551,1114914,2271465,Basketball
31725,2016,219471,University of South Dakota,Vermillion,SD,57069,2,NCAA Division I-FCS,1978,2944,4922,1,"Public, 4-year or above",2,15,14,1470740,1373070,2843810,1470740,1373070,2843810,Basketball
49239,2017,219471,University of South Dakota,Vermillion,SD,57069,2,NCAA Division I-FCS,1917,2963,4880,1,"Public, 4-year or above",2,17,14,1685107,1418877,3103984,1685107,1418877,3103984,Basketball
67007,2018,219471,University of South Dakota,Vermillion,SD,57069,2,NCAA Division I-FCS,1873,3063,4936,1,"Public, 4-year or above",2,17,14,1469868,1332037,2801905,1469868,1332037,2801905,Basketball
119867,2019,219471,University of South Dakota,Vermillion,SD,57069,2,NCAA Division I-FCS,1791,3052,4843,1,"Public, 4-year or above",2,16,14,1625434,1432486,3057920,1625434,1432486,3057920,Basketball
3032,2015,137351,University of South Florida-Main Campus,Tampa,FL,336209951,1,NCAA Division I-FBS,10587,13137,23724,1,"Public, 4-year or above",2,15,15,5701910,756756,6458666,4711026,3193249,7904275,Basketball
20406,2016,137351,University of South Florida-Main Campus,Tampa,FL,33620,1,NCAA Division I-FBS,10666,12937,23603,1,"Public, 4-year or above",2,15,15,5249672,2821037,8070709,4925942,2821037,7746979,Basketball
37858,2017,137351,University of South Florida-Main Campus,Tampa,FL,33620,1,NCAA Division I-FBS,10999,13343,24342,1,"Public, 4-year or above",2,16,13,4732996,1218398,5951394,5079617,3216517,8296134,Basketball
55509,2018,137351,University of South Florida-Main Campus,Tampa,FL,33620,1,NCAA Division I-FBS,10900,13602,24502,1,"Public, 4-year or above",2,15,22,4931868,2960713,7892581,4931868,2960713,7892581,Basketball
81267,2019,137351,University of South Florida-Main Campus,Tampa,FL,33620,1,NCAA Division I-FBS,11110,14040,25150,1,"Public, 4-year or above",2,13,20,4982170,2788632,7770802,4982170,2788632,7770802,Basketball
2057,2015,123961,University of Southern California,Los Angeles,CA,90089,1,NCAA Division I-FBS,8818,9197,18015,2,"Private nonprofit, 4-year or above",2,14,13,4948398,2709500,7657898,5266779,2836654,8103433,Basketball
19423,2016,123961,University of Southern California,Los Angeles,CA,90089,1,NCAA Division I-FBS,8687,9383,18070,2,"Private nonprofit, 4-year or above",2,14,14,5457322,2960163,8417485,5775866,2983417,8759283,Basketball
36861,2017,123961,University of Southern California,Los Angeles,CA,90089,1,NCAA Division I-FBS,8903,9562,18465,2,"Private nonprofit, 4-year or above",2,15,13,5961525,3000920,8962445,6488543,3032810,9521353,Basketball
54497,2018,123961,University of Southern California,Los Angeles,CA,90089,1,NCAA Division I-FBS,9240,9807,19047,2,"Private nonprofit, 4-year or above",2,14,13,6275440,2836460,9111900,6901843,2894674,9796517,Basketball
77759,2019,123961,University of Southern California,Los Angeles,CA,90089,1,NCAA Division I-FBS,9333,10116,19449,2,"Private nonprofit, 4-year or above",2,15,12,6540372,2952488,9492860,7031040,2957804,9988844,Basketball
4485,2015,151306,University of Southern Indiana,Evansville,IN,47712,5,NCAA Division II without football,2733,4105,6838,1,"Public, 4-year or above",2,15,13,634986,544365,1179351,634986,544365,1179351,Basketball
21857,2016,151306,University of Southern Indiana,Evansville,IN,47712,5,NCAA Division II without football,2605,4056,6661,1,"Public, 4-year or above",2,14,13,666411,599515,1265926,662919,599482,1262401,Basketball
39331,2017,151306,University of Southern Indiana,Evansville,IN,47712,5,NCAA Division II without football,2464,4049,6513,1,"Public, 4-year or above",2,15,12,701069,578827,1279896,697272,571308,1268580,Basketball
56991,2018,151306,University of Southern Indiana,Evansville,IN,47712,5,NCAA Division II without football,2415,3988,6403,1,"Public, 4-year or above",2,17,12,719453,566502,1285955,696123,559890,1256013,Basketball
86523,2019,151306,University of Southern Indiana,Evansville,IN,47712,5,NCAA Division II without football,2254,3831,6085,1,"Public, 4-year or above",2,17,11,820509,569812,1390321,809633,565710,1375343,Basketball
6013,2015,161554,University of Southern Maine,Portland,ME,4103,7,NCAA Division III without football,1599,2106,3705,1,"Public, 4-year or above",2,18,15,155908,116364,272272,155441,89670,245111,Basketball
23400,2016,161554,University of Southern Maine,Portland,ME,4103,7,NCAA Division III without football,1548,2152,3700,1,"Public, 4-year or above",2,16,12,117070,101490,218560,130657,104348,235005,Basketball
40902,2017,161554,University of Southern Maine,Portland,ME,4103,7,NCAA Division III without football,1622,2251,3873,1,"Public, 4-year or above",2,17,14,129413,107279,236692,139276,108755,248031,Basketball
58591,2018,161554,University of Southern Maine,Portland,ME,4103,7,NCAA Division III without football,1660,2340,4000,1,"Public, 4-year or above",2,26,25,143659,133758,277417,153343,121212,274555,Basketball
91755,2019,161554,University of Southern Maine,Portland,ME,4103,7,NCAA Division III without football,1658,2382,4040,1,"Public, 4-year or above",2,17,15,160410,118471,278881,161303,125418,286721,Basketball
8058,2015,176372,University of Southern Mississippi,Hattiesburg,MS,394060001,1,NCAA Division I-FBS,3664,6633,10297,1,"Public, 4-year or above",2,16,18,1808186,1327718,3135904,1808186,1327718,3135904,Basketball
25476,2016,176372,University of Southern Mississippi,Hattiesburg,MS,39406,1,NCAA Division I-FBS,3683,6559,10242,1,"Public, 4-year or above",2,17,20,1835983,1409970,3245953,1835983,1409970,3245953,Basketball
42974,2017,176372,University of Southern Mississippi,Hattiesburg,MS,39406,1,NCAA Division I-FBS,3766,6618,10384,1,"Public, 4-year or above",2,14,22,1781086,1390228,3171314,1781086,1390228,3171314,Basketball
60684,2018,176372,University of Southern Mississippi,Hattiesburg,MS,39406,1,NCAA Division I-FBS,3463,6383,9846,1,"Public, 4-year or above",2,15,16,2169053,1456454,3625507,2169053,1456454,3625507,Basketball
98459,2019,176372,University of Southern Mississippi,Hattiesburg,MS,39406,1,NCAA Division I-FBS,3367,6283,9650,1,"Public, 4-year or above",2,16,18,1794381,1356108,3150489,1794381,1356108,3150489,Basketball
7810,2015,174914,University of St Thomas,Saint Paul,MN,551051078,6,NCAA Division III with football,3198,2646,5844,2,"Private nonprofit, 4-year or above",2,27,25,273504,161316,434820,273504,161316,434820,Basketball
25224,2016,174914,University of St Thomas,Saint Paul,MN,55105,6,NCAA Division III with football,3133,2641,5774,2,"Private nonprofit, 4-year or above",2,27,20,214710,184574,399284,214710,184574,399284,Basketball
42725,2017,174914,University of St Thomas,Saint Paul,MN,55105,6,NCAA Division III with football,3181,2757,5938,2,"Private nonprofit, 4-year or above",2,34,18,217451,175316,392767,217451,175316,392767,Basketball
60431,2018,174914,University of St Thomas,Saint Paul,MN,55105,6,NCAA Division III with football,3272,2883,6155,2,"Private nonprofit, 4-year or above",2,31,22,236843,210965,447808,236843,210965,447808,Basketball
97463,2019,174914,University of St Thomas,Saint Paul,MN,55105,6,NCAA Division III with football,3245,2891,6136,2,"Private nonprofit, 4-year or above",2,29,18,227045,193842,420887,227045,193842,420887,Basketball
123400,2019,227863,University of St Thomas,Houston,TX,77006,7,NCAA Division III without football,542,1145,1687,2,"Private nonprofit, 4-year or above",2,17,15,221652,204702,426354,221652,204702,426354,Basketball
2626,2015,131399,University of the District of Columbia,Washington,DC,20008,5,NCAA Division II without football,896,1020,1916,1,"Public, 4-year or above",2,13,14,558157,549740,1107897,558157,549740,1107897,Basketball
19999,2016,131399,University of the District of Columbia,Washington,DC,20008,5,NCAA Division II without football,909,877,1786,1,"Public, 4-year or above",2,13,12,569068,491999,1061067,563289,528291,1091580,Basketball
37438,2017,131399,University of the District of Columbia,Washington,DC,20008,5,NCAA Division II without football,902,917,1819,1,"Public, 4-year or above",2,12,12,547449,556273,1103722,547449,556273,1103722,Basketball
55082,2018,131399,University of the District of Columbia,Washington,DC,20008,5,NCAA Division II without football,891,953,1844,1,"Public, 4-year or above",2,12,12,598211,548581,1146792,598211,548581,1146792,Basketball
79494,2019,131399,University of the District of Columbia,Washington,DC,20008,5,NCAA Division II without football,836,938,1774,1,"Public, 4-year or above",2,12,12,619771,547504,1167275,619771,547504,1167275,Basketball
14840,2015,225627,University of the Incarnate Word,San Antonio,TX,78209,2,NCAA Division I-FCS,1686,2552,4238,2,"Private nonprofit, 4-year or above",2,11,14,1481948,1048520,2530468,1180488,1020198,2200686,Basketball
32310,2016,225627,University of the Incarnate Word,San Antonio,TX,78209,2,NCAA Division I-FCS,1772,2716,4488,2,"Private nonprofit, 4-year or above",2,14,13,1223435,1051333,2274768,1223435,1038166,2261601,Basketball
49834,2017,225627,University of the Incarnate Word,San Antonio,TX,78209,2,NCAA Division I-FCS,1721,2687,4408,2,"Private nonprofit, 4-year or above",2,14,15,1690280,1183838,2874118,1397295,1174722,2572017,Basketball
67609,2018,225627,University of the Incarnate Word,San Antonio,TX,78209,2,NCAA Division I-FCS,1558,2490,4048,2,"Private nonprofit, 4-year or above",2,15,13,1416859,1201507,2618366,1371582,1199662,2571244,Basketball
122345,2019,225627,University of the Incarnate Word,San Antonio,TX,78209,2,NCAA Division I-FCS,1546,2483,4029,2,"Private nonprofit, 4-year or above",2,14,13,1480233,1240940,2721173,1376005,1236032,2612037,Basketball
598,2015,107558,University of the Ozarks,Clarksville,AR,72830,7,NCAA Division III without football,301,332,633,2,"Private nonprofit, 4-year or above",2,21,18,136318,129242,265560,136318,129242,265560,Basketball
17945,2016,107558,University of the Ozarks,Clarksville,AR,72830,7,NCAA Division III without football,326,341,667,2,"Private nonprofit, 4-year or above",2,21,19,127614,135999,263613,127614,135999,263613,Basketball
35373,2017,107558,University of the Ozarks,Clarksville,AR,72830,7,NCAA Division III without football,371,371,742,2,"Private nonprofit, 4-year or above",2,24,16,137207,127185,264392,137207,127185,264392,Basketball
52993,2018,107558,University of the Ozarks,Clarksville,AR,72830,7,NCAA Division III without football,422,436,858,2,"Private nonprofit, 4-year or above",2,22,25,135949,113149,249098,135949,113149,249098,Basketball
72888,2019,107558,University of the Ozarks,Clarksville,AR,72830,7,NCAA Division III without football,397,412,809,2,"Private nonprofit, 4-year or above",2,19,17,126049,124141,250190,126049,124141,250190,Basketball
1633,2015,120883,University of the Pacific,Stockton,CA,952110197,3,NCAA Division I without football,1745,1885,3630,2,"Private nonprofit, 4-year or above",2,16,15,2558711,2116125,4674836,2558711,2116125,4674836,Basketball
18993,2016,120883,University of the Pacific,Stockton,CA,95211,3,NCAA Division I without football,1566,1809,3375,2,"Private nonprofit, 4-year or above",2,18,14,3684884,2217556,5902440,3684884,2217556,5902440,Basketball
36428,2017,120883,University of the Pacific,Stockton,CA,95211,3,NCAA Division I without football,1564,1883,3447,2,"Private nonprofit, 4-year or above",2,12,15,3388724,2256500,5645224,3388724,2256500,5645224,Basketball
54057,2018,120883,University of the Pacific,Stockton,CA,95211,3,NCAA Division I without football,1684,1866,3550,2,"Private nonprofit, 4-year or above",2,14,14,3181522,2198286,5379808,3181522,2198286,5379808,Basketball
76379,2019,120883,University of the Pacific,Stockton,CA,95211,3,NCAA Division I without football,1664,1817,3481,2,"Private nonprofit, 4-year or above",2,15,15,3195439,2163983,5359422,3195439,2163983,5359422,Basketball
13406,2015,215132,University of the Sciences,Philadelphia,PA,191044495,5,NCAA Division II without football,610,913,1523,2,"Private nonprofit, 4-year or above",2,15,14,351487,291683,643170,351487,291683,643170,Basketball
30865,2016,215132,University of the Sciences,Philadelphia,PA,19104,5,NCAA Division II without football,511,814,1325,2,"Private nonprofit, 4-year or above",2,14,14,321277,333025,654302,321277,333025,654302,Basketball
48374,2017,215132,University of the Sciences,Philadelphia,PA,19104,5,NCAA Division II without football,497,754,1251,2,"Private nonprofit, 4-year or above",2,18,17,353416,377900,731316,353416,377900,731316,Basketball
66115,2018,215132,University of the Sciences,Philadelphia,PA,19104,5,NCAA Division II without football,440,776,1216,2,"Private nonprofit, 4-year or above",2,17,15,354965,370397,725362,354965,370397,725362,Basketball
117007,2019,215132,University of the Sciences,Philadelphia,PA,19104,4,NCAA Division II with football,440,776,1216,2,"Private nonprofit, 4-year or above",2,15,14,300918,333891,634809,300918,333891,634809,Basketball
11915,2015,206084,University of Toledo,Toledo,OH,436063390,1,NCAA Division I-FBS,6533,6017,12550,1,"Public, 4-year or above",2,13,26,2340047,2013212,4353259,2340047,2013212,4353259,Basketball
29355,2016,206084,University of Toledo,Toledo,OH,43606,1,NCAA Division I-FBS,6578,6232,12810,1,"Public, 4-year or above",2,16,34,2675033,2069113,4744146,2675033,2069113,4744146,Basketball
46859,2017,206084,University of Toledo,Toledo,OH,43606,1,NCAA Division I-FBS,6595,6326,12921,1,"Public, 4-year or above",2,15,27,2544042,2234377,4778419,2544042,2234377,4778419,Basketball
64601,2018,206084,University of Toledo,Toledo,OH,43606,1,NCAA Division I-FBS,6552,6247,12799,1,"Public, 4-year or above",2,15,32,2673988,2299814,4973802,2673988,2299814,4973802,Basketball
111825,2019,206084,University of Toledo,Toledo,OH,43606,1,NCAA Division I-FBS,6289,6143,12432,1,"Public, 4-year or above",2,14,32,2465490,2200715,4666205,2465490,2200715,4666205,Basketball
12262,2015,207971,University of Tulsa,Tulsa,OK,741043189,1,NCAA Division I-FBS,1938,1405,3343,2,"Private nonprofit, 4-year or above",2,16,17,6174244,2317512,8491756,6174244,2317512,8491756,Basketball
29705,2016,207971,University of Tulsa,Tulsa,OK,74104,1,NCAA Division I-FBS,1852,1396,3248,2,"Private nonprofit, 4-year or above",2,18,22,6130964,2300216,8431180,6130964,2300216,8431180,Basketball
47201,2017,207971,University of Tulsa,Tulsa,OK,74104,1,NCAA Division I-FBS,1784,1412,3196,2,"Private nonprofit, 4-year or above",2,15,21,5959541,2251104,8210645,5959541,2251104,8210645,Basketball
64945,2018,207971,University of Tulsa,Tulsa,OK,74104,1,NCAA Division I-FBS,1732,1414,3146,2,"Private nonprofit, 4-year or above",2,18,23,6196308,2515857,8712165,6196308,2515857,8712165,Basketball
113118,2019,207971,University of Tulsa,Tulsa,OK,74104,1,NCAA Division I-FBS,1678,1473,3151,2,"Private nonprofit, 4-year or above",2,15,21,5083099,2129479,7212578,5083099,2129479,7212578,Basketball
15430,2015,230764,University of Utah,Salt Lake City,UT,841129008,1,NCAA Division I-FBS,9481,7306,16787,1,"Public, 4-year or above",2,15,13,8876677,260679,9137356,8053466,3131258,11184724,Basketball
32894,2016,230764,University of Utah,Salt Lake City,UT,84112,1,NCAA Division I-FBS,9286,7795,17081,1,"Public, 4-year or above",2,16,14,8754441,263803,9018244,8454976,2949242,11404218,Basketball
50427,2017,230764,University of Utah,Salt Lake City,UT,84112,1,NCAA Division I-FBS,9488,8352,17840,1,"Public, 4-year or above",2,18,16,9754858,284709,10039567,8808011,3249683,12057694,Basketball
68202,2018,230764,University of Utah,Salt Lake City,UT,84112,1,NCAA Division I-FBS,9574,8556,18130,1,"Public, 4-year or above",2,18,14,10511632,214491,10726123,8965613,3163899,12129512,Basketball
124880,2019,230764,University of Utah,Salt Lake City,UT,84112,1,NCAA Division I-FBS,9723,8811,18534,1,"Public, 4-year or above",2,17,13,9140259,286673,9426932,8638948,3187136,11826084,Basketball
13632,2015,216542,University of Valley Forge,Phoenixville,PA,194602373,7,NCAA Division III without football,306,299,605,2,"Private nonprofit, 4-year or above",2,15,10,74330,68280,142610,74330,68280,142610,Basketball
31091,2016,216542,University of Valley Forge,Phoenixville,PA,19460,7,NCAA Division III without football,304,320,624,2,"Private nonprofit, 4-year or above",2,17,16,46960,43157,90117,46960,43157,90117,Basketball
48603,2017,216542,University of Valley Forge,Phoenixville,PA,19460,7,NCAA Division III without football,286,300,586,2,"Private nonprofit, 4-year or above",2,14,14,26640,27330,53970,25140,25830,50970,Basketball
66355,2018,216542,University of Valley Forge,Phoenixville,PA,19460,7,NCAA Division III without football,250,241,491,2,"Private nonprofit, 4-year or above",2,14,9,21816,23172,44988,21816,23172,44988,Basketball
117695,2019,216542,University of Valley Forge,Phoenixville,PA,19460,7,NCAA Division III without football,204,219,423,2,"Private nonprofit, 4-year or above",2,22,10,28744,24365,53109,28744,24365,53109,Basketball
15558,2015,231174,University of Vermont,Burlington,VT,54050160,3,NCAA Division I without football,4280,5438,9718,1,"Public, 4-year or above",2,14,13,2002825,1095334,3098159,1579502,1145240,2724742,Basketball
33027,2016,231174,University of Vermont,Burlington,VT,5405,3,NCAA Division I without football,4250,5690,9940,1,"Public, 4-year or above",2,16,23,2138606,1084623,3223229,1763482,1360708,3124190,Basketball
50562,2017,231174,University of Vermont,Burlington,VT,5405,3,NCAA Division I without football,4251,5947,10198,1,"Public, 4-year or above",2,16,23,2199465,1276777,3476242,1992602,1598753,3591355,Basketball
68307,2018,231174,University of Vermont,Burlington,VT,5405,3,NCAA Division I without football,4199,6063,10262,1,"Public, 4-year or above",2,15,25,2520742,1243439,3764181,2261158,1698738,3959896,Basketball
125129,2019,231174,University of Vermont,Burlington,VT,5405,3,NCAA Division I without football,4178,6198,10376,1,"Public, 4-year or above",2,18,23,2470169,1285913,3756082,2588731,1345268,3933999,Basketball
15903,2015,234076,University of Virginia-Main Campus,Charlottesville,VA,229032628,1,NCAA Division I-FBS,6880,8338,15218,1,"Public, 4-year or above",2,19,26,10326281,1034129,11360410,8644445,4276182,12920627,Basketball
33377,2016,234076,University of Virginia-Main Campus,Charlottesville,VA,22903,1,NCAA Division I-FBS,7065,8355,15420,1,"Public, 4-year or above",2,17,30,8555125,4273169,12828294,8555125,4273169,12828294,Basketball
50928,2017,234076,University of Virginia-Main Campus,Charlottesville,VA,22903,1,NCAA Division I-FBS,7211,8486,15697,1,"Public, 4-year or above",2,17,23,13468010,4742916,18210926,10501454,4742916,15244370,Basketball
68676,2018,234076,University of Virginia-Main Campus,Charlottesville,VA,22903,1,NCAA Division I-FBS,7240,8665,15905,1,"Public, 4-year or above",2,18,26,13400721,4267198,17667919,13400721,4267198,17667919,Basketball
126333,2019,234076,University of Virginia-Main Campus,Charlottesville,VA,22903,1,NCAA Division I-FBS,7320,8854,16174,1,"Public, 4-year or above",2,20,28,13677300,4213783,17891083,11233029,4213783,15446812,Basketball
16183,2015,236948,University of Washington-Seattle Campus,Seattle,WA,981954550,1,NCAA Division I-FBS,13432,14895,28327,1,"Public, 4-year or above",2,16,15,10760021,738848,11498869,6453983,3425732,9879715,Basketball
33657,2016,236948,University of Washington-Seattle Campus,Seattle,WA,98195,1,NCAA Division I-FBS,13370,14795,28165,1,"Public, 4-year or above",2,14,16,9683868,2541649,12225517,10154262,4309032,14463294,Basketball
51211,2017,236948,University of Washington-Seattle Campus,Seattle,WA,98195,1,NCAA Division I-FBS,13404,15133,28537,1,"Public, 4-year or above",2,15,23,10226399,1024996,11251395,8656133,4394132,13050265,Basketball
68958,2018,236948,University of Washington-Seattle Campus,Seattle,WA,98195,1,NCAA Division I-FBS,13552,15703,29255,1,"Public, 4-year or above",2,19,19,11409380,1080083,12489463,9224123,4563841,13787964,Basketball
127610,2019,236948,University of Washington-Seattle Campus,Seattle,WA,98195,1,NCAA Division I-FBS,13237,15840,29077,1,"Public, 4-year or above",2,20,22,12459010,1465644,13924654,10512810,4300568,14813378,Basketball
165,2015,101587,University of West Alabama,Livingston,AL,35470,4,NCAA Division II with football,789,915,1704,1,"Public, 4-year or above",2,13,14,605119,629020,1234139,605119,629020,1234139,Basketball
17511,2016,101587,University of West Alabama,Livingston,AL,35470,4,NCAA Division II with football,781,941,1722,1,"Public, 4-year or above",2,15,15,506497,563007,1069504,506497,563007,1069504,Basketball
34918,2017,101587,University of West Alabama,Livingston,AL,35470,4,NCAA Division II with football,806,1037,1843,1,"Public, 4-year or above",2,16,15,592321,667950,1260271,561577,656401,1217978,Basketball
52550,2018,101587,University of West Alabama,Livingston,AL,35470,4,NCAA Division II with football,747,1089,1836,1,"Public, 4-year or above",2,13,15,621158,708499,1329657,623622,626654,1250276,Basketball
70896,2019,101587,University of West Alabama,Livingston,AL,35470,4,NCAA Division II with football,722,1161,1883,1,"Public, 4-year or above",2,12,14,514657,559424,1074081,512924,546572,1059496,Basketball
3469,2015,141334,University of West Georgia,Carrollton,GA,301180001,4,NCAA Division II with football,3201,5487,8688,1,"Public, 4-year or above",2,18,12,482272,481209,963481,482272,481209,963481,Basketball
20839,2016,141334,University of West Georgia,Carrollton,GA,30118,4,NCAA Division II with football,3265,5693,8958,1,"Public, 4-year or above",2,16,15,563119,486771,1049890,563119,486771,1049890,Basketball
38296,2017,141334,University of West Georgia,Carrollton,GA,30118,4,NCAA Division II with football,3274,5525,8799,1,"Public, 4-year or above",2,16,16,600543,446734,1047277,600543,446734,1047277,Basketball
55949,2018,141334,University of West Georgia,Carrollton,GA,30118,4,NCAA Division II with football,3175,5425,8600,1,"Public, 4-year or above",2,15,12,536235,433177,969412,536235,433177,969412,Basketball
82798,2019,141334,University of West Georgia,Carrollton,GA,30118,4,NCAA Division II with football,2926,5086,8012,1,"Public, 4-year or above",2,15,12,569099,487210,1056309,569099,487210,1056309,Basketball
16634,2015,240268,University of Wisconsin-Eau Claire,Eau Claire,WI,547024004,6,NCAA Division III with football,3657,5542,9199,1,"Public, 4-year or above",2,19,17,237535,181246,418781,183979,167788,351767,Basketball
34109,2016,240268,University of Wisconsin-Eau Claire,Eau Claire,WI,54701,6,NCAA Division III with football,3592,5758,9350,1,"Public, 4-year or above",2,21,19,210223,176729,386952,182679,196491,379170,Basketball
51661,2017,240268,University of Wisconsin-Eau Claire,Eau Claire,WI,54701,6,NCAA Division III with football,3644,5803,9447,1,"Public, 4-year or above",2,17,16,192827,207033,399860,166848,207033,373881,Basketball
69410,2018,240268,University of Wisconsin-Eau Claire,Eau Claire,WI,54701,6,NCAA Division III with football,3727,6041,9768,1,"Public, 4-year or above",2,17,16,203744,199521,403265,189959,195114,385073,Basketball
129191,2019,240268,University of Wisconsin-Eau Claire,Eau Claire,WI,54701,6,NCAA Division III with football,3711,6032,9743,1,"Public, 4-year or above",2,18,16,200568,209532,410100,198264,202625,400889,Basketball
16648,2015,240277,University of Wisconsin-Green Bay,Green Bay,WI,543117001,3,NCAA Division I without football,1383,2612,3995,1,"Public, 4-year or above",2,14,14,1776757,1295921,3072678,1776757,1295921,3072678,Basketball
34123,2016,240277,University of Wisconsin-Green Bay,Green Bay,WI,54311,3,NCAA Division I without football,1411,2631,4042,1,"Public, 4-year or above",2,14,13,1954390,1512854,3467244,1954390,1512854,3467244,Basketball
51675,2017,240277,University of Wisconsin-Green Bay,Green Bay,WI,54311,3,NCAA Division I without football,1448,2613,4061,1,"Public, 4-year or above",2,14,14,1758211,1292154,3050365,1758211,1292154,3050365,Basketball
69424,2018,240277,University of Wisconsin-Green Bay,Green Bay,WI,54311,3,NCAA Division I without football,1856,2960,4816,1,"Public, 4-year or above",2,15,14,1874827,1299890,3174717,1874827,1299890,3174717,Basketball
129207,2019,240277,University of Wisconsin-Green Bay,Green Bay,WI,54311,3,NCAA Division I without football,1859,3006,4865,1,"Public, 4-year or above",2,15,14,1722597,1326440,3049037,1722597,1326440,3049037,Basketball
16658,2015,240329,University of Wisconsin-La Crosse,La Crosse,WI,546019959,6,NCAA Division III with football,3979,5126,9105,1,"Public, 4-year or above",2,18,15,196989,124821,321810,203113,121747,324860,Basketball
34133,2016,240329,University of Wisconsin-La Crosse,La Crosse,WI,54601,6,NCAA Division III with football,3960,5182,9142,1,"Public, 4-year or above",2,20,17,155556,117441,272997,155556,109266,264822,Basketball
51685,2017,240329,University of Wisconsin-La Crosse,La Crosse,WI,54601,6,NCAA Division III with football,3918,5134,9052,1,"Public, 4-year or above",2,18,19,185646,148542,334188,175966,137935,313901,Basketball
69434,2018,240329,University of Wisconsin-La Crosse,La Crosse,WI,54601,6,NCAA Division III with football,3971,5154,9125,1,"Public, 4-year or above",2,19,17,223214,226112,449326,215377,208315,423692,Basketball
129245,2019,240329,University of Wisconsin-La Crosse,La Crosse,WI,54601,6,NCAA Division III with football,3913,5142,9055,1,"Public, 4-year or above",2,13,16,243790,197667,441457,221620,212947,434567,Basketball
16722,2015,240444,University of Wisconsin-Madison,Madison,WI,537061380,1,NCAA Division I-FBS,13741,14416,28157,1,"Public, 4-year or above",2,18,15,22808750,1620997,24429747,9834445,5519016,15353461,Basketball
34200,2016,240444,University of Wisconsin-Madison,Madison,WI,53706,1,NCAA Division I-FBS,13758,14443,28201,1,"Public, 4-year or above",2,17,15,23168473,1725172,24893645,9564602,5018291,14582893,Basketball
51752,2017,240444,University of Wisconsin-Madison,Madison,WI,53706,1,NCAA Division I-FBS,13812,14747,28559,1,"Public, 4-year or above",2,17,14,22438795,2010049,24448844,10636714,5987741,16624455,Basketball
69502,2018,240444,University of Wisconsin-Madison,Madison,WI,53706,1,NCAA Division I-FBS,13930,15012,28942,1,"Public, 4-year or above",2,19,17,21701868,2070214,23772082,8548485,4340513,12888998,Basketball
129395,2019,240444,University of Wisconsin-Madison,Madison,WI,53706,1,NCAA Division I-FBS,14175,15575,29750,1,"Public, 4-year or above",2,16,16,19453045,984485,20437530,8584987,3982182,12567169,Basketball
16735,2015,240453,University of Wisconsin-Milwaukee,Milwaukee,WI,532010413,3,NCAA Division I without football,8875,9165,18040,1,"Public, 4-year or above",2,17,25,2877237,1171435,4048672,2877237,1171435,4048672,Basketball
34213,2016,240453,University of Wisconsin-Milwaukee,Milwaukee,WI,53201,3,NCAA Division I without football,8441,8932,17373,1,"Public, 4-year or above",2,16,20,2241355,1375033,3616388,2241355,1375033,3616388,Basketball
51765,2017,240453,University of Wisconsin-Milwaukee,Milwaukee,WI,53211,3,NCAA Division I without football,8046,8790,16836,1,"Public, 4-year or above",2,15,15,2321139,1446082,3767221,2321139,1446082,3767221,Basketball
69515,2018,240453,University of Wisconsin-Milwaukee,Milwaukee,WI,53211,3,NCAA Division I without football,8542,9348,17890,1,"Public, 4-year or above",2,15,18,2588033,1538099,4126132,2588033,1538099,4126132,Basketball
129433,2019,240453,University of Wisconsin-Milwaukee,Milwaukee,WI,53211,3,NCAA Division I without football,8150,9086,17236,1,"Public, 4-year or above",2,18,16,2330254,1413894,3744148,2330254,1413894,3744148,Basketball
16680,2015,240365,University of Wisconsin-Oshkosh,Oshkosh,WI,54901,6,NCAA Division III with football,3655,4957,8612,1,"Public, 4-year or above",2,20,17,326145,192171,518316,294450,189029,483479,Basketball
34157,2016,240365,University of Wisconsin-Oshkosh,Oshkosh,WI,54901,6,NCAA Division III with football,3447,4817,8264,1,"Public, 4-year or above",2,20,17,328151,210664,538815,262908,184224,447132,Basketball
51709,2017,240365,University of Wisconsin-Oshkosh,Oshkosh,WI,54901,6,NCAA Division III with football,3201,4717,7918,1,"Public, 4-year or above",2,19,15,412300,233273,645573,305847,165140,470987,Basketball
69459,2018,240365,University of Wisconsin-Oshkosh,Oshkosh,WI,54901,6,NCAA Division III with football,3727,5289,9016,1,"Public, 4-year or above",2,20,20,406822,269558,676380,341206,269558,610764,Basketball
129270,2019,240365,University of Wisconsin-Oshkosh,Oshkosh,WI,54901,6,NCAA Division III with football,3439,4999,8438,1,"Public, 4-year or above",2,19,17,337853,216931,554784,337853,216931,554784,Basketball
16692,2015,240374,University of Wisconsin-Parkside,Kenosha,WI,531412000,5,NCAA Division II without football,1607,1663,3270,1,"Public, 4-year or above",2,14,18,374836,395333,770169,374836,395333,770169,Basketball
34170,2016,240374,University of Wisconsin-Parkside,Kenosha,WI,53141,5,NCAA Division II without football,1551,1696,3247,1,"Public, 4-year or above",2,15,16,384315,390816,775131,384315,390816,775131,Basketball
51721,2017,240374,University of Wisconsin-Parkside,Kenosha,WI,53144,5,NCAA Division II without football,1577,1696,3273,1,"Public, 4-year or above",2,16,16,422658,433906,856564,413641,433906,847547,Basketball
69471,2018,240374,University of Wisconsin-Parkside,Kenosha,WI,53144,5,NCAA Division II without football,1514,1677,3191,1,"Public, 4-year or above",2,17,14,471657,398366,870023,471657,398366,870023,Basketball
129308,2019,240374,University of Wisconsin-Parkside,Kenosha,WI,53144,5,NCAA Division II without football,1412,1728,3140,1,"Public, 4-year or above",2,16,12,466096,403381,869477,518518,469911,988429,Basketball
16742,2015,240462,University of Wisconsin-Platteville,Platteville,WI,538183001,6,NCAA Division III with football,4664,2405,7069,1,"Public, 4-year or above",2,19,17,323841,151252,475093,251223,145193,396416,Basketball
34220,2016,240462,University of Wisconsin-Platteville,Platteville,WI,53818,6,NCAA Division III with football,4609,2341,6950,1,"Public, 4-year or above",2,18,15,364746,194892,559638,284377,164805,449182,Basketball
51772,2017,240462,University of Wisconsin-Platteville,Platteville,WI,53818,6,NCAA Division III with football,4430,2286,6716,1,"Public, 4-year or above",2,20,18,370438,169886,540324,309737,162839,472576,Basketball
69522,2018,240462,University of Wisconsin-Platteville,Platteville,WI,53818,6,NCAA Division III with football,4553,2378,6931,1,"Public, 4-year or above",2,22,17,367164,196864,564028,360639,194940,555579,Basketball
129471,2019,240462,University of Wisconsin-Platteville,Platteville,WI,53818,6,NCAA Division III with football,4163,2294,6457,1,"Public, 4-year or above",2,17,17,314077,159937,474014,282436,132137,414573,Basketball
16750,2015,240471,University of Wisconsin-River Falls,River Falls,WI,540225001,6,NCAA Division III with football,1884,2938,4822,1,"Public, 4-year or above",2,18,16,161364,142582,303946,161364,142582,303946,Basketball
34228,2016,240471,University of Wisconsin-River Falls,River Falls,WI,54022,6,NCAA Division III with football,1861,2919,4780,1,"Public, 4-year or above",2,17,18,149955,119435,269390,149955,119436,269391,Basketball
51780,2017,240471,University of Wisconsin-River Falls,River Falls,WI,54022,6,NCAA Division III with football,1915,3032,4947,1,"Public, 4-year or above",2,18,18,159633,149636,309269,158430,149634,308064,Basketball
69530,2018,240471,University of Wisconsin-River Falls,River Falls,WI,54022,6,NCAA Division III with football,1895,3276,5171,1,"Public, 4-year or above",2,18,18,161839,125186,287025,161839,125186,287025,Basketball
129483,2019,240471,University of Wisconsin-River Falls,River Falls,WI,54022,6,NCAA Division III with football,1760,3231,4991,1,"Public, 4-year or above",2,16,16,182353,111316,293669,182353,111316,293669,Basketball
16760,2015,240480,University of Wisconsin-Stevens Point,Stevens Point,WI,544813897,6,NCAA Division III with football,3915,4249,8164,1,"Public, 4-year or above",2,14,15,405931,172762,578693,386204,164464,550668,Basketball
34238,2016,240480,University of Wisconsin-Stevens Point,Stevens Point,WI,54481,6,NCAA Division III with football,3671,4008,7679,1,"Public, 4-year or above",2,19,14,392256,182419,574675,392256,182419,574675,Basketball
51790,2017,240480,University of Wisconsin-Stevens Point,Stevens Point,WI,54481,6,NCAA Division III with football,3420,3796,7216,1,"Public, 4-year or above",2,16,13,335641,133942,469583,335641,133942,469583,Basketball
69541,2018,240480,University of Wisconsin-Stevens Point,Stevens Point,WI,54481,6,NCAA Division III with football,3525,3873,7398,1,"Public, 4-year or above",2,16,15,274028,201178,475206,274028,201178,475206,Basketball
129521,2019,240480,University of Wisconsin-Stevens Point,Stevens Point,WI,54481,6,NCAA Division III with football,3107,3550,6657,1,"Public, 4-year or above",2,14,11,277706,71855,349561,380896,163346,544242,Basketball
16700,2015,240417,University of Wisconsin-Stout,Menomonie,WI,54751,6,NCAA Division III with football,3662,3143,6805,1,"Public, 4-year or above",2,21,18,143533,164521,308054,143533,164521,308054,Basketball
34178,2016,240417,University of Wisconsin-Stout,Menomonie,WI,54751,6,NCAA Division III with football,3715,3089,6804,1,"Public, 4-year or above",2,21,18,191561,159297,350858,191561,159297,350858,Basketball
51729,2017,240417,University of Wisconsin-Stout,Menomonie,WI,54751,6,NCAA Division III with football,3656,2909,6565,1,"Public, 4-year or above",2,20,22,232867,178299,411166,232867,178299,411166,Basketball
69479,2018,240417,University of Wisconsin-Stout,Menomonie,WI,54751,6,NCAA Division III with football,3513,2636,6149,1,"Public, 4-year or above",2,24,17,185733,184230,369963,185733,176115,361848,Basketball
16713,2015,240426,University of Wisconsin-Superior,Superior,WI,548804500,7,NCAA Division III without football,759,1109,1868,1,"Public, 4-year or above",2,21,20,126943,93535,220478,126943,93535,220478,Basketball
51742,2017,240426,University of Wisconsin-Superior,Superior,WI,54880,7,NCAA Division III without football,739,1079,1818,1,"Public, 4-year or above",2,18,22,123319,97730,221049,123319,97730,221049,Basketball
69492,2018,240426,University of Wisconsin-Superior,Superior,WI,54880,7,NCAA Division III without football,711,1078,1789,1,"Public, 4-year or above",2,18,20,143048,111674,254722,143048,111674,254722,Basketball
129357,2019,240426,University of Wisconsin-Superior,Superior,WI,54880,7,NCAA Division III without football,687,1023,1710,1,"Public, 4-year or above",2,20,17,135278,110426,245704,135278,110426,245704,Basketball
16620,2015,240189,University of Wisconsin-Whitewater,Whitewater,WI,531901790,6,NCAA Division III with football,5004,4904,9908,1,"Public, 4-year or above",2,18,22,171231,213468,384699,169906,195009,364915,Basketball
34095,2016,240189,University of Wisconsin-Whitewater,Whitewater,WI,53190,6,NCAA Division III with football,5138,4908,10046,1,"Public, 4-year or above",2,20,22,165808,177405,343213,166991,177872,344863,Basketball
51647,2017,240189,University of Wisconsin-Whitewater,Whitewater,WI,53190,6,NCAA Division III with football,4989,4756,9745,1,"Public, 4-year or above",2,19,23,189173,176331,365504,189248,174841,364089,Basketball
69396,2018,240189,University of Wisconsin-Whitewater,Whitewater,WI,53190,6,NCAA Division III with football,5161,4898,10059,1,"Public, 4-year or above",2,19,19,201305,183268,384573,204067,177626,381693,Basketball
129153,2019,240189,University of Wisconsin-Whitewater,Whitewater,WI,53190,6,NCAA Division III with football,4925,4563,9488,1,"Public, 4-year or above",2,19,18,203303,221481,424784,205093,216233,421326,Basketball
16804,2015,240727,University of Wyoming,Laramie,WY,82071,1,NCAA Division I-FBS,4213,4179,8392,1,"Public, 4-year or above",2,15,19,3649309,2444447,6093756,3702699,1860238,5562937,Basketball
34281,2016,240727,University of Wyoming,Laramie,WY,82071,1,NCAA Division I-FBS,4125,3974,8099,1,"Public, 4-year or above",2,16,15,3508684,1539793,5048477,3082357,1899524,4981881,Basketball
51833,2017,240727,University of Wyoming,Laramie,WY,82071,1,NCAA Division I-FBS,4235,4044,8279,1,"Public, 4-year or above",2,15,14,3272527,1735093,5007620,3312831,2067629,5380460,Basketball
69583,2018,240727,University of Wyoming,Laramie,WY,82071,1,NCAA Division I-FBS,4301,4149,8450,1,"Public, 4-year or above",2,14,16,3329650,2253068,5582718,3329650,2253068,5582718,Basketball
129733,2019,240727,University of Wyoming,Laramie,WY,82071,1,NCAA Division I-FBS,4155,4173,8328,1,"Public, 4-year or above",2,16,14,3709285,1897223,5606508,3596686,1838861,5435547,Basketball
5042,2015,154493,Upper Iowa University,Fayette,IA,521421857,4,NCAA Division II with football,1026,1422,2448,2,"Private nonprofit, 4-year or above",2,18,15,604420,496078,1100498,602329,496078,1098407,Basketball
22400,2016,154493,Upper Iowa University,Fayette,IA,52142,4,NCAA Division II with football,878,1346,2224,2,"Private nonprofit, 4-year or above",2,16,17,574736,573595,1148331,574736,573595,1148331,Basketball
39878,2017,154493,Upper Iowa University,Fayette,IA,52142,4,NCAA Division II with football,794,1298,2092,2,"Private nonprofit, 4-year or above",2,14,14,577016,545886,1122902,524310,507591,1031901,Basketball
57550,2018,154493,Upper Iowa University,Fayette,IA,52142,4,NCAA Division II with football,760,1174,1934,2,"Private nonprofit, 4-year or above",2,19,14,601102,548652,1149754,597406,548652,1146058,Basketball
88380,2019,154493,Upper Iowa University,Fayette,IA,52142,4,NCAA Division II with football,729,1127,1856,2,"Private nonprofit, 4-year or above",2,23,18,617765,513012,1130777,623422,501946,1125368,Basketball
11926,2015,206330,Urbana University,Urbana,OH,430782091,4,NCAA Division II with football,270,213,483,2,"Private nonprofit, 4-year or above",2,13,13,340137,255057,595194,340137,255057,595194,Basketball
29366,2016,206330,Urbana University,Urbana,OH,43078,4,NCAA Division II with football,230,187,417,2,"Private nonprofit, 4-year or above",2,17,15,397269,345605,742874,397269,345605,742874,Basketball
46870,2017,206330,Urbana University,Urbana,OH,43078,4,NCAA Division II with football,204,161,365,2,"Private nonprofit, 4-year or above",2,13,14,306880,346377,653257,306880,346367,653247,Basketball
64612,2018,206330,Urbana University,Urbana,OH,430782091,4,NCAA Division II with football,0,0,0,2,"Private nonprofit, 4-year or above",2,23,13,285075,357522,642597,285075,357522,642597,Basketball
13618,2015,216524,Ursinus College,Collegeville,PA,194261000,6,NCAA Division III with football,772,855,1627,2,"Private nonprofit, 4-year or above",2,12,14,220514,126088,346602,220514,126088,346602,Basketball
31077,2016,216524,Ursinus College,Collegeville,PA,19426,6,NCAA Division III with football,719,820,1539,2,"Private nonprofit, 4-year or above",2,14,13,220610,140331,360941,220610,140331,360941,Basketball
48589,2017,216524,Ursinus College,Collegeville,PA,19426,6,NCAA Division III with football,702,783,1485,2,"Private nonprofit, 4-year or above",2,16,15,226618,127462,354080,226618,127462,354080,Basketball
66341,2018,216524,Ursinus College,Collegeville,PA,19426,6,NCAA Division III with football,692,713,1405,2,"Private nonprofit, 4-year or above",2,14,13,315757,137248,453005,315757,137248,453005,Basketball
117657,2019,216524,Ursinus College,Collegeville,PA,19426,6,NCAA Division III with football,719,735,1454,2,"Private nonprofit, 4-year or above",2,12,14,217319,144840,362159,217319,144840,362159,Basketball
11935,2015,206349,Ursuline College,Pepper Pike,OH,44124,5,NCAA Division II without football,19,421,440,2,"Private nonprofit, 4-year or above",2,0,12,NA,421653,421653,NA,421653,421653,Basketball
29374,2016,206349,Ursuline College,Pepper Pike,OH,44124,5,NCAA Division II without football,22,441,463,2,"Private nonprofit, 4-year or above",2,0,14,NA,533124,533124,NA,533124,533124,Basketball
46878,2017,206349,Ursuline College,Pepper Pike,OH,44124,5,NCAA Division II without football,29,426,455,2,"Private nonprofit, 4-year or above",2,0,12,NA,367731,367731,NA,367731,367731,Basketball
64622,2018,206349,Ursuline College,Pepper Pike,OH,44124,5,NCAA Division II without football,33,461,494,2,"Private nonprofit, 4-year or above",2,0,12,NA,383465,383465,NA,383465,383465,Basketball
111862,2019,206349,Ursuline College,Pepper Pike,OH,44124,5,NCAA Division II without football,28,462,490,2,"Private nonprofit, 4-year or above",2,0,13,NA,392453,392453,NA,392453,392453,Basketball
15408,2015,230728,Utah State University,Logan,UT,843221400,1,NCAA Division I-FBS,8287,8691,16978,1,"Public, 4-year or above",2,30,31,3363296,1891051,5254347,3363296,1891051,5254347,Basketball
32871,2016,230728,Utah State University,Logan,UT,84322,1,NCAA Division I-FBS,8249,8639,16888,1,"Public, 4-year or above",2,30,36,3291251,1843933,5135184,3291251,1843933,5135184,Basketball
50404,2017,230728,Utah State University,Logan,UT,84322,1,NCAA Division I-FBS,8281,8761,17042,1,"Public, 4-year or above",2,32,40,3451734,1725384,5177118,3451734,1725384,5177118,Basketball
68179,2018,230728,Utah State University,Logan,UT,84322,1,NCAA Division I-FBS,8301,8982,17283,1,"Public, 4-year or above",2,31,36,4250996,1879589,6130585,4250996,1879589,6130585,Basketball
124793,2019,230728,Utah State University,Logan,UT,84322,1,NCAA Division I-FBS,7919,9016,16935,1,"Public, 4-year or above",2,31,36,5154826,2236349,7391175,5154826,2236349,7391175,Basketball
15418,2015,230737,Utah Valley University,Orem,UT,840585999,3,NCAA Division I without football,9078,7390,16468,1,"Public, 4-year or above",2,22,16,1453015,764871,2217886,1116338,753118,1869456,Basketball
32881,2016,230737,Utah Valley University,Orem,UT,84058,3,NCAA Division I without football,9262,7713,16975,1,"Public, 4-year or above",2,17,16,2148015,758658,2906673,1583803,783193,2366996,Basketball
50414,2017,230737,Utah Valley University,Orem,UT,84058,3,NCAA Division I without football,9492,7996,17488,1,"Public, 4-year or above",2,16,14,1861238,988775,2850013,1635264,1000561,2635825,Basketball
68189,2018,230737,Utah Valley University,Orem,UT,84058,3,NCAA Division I without football,9852,8466,18318,1,"Public, 4-year or above",2,16,26,2006839,1052836,3059675,1866466,1052836,2919302,Basketball
124804,2019,230737,Utah Valley University,Orem,UT,84058,3,NCAA Division I without football,9989,8733,18722,1,"Public, 4-year or above",2,15,13,2031214,988510,3019724,1688730,990248,2678978,Basketball
10697,2015,197045,Utica College,Utica,NY,135024892,6,NCAA Division III with football,1030,1375,2405,2,"Private nonprofit, 4-year or above",2,21,15,124378,138498,262876,123878,138498,262376,Basketball
28122,2016,197045,Utica College,Utica,NY,13502,6,NCAA Division III with football,1170,1560,2730,2,"Private nonprofit, 4-year or above",2,17,16,203506,187804,391310,196309,181107,377416,Basketball
45618,2017,197045,Utica College,Utica,NY,13502,6,NCAA Division III with football,1233,1659,2892,2,"Private nonprofit, 4-year or above",2,18,18,182312,163114,345426,182312,163114,345426,Basketball
63329,2018,197045,Utica College,Utica,NY,13502,6,NCAA Division III with football,1241,1659,2900,2,"Private nonprofit, 4-year or above",2,18,17,186283,184098,370381,185683,184098,369781,Basketball
107384,2019,197045,Utica College,Utica,NY,13502,6,NCAA Division III with football,1206,1604,2810,2,"Private nonprofit, 4-year or above",2,18,15,35391,30084,65475,208818,178051,386869,Basketball
3460,2015,141264,Valdosta State University,Valdosta,GA,31698,4,NCAA Division II with football,2940,4294,7234,1,"Public, 4-year or above",2,16,16,299244,270104,569348,497776,530088,1027864,Basketball
20830,2016,141264,Valdosta State University,Valdosta,GA,31698,4,NCAA Division II with football,2851,4297,7148,1,"Public, 4-year or above",2,16,12,300659,397507,698166,520189,397507,917696,Basketball
38287,2017,141264,Valdosta State University,Valdosta,GA,31698,4,NCAA Division II with football,2739,4393,7132,1,"Public, 4-year or above",2,15,16,524204,467763,991967,524204,467763,991967,Basketball
55940,2018,141264,Valdosta State University,Valdosta,GA,31698,4,NCAA Division II with football,2540,4397,6937,1,"Public, 4-year or above",2,17,13,586522,491681,1078203,586522,491681,1078203,Basketball
82760,2019,141264,Valdosta State University,Valdosta,GA,31698,4,NCAA Division II with football,2412,4341,6753,1,"Public, 4-year or above",2,13,11,451709,383795,835504,451709,383795,835504,Basketball
4671,2015,152600,Valparaiso University,Valparaiso,IN,46383,2,NCAA Division I-FCS,1485,1573,3058,2,"Private nonprofit, 4-year or above",2,15,20,2720863,1282013,4002876,2666213,1235927,3902140,Basketball
22032,2016,152600,Valparaiso University,Valparaiso,IN,46383,2,NCAA Division I-FCS,1479,1717,3196,2,"Private nonprofit, 4-year or above",2,13,20,2504241,1393618,3897859,2397794,1332915,3730709,Basketball
39505,2017,152600,Valparaiso University,Valparaiso,IN,46383,2,NCAA Division I-FCS,1413,1724,3137,2,"Private nonprofit, 4-year or above",2,13,15,2559150,1517464,4076614,2693562,1519543,4213105,Basketball
57167,2018,152600,Valparaiso University,Valparaiso,IN,46383,2,NCAA Division I-FCS,1375,1730,3105,2,"Private nonprofit, 4-year or above",2,14,16,2461689,1453033,3914722,2415050,1461702,3876752,Basketball
87149,2019,152600,Valparaiso University,Valparaiso,IN,46383,2,NCAA Division I-FCS,1298,1626,2924,2,"Private nonprofit, 4-year or above",2,14,15,2621694,1345884,3967578,2451915,1329447,3781362,Basketball
14607,2015,221999,Vanderbilt University,Nashville,TN,37240,1,NCAA Division I-FBS,3436,3377,6813,2,"Private nonprofit, 4-year or above",2,15,26,9171563,4403108,13574671,8181142,4403108,12584250,Basketball
32076,2016,221999,Vanderbilt University,Nashville,TN,37240,1,NCAA Division I-FBS,3366,3442,6808,2,"Private nonprofit, 4-year or above",2,12,27,9378279,5173024,14551303,7168389,5173024,12341413,Basketball
49595,2017,221999,Vanderbilt University,Nashville,TN,37240,1,NCAA Division I-FBS,3315,3476,6791,2,"Private nonprofit, 4-year or above",2,14,22,9739474,5511406,15250880,7761696,5511406,13273102,Basketball
67365,2018,221999,Vanderbilt University,Nashville,TN,37240,1,NCAA Division I-FBS,3295,3486,6781,2,"Private nonprofit, 4-year or above",2,14,19,10876435,4401360,15277795,9901818,4401360,14303178,Basketball
121178,2019,221999,Vanderbilt University,Nashville,TN,37240,1,NCAA Division I-FBS,3296,3528,6824,2,"Private nonprofit, 4-year or above",2,16,22,14072415,6034138,20106553,14072415,6034138,20106553,Basketball
10713,2015,197133,Vassar College,Poughkeepsie,NY,12604,7,NCAA Division III without football,1058,1349,2407,2,"Private nonprofit, 4-year or above",2,14,12,171126,169713,340839,171126,167069,338195,Basketball
28138,2016,197133,Vassar College,Poughkeepsie,NY,12604,7,NCAA Division III without football,1025,1365,2390,2,"Private nonprofit, 4-year or above",2,14,13,182799,178949,361748,177371,166069,343440,Basketball
45634,2017,197133,Vassar College,Poughkeepsie,NY,12604,7,NCAA Division III without football,951,1366,2317,2,"Private nonprofit, 4-year or above",2,15,14,152026,194813,346839,144721,185500,330221,Basketball
63345,2018,197133,Vassar College,Poughkeepsie,NY,12604,7,NCAA Division III without football,1003,1429,2432,2,"Private nonprofit, 4-year or above",2,18,12,229391,199854,429245,222885,199854,422739,Basketball
107401,2019,197133,Vassar College,Poughkeepsie,NY,12604,7,NCAA Division III without football,993,1424,2417,2,"Private nonprofit, 4-year or above",2,18,13,198326,161240,359566,177284,161240,338524,Basketball
13649,2015,216597,Villanova University,Villanova,PA,190851699,2,NCAA Division I-FCS,3041,3349,6390,2,"Private nonprofit, 4-year or above",2,18,22,11382110,2597685,13979795,9447198,2597685,12044883,Basketball
31105,2016,216597,Villanova University,Villanova,PA,19085,2,NCAA Division I-FCS,3035,3434,6469,2,"Private nonprofit, 4-year or above",2,15,24,11120378,2701148,13821526,11120378,2701148,13821526,Basketball
48616,2017,216597,Villanova University,Villanova,PA,19085,2,NCAA Division I-FCS,3072,3449,6521,2,"Private nonprofit, 4-year or above",2,16,22,17605994,2651481,20257475,14791481,2651481,17442962,Basketball
66368,2018,216597,Villanova University,Villanova,PA,19085,2,NCAA Division I-FCS,3069,3491,6560,2,"Private nonprofit, 4-year or above",2,15,23,14428932,2517318,16946250,14428932,2517318,16946250,Basketball
117733,2019,216597,Villanova University,Villanova,PA,19085,2,NCAA Division I-FCS,3077,3448,6525,2,"Private nonprofit, 4-year or above",2,15,21,17156399,2865169,20021568,13021970,2865169,15887139,Basketball
15894,2015,234030,Virginia Commonwealth University,Richmond,VA,232842512,3,NCAA Division I without football,8351,11456,19807,1,"Public, 4-year or above",2,15,25,7996470,2329234,10325704,5676415,2329334,8005749,Basketball
33368,2016,234030,Virginia Commonwealth University,Richmond,VA,23284,3,NCAA Division I without football,8246,11804,20050,1,"Public, 4-year or above",2,14,21,8830848,2590340,11421188,6100756,2590340,8691096,Basketball
50919,2017,234030,Virginia Commonwealth University,Richmond,VA,23284,3,NCAA Division I without football,8079,11779,19858,1,"Public, 4-year or above",2,14,21,8852784,2556936,11409720,6148859,2556936,8705795,Basketball
68667,2018,234030,Virginia Commonwealth University,Richmond,VA,23284,3,NCAA Division I without football,7951,12129,20080,1,"Public, 4-year or above",2,14,26,8833917,2720150,11554067,6102633,2720150,8822783,Basketball
126295,2019,234030,Virginia Commonwealth University,Richmond,VA,23284,3,NCAA Division I without football,7585,12149,19734,1,"Public, 4-year or above",2,14,26,9087920,2953102,12041022,6721809,2953102,9674911,Basketball
15917,2015,234085,Virginia Military Institute,Lexington,VA,244500304,2,NCAA Division I-FCS,1534,183,1717,1,"Public, 4-year or above",2,15,0,1322136,NA,1322136,1322136,NA,1322136,Basketball
33391,2016,234085,Virginia Military Institute,Lexington,VA,244500304,2,NCAA Division I-FCS,1518,195,1713,1,"Public, 4-year or above",2,17,0,1469345,NA,1469345,1469345,NA,1469345,Basketball
50943,2017,234085,Virginia Military Institute,Lexington,VA,24450,2,NCAA Division I-FCS,1516,206,1722,1,"Public, 4-year or above",2,14,0,1447762,NA,1447762,1447762,NA,1447762,Basketball
68691,2018,234085,Virginia Military Institute,Lexington,VA,24450,2,NCAA Division I-FCS,1467,218,1685,1,"Public, 4-year or above",2,14,0,1547786,NA,1547786,1547786,NA,1547786,Basketball
126371,2019,234085,Virginia Military Institute,Lexington,VA,24450,2,NCAA Division I-FCS,1459,239,1698,1,"Public, 4-year or above",2,15,0,1501001,NA,1501001,1501001,NA,1501001,Basketball
15882,2015,233921,Virginia Polytechnic Institute and State University,Blacksburg,VA,240610131,1,NCAA Division I-FBS,14194,10606,24800,1,"Public, 4-year or above",2,15,27,10901266,1277193,12178459,9478661,3989929,13468590,Basketball
33356,2016,233921,Virginia Polytechnic Institute and State University,Blacksburg,VA,24061,1,NCAA Division I-FBS,14352,10823,25175,1,"Public, 4-year or above",2,16,27,9428524,759341,10187865,9892883,4431904,14324787,Basketball
50907,2017,233921,Virginia Polytechnic Institute and State University,Blacksburg,VA,24061,1,NCAA Division I-FBS,15074,11481,26555,1,"Public, 4-year or above",2,13,17,13410392,719068,14129460,11294240,4069661,15363901,Basketball
68655,2018,233921,Virginia Polytechnic Institute and State University,Blacksburg,VA,24061,1,NCAA Division I-FBS,15416,11709,27125,1,"Public, 4-year or above",2,13,24,9886728,735842,10622570,8525606,4063565,12589171,Basketball
126257,2019,233921,Virginia Polytechnic Institute and State University,Blacksburg,VA,24061,1,NCAA Division I-FBS,16267,12272,28539,1,"Public, 4-year or above",2,15,21,11795978,921681,12717659,10269671,5089255,15358926,Basketball
15930,2015,234155,Virginia State University,Petersburg,VA,23806,4,NCAA Division II with football,1661,2316,3977,1,"Public, 4-year or above",2,17,19,527605,511697,1039302,527605,511697,1039302,Basketball
33404,2016,234155,Virginia State University,Petersburg,VA,23806,4,NCAA Division II with football,1715,2307,4022,1,"Public, 4-year or above",2,15,16,536097,508147,1044244,536097,508312,1044409,Basketball
50956,2017,234155,Virginia State University,Petersburg,VA,23806,4,NCAA Division II with football,1681,2292,3973,1,"Public, 4-year or above",2,19,21,569136,526840,1095976,569136,526840,1095976,Basketball
68706,2018,234155,Virginia State University,Petersburg,VA,23806,4,NCAA Division II with football,1640,2222,3862,1,"Public, 4-year or above",2,17,16,693049,601471,1294520,693049,601471,1294520,Basketball
126447,2019,234155,Virginia State University,Petersburg,VA,23806,4,NCAA Division II with football,1620,2283,3903,1,"Public, 4-year or above",2,16,23,603401,534812,1138213,603401,534812,1138213,Basketball
15938,2015,234164,Virginia Union University,Richmond,VA,23220,4,NCAA Division II with football,605,802,1407,2,"Private nonprofit, 4-year or above",2,15,15,530587,365851,896438,530587,365851,896438,Basketball
33412,2016,234164,Virginia Union University,Richmond,VA,23220,4,NCAA Division II with football,570,741,1311,2,"Private nonprofit, 4-year or above",2,15,20,546505,380485,926990,546505,380485,926990,Basketball
50964,2017,234164,Virginia Union University,Richmond,VA,23220,4,NCAA Division II with football,552,644,1196,2,"Private nonprofit, 4-year or above",2,20,14,526411,537277,1063688,526411,537277,1063688,Basketball
68714,2018,234164,Virginia Union University,Richmond,VA,23220,4,NCAA Division II with football,504,595,1099,2,"Private nonprofit, 4-year or above",2,23,20,533185,425611,958796,533185,550205,1083390,Basketball
126485,2019,234164,Virginia Union University,Richmond,VA,23220,4,NCAA Division II with football,508,507,1015,2,"Private nonprofit, 4-year or above",2,25,16,723873,681537,1405410,546544,541199,1087743,Basketball
15947,2015,234173,Virginia Wesleyan College,Norfolk,VA,235025599,7,NCAA Division III without football,483,847,1330,2,"Private nonprofit, 4-year or above",2,35,17,337074,176110,513184,293716,163802,457518,Basketball
33421,2016,234173,Virginia Wesleyan College,Virginia Beach,VA,23455,7,NCAA Division III without football,493,799,1292,2,"Private nonprofit, 4-year or above",2,21,20,282786,151035,433821,282786,151035,433821,Basketball
50973,2017,234173,Virginia Wesleyan University,Virginia Beach,VA,23455,7,NCAA Division III without football,535,791,1326,2,"Private nonprofit, 4-year or above",2,21,17,291891,166387,458278,291891,166387,458278,Basketball
68723,2018,234173,Virginia Wesleyan University,Virginia Beach,VA,23455,7,NCAA Division III without football,525,721,1246,2,"Private nonprofit, 4-year or above",2,20,17,314266,185150,499416,314266,185150,499416,Basketball
126523,2019,234173,Virginia Wesleyan University,Virginia Beach,VA,23455,7,NCAA Division III without football,515,707,1222,2,"Private nonprofit, 4-year or above",2,22,16,315029,171032,486061,315029,171032,486061,Basketball
10727,2015,197197,Wagner College,Staten Island,NY,103014495,2,NCAA Division I-FCS,630,1084,1714,2,"Private nonprofit, 4-year or above",2,13,13,1619380,1120295,2739675,1597445,1109871,2707316,Basketball
28154,2016,197197,Wagner College,Staten Island,NY,10301,2,NCAA Division I-FCS,671,1091,1762,2,"Private nonprofit, 4-year or above",2,14,14,1533500,1220216,2753716,1533035,1217436,2750471,Basketball
45651,2017,197197,Wagner College,Staten Island,NY,10301,2,NCAA Division I-FCS,639,1082,1721,2,"Private nonprofit, 4-year or above",2,14,14,1584113,1195354,2779467,1584113,1195354,2779467,Basketball
63362,2018,197197,Wagner College,Staten Island,NY,10301,2,NCAA Division I-FCS,605,1113,1718,2,"Private nonprofit, 4-year or above",2,13,15,1520014,1355372,2875386,1487551,1358388,2845939,Basketball
107477,2019,197197,Wagner College,Staten Island,NY,10301,2,NCAA Division I-FCS,554,1105,1659,2,"Private nonprofit, 4-year or above",2,13,14,1680721,1414797,3095518,1546857,1406524,2953381,Basketball
11243,2015,199847,Wake Forest University,Winston-Salem,NC,27106,1,NCAA Division I-FBS,2278,2527,4805,2,"Private nonprofit, 4-year or above",2,19,23,7685562,3034834,10720396,7647068,3034834,10681902,Basketball
28681,2016,199847,Wake Forest University,Winston-Salem,NC,27106,1,NCAA Division I-FBS,2305,2594,4899,2,"Private nonprofit, 4-year or above",2,17,20,8101958,3137721,11239679,7905826,3137721,11043547,Basketball
46185,2017,199847,Wake Forest University,Winston-Salem,NC,27106,1,NCAA Division I-FBS,2346,2700,5046,2,"Private nonprofit, 4-year or above",2,16,26,8656761,3081408,11738169,8296973,3081408,11378381,Basketball
63907,2018,199847,Wake Forest University,Winston-Salem,NC,27106,1,NCAA Division I-FBS,2439,2732,5171,2,"Private nonprofit, 4-year or above",2,17,26,9148670,3447683,12596353,8805630,3447683,12253313,Basketball
109399,2019,199847,Wake Forest University,Winston-Salem,NC,27106,1,NCAA Division I-FBS,2447,2792,5239,2,"Private nonprofit, 4-year or above",2,17,14,9062420,3476477,12538897,9062420,3476477,12538897,Basketball
11946,2015,206437,Walsh University,North Canton,OH,447203396,4,NCAA Division II with football,756,1117,1873,2,"Private nonprofit, 4-year or above",2,27,29,799216,581029,1380245,738340,570704,1309044,Basketball
29384,2016,206437,Walsh University,North Canton,OH,44720,4,NCAA Division II with football,731,1047,1778,2,"Private nonprofit, 4-year or above",2,19,15,746077,597583,1343660,687129,584816,1271945,Basketball
46889,2017,206437,Walsh University,North Canton,OH,44720,4,NCAA Division II with football,732,1001,1733,2,"Private nonprofit, 4-year or above",2,13,16,825437,720445,1545882,756264,694838,1451102,Basketball
64633,2018,206437,Walsh University,North Canton,OH,44720,4,NCAA Division II with football,711,984,1695,2,"Private nonprofit, 4-year or above",2,17,15,769101,728332,1497433,731648,691278,1422926,Basketball
111899,2019,206437,Walsh University,North Canton,OH,44720,4,NCAA Division II with football,695,918,1613,2,"Private nonprofit, 4-year or above",2,15,13,663325,677680,1341005,638773,642306,1281079,Basketball
5064,2015,154527,Wartburg College,Waverly,IA,506770903,6,NCAA Division III with football,696,777,1473,2,"Private nonprofit, 4-year or above",2,20,18,161360,157510,318870,161360,157510,318870,Basketball
22423,2016,154527,Wartburg College,Waverly,IA,50677,6,NCAA Division III with football,686,747,1433,2,"Private nonprofit, 4-year or above",2,25,17,181366,151986,333352,181366,151986,333352,Basketball
39901,2017,154527,Wartburg College,Waverly,IA,50677,6,NCAA Division III with football,686,786,1472,2,"Private nonprofit, 4-year or above",2,23,24,175304,157735,333039,175304,157735,333039,Basketball
57571,2018,154527,Wartburg College,Waverly,IA,50677,6,NCAA Division III with football,675,781,1456,2,"Private nonprofit, 4-year or above",2,25,24,176017,180569,356586,176017,180569,356586,Basketball
88430,2019,154527,Wartburg College,Waverly,IA,50677,6,NCAA Division III with football,661,800,1461,2,"Private nonprofit, 4-year or above",2,20,23,208184,162445,370629,208184,162445,370629,Basketball
5433,2015,156082,Washburn University,Topeka,KS,666210001,4,NCAA Division II with football,1531,2133,3664,1,"Public, 4-year or above",2,26,15,560471,551883,1112354,560471,551883,1112354,Basketball
22805,2016,156082,Washburn University,Topeka,KS,66621,4,NCAA Division II with football,1576,2205,3781,1,"Public, 4-year or above",2,35,24,644633,598954,1243587,644633,598954,1243587,Basketball
40295,2017,156082,Washburn University,Topeka,KS,66621,4,NCAA Division II with football,1615,2258,3873,1,"Public, 4-year or above",2,17,14,684776,612793,1297569,684776,612793,1297569,Basketball
57972,2018,156082,Washburn University,Topeka,KS,66621,4,NCAA Division II with football,1472,2261,3733,1,"Public, 4-year or above",2,31,29,703633,635633,1339266,703633,635633,1339266,Basketball
89740,2019,156082,Washburn University,Topeka,KS,66621,4,NCAA Division II with football,1406,2146,3552,1,"Public, 4-year or above",2,28,30,665206,629700,1294906,650116,629700,1279816,Basketball
13663,2015,216667,Washington & Jefferson College,Washington,PA,15301,6,NCAA Division III with football,673,629,1302,2,"Private nonprofit, 4-year or above",2,13,16,117524,123312,240836,117143,133592,250735,Basketball
31119,2016,216667,Washington & Jefferson College,Washington,PA,15301,6,NCAA Division III with football,704,665,1369,2,"Private nonprofit, 4-year or above",2,16,13,128904,146899,275803,128904,146899,275803,Basketball
48630,2017,216667,Washington & Jefferson College,Washington,PA,15301,6,NCAA Division III with football,721,652,1373,2,"Private nonprofit, 4-year or above",2,20,15,130817,166696,297513,130415,166108,296523,Basketball
66382,2018,216667,Washington & Jefferson College,Washington,PA,15301,6,NCAA Division III with football,682,651,1333,2,"Private nonprofit, 4-year or above",2,18,16,123010,173474,296484,122434,173465,295899,Basketball
117771,2019,216667,Washington & Jefferson College,Washington,PA,15301,6,NCAA Division III with football,602,641,1243,2,"Private nonprofit, 4-year or above",2,17,13,125340,143453,268793,117288,138333,255621,Basketball
15957,2015,234207,Washington and Lee University,Lexington,VA,244502116,6,NCAA Division III with football,936,907,1843,2,"Private nonprofit, 4-year or above",2,17,13,218649,154912,373561,179382,145758,325140,Basketball
33431,2016,234207,Washington and Lee University,Lexington,VA,24450,6,NCAA Division III with football,939,879,1818,2,"Private nonprofit, 4-year or above",2,18,15,263716,152379,416095,263716,152379,416095,Basketball
50984,2017,234207,Washington and Lee University,Lexington,VA,24450,6,NCAA Division III with football,942,875,1817,2,"Private nonprofit, 4-year or above",2,17,13,188430,142868,331298,175320,142868,318188,Basketball
68734,2018,234207,Washington and Lee University,Lexington,VA,24450,6,NCAA Division III with football,920,902,1822,2,"Private nonprofit, 4-year or above",2,15,11,181221,166330,347551,171893,165187,337080,Basketball
126561,2019,234207,Washington and Lee University,Lexington,VA,24450,6,NCAA Division III with football,915,928,1843,2,"Private nonprofit, 4-year or above",2,14,13,191627,182979,374606,184496,180838,365334,Basketball
6302,2015,164216,Washington College,Chestertown,MD,216201438,7,NCAA Division III without football,608,772,1380,2,"Private nonprofit, 4-year or above",2,16,11,144039,108091,252130,144039,108091,252130,Basketball
23685,2016,164216,Washington College,Chestertown,MD,21620,7,NCAA Division III without football,632,805,1437,2,"Private nonprofit, 4-year or above",2,16,14,142704,120469,263173,142704,120469,263173,Basketball
41189,2017,164216,Washington College,Chestertown,MD,21620,7,NCAA Division III without football,605,833,1438,2,"Private nonprofit, 4-year or above",2,16,17,126161,119608,245769,126161,119608,245769,Basketball
58885,2018,164216,Washington College,Chestertown,MD,21620,7,NCAA Division III without football,547,787,1334,2,"Private nonprofit, 4-year or above",2,16,15,172296,147580,319876,172296,147580,319876,Basketball
92770,2019,164216,Washington College,Chestertown,MD,21620,7,NCAA Division III without football,501,752,1253,2,"Private nonprofit, 4-year or above",2,13,16,143530,131420,274950,143530,131420,274950,Basketball
16173,2015,236939,Washington State University,Pullman,WA,991645910,1,NCAA Division I-FBS,10391,10907,21298,1,"Public, 4-year or above",2,14,28,5557614,2531395,8089009,5118153,2909188,8027341,Basketball
33647,2016,236939,Washington State University,Pullman,WA,99164,1,NCAA Division I-FBS,10372,11162,21534,1,"Public, 4-year or above",2,14,35,5737509,1379384,7116893,4920986,2879609,7800595,Basketball
51201,2017,236939,Washington State University,Pullman,WA,99164,1,NCAA Division I-FBS,10620,11478,22098,1,"Public, 4-year or above",2,14,35,5756568,1263833,7020401,4914186,3302346,8216532,Basketball
68948,2018,236939,Washington State University,Pullman,WA,99164,1,NCAA Division I-FBS,10833,11983,22816,1,"Public, 4-year or above",2,14,19,6171373,1116662,7288035,5483898,2751027,8234925,Basketball
127597,2019,236939,Washington State University,Pullman,WA,99164,1,NCAA Division I-FBS,10777,12222,22999,1,"Public, 4-year or above",2,17,37,6659769,1154307,7814076,6778055,3023333,9801388,Basketball
8419,2015,179867,Washington University in St Louis,Saint Louis,MO,631304899,6,NCAA Division III with football,3278,3481,6759,2,"Private nonprofit, 4-year or above",2,23,25,415421,422712,838133,407162,410790,817952,Basketball
25854,2016,179867,Washington University in St Louis,Saint Louis,MO,63130,6,NCAA Division III with football,3271,3592,6863,2,"Private nonprofit, 4-year or above",2,25,20,446279,463732,910011,415417,396786,812203,Basketball
43344,2017,179867,Washington University in St Louis,Saint Louis,MO,63130,6,NCAA Division III with football,3304,3717,7021,2,"Private nonprofit, 4-year or above",2,24,23,536051,488797,1024848,495570,410528,906098,Basketball
61063,2018,179867,Washington University in St Louis,Saint Louis,MO,63130,6,NCAA Division III with football,3358,3739,7097,2,"Private nonprofit, 4-year or above",2,17,19,508055,465485,973540,477763,435273,913036,Basketball
100021,2019,179867,Washington University in St Louis,Saint Louis,MO,63130,6,NCAA Division III with football,3389,3703,7092,2,"Private nonprofit, 4-year or above",2,17,17,493916,486278,980194,396610,384519,781129,Basketball
8701,2015,181783,Wayne State College,Wayne,NE,68787,4,NCAA Division II with football,1137,1473,2610,1,"Public, 4-year or above",2,17,18,447690,426714,874404,447690,426714,874404,Basketball
26137,2016,181783,Wayne State College,Wayne,NE,68787,4,NCAA Division II with football,1092,1361,2453,1,"Public, 4-year or above",2,16,16,470808,412579,883387,470808,412579,883387,Basketball
43632,2017,181783,Wayne State College,Wayne,NE,68787,4,NCAA Division II with football,1044,1359,2403,1,"Public, 4-year or above",2,17,16,459556,469355,928911,459556,469355,928911,Basketball
61350,2018,181783,Wayne State College,Wayne,NE,68787,4,NCAA Division II with football,1133,1429,2562,1,"Public, 4-year or above",2,13,19,453887,409436,863323,453887,409436,863323,Basketball
101095,2019,181783,Wayne State College,Wayne,NE,68787,4,NCAA Division II with football,1127,1498,2625,1,"Public, 4-year or above",2,13,16,448525,414626,863151,448525,414626,863151,Basketball
7443,2015,172644,Wayne State University,Detroit,MI,48202,4,NCAA Division II with football,5182,6435,11617,1,"Public, 4-year or above",2,17,14,765595,634231,1399826,765595,634231,1399826,Basketball
24855,2016,172644,Wayne State University,Detroit,MI,48202,4,NCAA Division II with football,5275,6678,11953,1,"Public, 4-year or above",2,14,16,741124,626265,1367389,741124,626265,1367389,Basketball
42355,2017,172644,Wayne State University,Detroit,MI,48202,4,NCAA Division II with football,5379,6967,12346,1,"Public, 4-year or above",2,13,17,729196,665240,1394436,729196,665240,1394436,Basketball
60058,2018,172644,Wayne State University,Detroit,MI,48202,4,NCAA Division II with football,5386,7526,12912,1,"Public, 4-year or above",2,13,17,732191,716549,1448740,732191,716549,1448740,Basketball
96288,2019,172644,Wayne State University,Detroit,MI,48202,4,NCAA Division II with football,5395,7681,13076,1,"Public, 4-year or above",2,14,14,764038,633144,1397182,764038,633144,1397182,Basketball
13677,2015,216694,Waynesburg University,Waynesburg,PA,153701257,6,NCAA Division III with football,556,771,1327,2,"Private nonprofit, 4-year or above",2,16,19,129909,168899,298808,129909,168899,298808,Basketball
31133,2016,216694,Waynesburg University,Waynesburg,PA,15370,6,NCAA Division III with football,557,772,1329,2,"Private nonprofit, 4-year or above",2,14,12,127165,171674,298839,127165,171674,298839,Basketball
48644,2017,216694,Waynesburg University,Waynesburg,PA,15370,6,NCAA Division III with football,549,779,1328,2,"Private nonprofit, 4-year or above",2,16,11,113130,171367,284497,113130,171367,284497,Basketball
66396,2018,216694,Waynesburg University,Waynesburg,PA,15370,6,NCAA Division III with football,559,726,1285,2,"Private nonprofit, 4-year or above",2,15,9,109133,155490,264623,109133,155490,264623,Basketball
117786,2019,216694,Waynesburg University,Waynesburg,PA,15370,6,NCAA Division III with football,519,720,1239,2,"Private nonprofit, 4-year or above",2,31,10,120441,152950,273391,120441,152950,273391,Basketball
15443,2015,230782,Weber State University,Ogden,UT,844081031,2,NCAA Division I-FCS,5031,5413,10444,1,"Public, 4-year or above",2,16,15,1799880,1064953,2864833,1799880,1064953,2864833,Basketball
32908,2016,230782,Weber State University,Ogden,UT,84408,2,NCAA Division I-FCS,4834,5431,10265,1,"Public, 4-year or above",2,16,18,1771275,1040000,2811275,1771275,1040000,2811275,Basketball
50441,2017,230782,Weber State University,Ogden,UT,84408,2,NCAA Division I-FCS,4900,5545,10445,1,"Public, 4-year or above",2,16,17,1930140,1107780,3037920,1930140,1107780,3037920,Basketball
68217,2018,230782,Weber State University,Ogden,UT,84408,2,NCAA Division I-FCS,4882,5719,10601,1,"Public, 4-year or above",2,16,14,1913406,975884,2889290,1913406,975884,2889290,Basketball
124897,2019,230782,Weber State University,Ogden,UT,84408,2,NCAA Division I-FCS,4751,6027,10778,1,"Public, 4-year or above",2,16,14,1847499,1123589,2971088,1847499,1123589,2971088,Basketball
8429,2015,179894,Webster University,Saint Louis,MO,631193194,7,NCAA Division III without football,1077,1308,2385,2,"Private nonprofit, 4-year or above",2,37,17,190311,189327,379638,171772,171824,343596,Basketball
25864,2016,179894,Webster University,Saint Louis,MO,63119,7,NCAA Division III without football,1025,1258,2283,2,"Private nonprofit, 4-year or above",2,28,20,197943,153012,350955,155916,128948,284864,Basketball
43354,2017,179894,Webster University,Saint Louis,MO,63119,7,NCAA Division III without football,999,1287,2286,2,"Private nonprofit, 4-year or above",2,24,20,210180,196414,406594,164670,166592,331262,Basketball
61073,2018,179894,Webster University,Saint Louis,MO,63119,7,NCAA Division III without football,1015,1281,2296,2,"Private nonprofit, 4-year or above",2,19,29,184627,190026,374653,147367,150759,298126,Basketball
100059,2019,179894,Webster University,Saint Louis,MO,63119,7,NCAA Division III without football,927,1239,2166,2,"Private nonprofit, 4-year or above",2,17,17,209724,219821,429545,164365,181579,345944,Basketball
10741,2015,197230,Wells College,Aurora,NY,130260500,7,NCAA Division III without football,179,359,538,2,"Private nonprofit, 4-year or above",2,17,13,87231,55916,143147,87231,55916,143147,Basketball
28171,2016,197230,Wells College,Aurora,NY,13026,7,NCAA Division III without football,171,334,505,2,"Private nonprofit, 4-year or above",2,14,11,82247,51033,133280,82247,51033,133280,Basketball
45668,2017,197230,Wells College,Aurora,NY,13026,7,NCAA Division III without football,173,308,481,2,"Private nonprofit, 4-year or above",2,13,10,83565,65457,149022,83565,65457,149022,Basketball
63380,2018,197230,Wells College,Aurora,NY,13026,7,NCAA Division III without football,167,292,459,2,"Private nonprofit, 4-year or above",2,16,10,91311,52407,143718,91311,52407,143718,Basketball
107493,2019,197230,Wells College,Aurora,NY,13026,7,NCAA Division III without football,143,267,410,2,"Private nonprofit, 4-year or above",2,16,9,76311,53286,129597,76311,53286,129597,Basketball
6894,2015,168227,Wentworth Institute of Technology,Boston,MA,2115,7,NCAA Division III without football,3125,769,3894,2,"Private nonprofit, 4-year or above",2,15,12,125149,90565,215714,124924,80044,204968,Basketball
24285,2016,168227,Wentworth Institute of Technology,Boston,MA,2115,7,NCAA Division III without football,3131,785,3916,2,"Private nonprofit, 4-year or above",2,18,13,124296,89168,213464,121512,85142,206654,Basketball
41789,2017,168227,Wentworth Institute of Technology,Boston,MA,2115,7,NCAA Division III without football,3093,805,3898,2,"Private nonprofit, 4-year or above",2,19,15,129549,94442,223991,130562,89042,219604,Basketball
59482,2018,168227,Wentworth Institute of Technology,Boston,MA,2115,7,NCAA Division III without football,3098,833,3931,2,"Private nonprofit, 4-year or above",2,14,11,144572,101318,245890,117091,94441,211532,Basketball
94390,2019,168227,Wentworth Institute of Technology,Boston,MA,2115,7,NCAA Division III without football,3040,853,3893,2,"Private nonprofit, 4-year or above",2,18,15,151529,104484,256013,146765,97641,244406,Basketball
2590,2015,131098,Wesley College,Dover,DE,199013875,6,NCAA Division III with football,603,852,1455,2,"Private nonprofit, 4-year or above",2,14,12,108076,96836,204912,108076,96836,204912,Basketball
19961,2016,131098,Wesley College,Dover,DE,19901,6,NCAA Division III with football,573,732,1305,2,"Private nonprofit, 4-year or above",2,14,13,101131,87529,188660,101131,87529,188660,Basketball
37400,2017,131098,Wesley College,Dover,DE,19901,6,NCAA Division III with football,583,720,1303,2,"Private nonprofit, 4-year or above",2,16,10,103753,84017,187770,103753,84017,187770,Basketball
55042,2018,131098,Wesley College,Dover,DE,19901,6,NCAA Division III with football,513,616,1129,2,"Private nonprofit, 4-year or above",2,17,13,106496,76698,183194,106496,76698,183194,Basketball
79396,2019,131098,Wesley College,Dover,DE,19901,6,NCAA Division III with football,457,519,976,2,"Private nonprofit, 4-year or above",2,15,13,99950,79249,179199,99950,79249,179199,Basketball
2506,2015,130697,Wesleyan University,Middletown,CT,6459,6,NCAA Division III with football,1297,1517,2814,2,"Private nonprofit, 4-year or above",2,16,12,214159,176276,390435,206680,168014,374694,Basketball
19876,2016,130697,Wesleyan University,Middletown,CT,6459,6,NCAA Division III with football,1340,1572,2912,2,"Private nonprofit, 4-year or above",2,17,11,228144,201939,430083,227150,195432,422582,Basketball
37315,2017,130697,Wesleyan University,Middletown,CT,6459,6,NCAA Division III with football,1326,1559,2885,2,"Private nonprofit, 4-year or above",2,13,13,241714,211857,453571,227583,211092,438675,Basketball
54952,2018,130697,Wesleyan University,Middletown,CT,6459,6,NCAA Division III with football,1304,1614,2918,2,"Private nonprofit, 4-year or above",2,16,15,253520,227904,481424,241728,225958,467686,Basketball
79232,2019,130697,Wesleyan University,Middletown,CT,6459,6,NCAA Division III with football,1332,1598,2930,2,"Private nonprofit, 4-year or above",2,15,11,297044,210209,507253,233532,199815,433347,Basketball
13690,2015,216764,West Chester University of Pennsylvania,West Chester,PA,19383,4,NCAA Division II with football,5123,7633,12756,1,"Public, 4-year or above",2,16,20,481803,362835,844638,344087,373884,717971,Basketball
31146,2016,216764,West Chester University of Pennsylvania,West Chester,PA,19383,4,NCAA Division II with football,5136,7658,12794,1,"Public, 4-year or above",2,16,15,487561,398816,886377,354983,380709,735692,Basketball
48657,2017,216764,West Chester University of Pennsylvania,West Chester,PA,19383,4,NCAA Division II with football,5264,7729,12993,1,"Public, 4-year or above",2,15,14,572040,433219,1005259,486227,378136,864363,Basketball
66409,2018,216764,West Chester University of Pennsylvania,West Chester,PA,19383,4,NCAA Division II with football,5253,7782,13035,1,"Public, 4-year or above",2,15,14,702886,518152,1221038,624255,498004,1122259,Basketball
117824,2019,216764,West Chester University of Pennsylvania,West Chester,PA,19383,4,NCAA Division II with football,5240,7777,13017,1,"Public, 4-year or above",2,16,14,404208,257370,661578,532033,424224,956257,Basketball
16375,2015,237932,West Liberty University,West Liberty,WV,26074,4,NCAA Division II with football,736,1107,1843,1,"Public, 4-year or above",2,13,14,477058,384036,861094,477058,384036,861094,Basketball
33850,2016,237932,West Liberty University,West Liberty,WV,26074,4,NCAA Division II with football,689,1112,1801,1,"Public, 4-year or above",2,14,17,514206,406795,921001,514206,406795,921001,Basketball
51404,2017,237932,West Liberty University,West Liberty,WV,26074,4,NCAA Division II with football,737,1118,1855,1,"Public, 4-year or above",2,15,14,406617,368411,775028,406617,368411,775028,Basketball
69149,2018,237932,West Liberty University,West Liberty,WV,26074,4,NCAA Division II with football,704,1162,1866,1,"Public, 4-year or above",2,14,17,375397,376062,751459,375397,376062,751459,Basketball
128327,2019,237932,West Liberty University,West Liberty,WV,26074,4,NCAA Division II with football,683,1151,1834,1,"Public, 4-year or above",2,13,15,435692,386658,822350,435692,386658,822350,Basketball
15341,2015,229814,West Texas A & M University,Canyon,TX,790160001,4,NCAA Division II with football,2524,3152,5676,1,"Public, 4-year or above",2,14,15,634869,547454,1182323,634869,547454,1182323,Basketball
32814,2016,229814,West Texas A & M University,Canyon,TX,79016,4,NCAA Division II with football,2502,3148,5650,1,"Public, 4-year or above",2,14,13,635846,597546,1233392,620025,597343,1217368,Basketball
50341,2017,229814,West Texas A & M University,Canyon,TX,79016,4,NCAA Division II with football,2420,3195,5615,1,"Public, 4-year or above",2,14,14,705127,626374,1331501,705127,626374,1331501,Basketball
68117,2018,229814,West Texas A & M University,Canyon,TX,79016,4,NCAA Division II with football,2339,3145,5484,1,"Public, 4-year or above",2,13,14,767035,683028,1450063,767035,683028,1450063,Basketball
124522,2019,229814,West Texas A & M University,Canyon,TX,79016,4,NCAA Division II with football,2357,3225,5582,1,"Public, 4-year or above",2,15,14,780061,674882,1454943,780061,674882,1454943,Basketball
16367,2015,237899,West Virginia State University,Institute,WV,251121000,4,NCAA Division II with football,832,977,1809,1,"Public, 4-year or above",2,15,15,302901,313468,616369,331241,316804,648045,Basketball
33842,2016,237899,West Virginia State University,Institute,WV,25112,4,NCAA Division II with football,842,920,1762,1,"Public, 4-year or above",2,22,16,392739,430383,823122,392739,430383,823122,Basketball
51396,2017,237899,West Virginia State University,Institute,WV,25112,4,NCAA Division II with football,799,902,1701,1,"Public, 4-year or above",2,22,16,434041,378486,812527,434041,378486,812527,Basketball
69141,2018,237899,West Virginia State University,Institute,WV,25112,4,NCAA Division II with football,711,874,1585,1,"Public, 4-year or above",2,25,17,408551,363101,771652,408551,363101,771652,Basketball
128318,2019,237899,West Virginia State University,Institute,WV,25112,4,NCAA Division II with football,642,824,1466,1,"Public, 4-year or above",2,21,16,515595,358692,874287,515595,358692,874287,Basketball
16409,2015,238032,West Virginia University,Morgantown,WV,265066201,1,NCAA Division I-FBS,11201,9331,20532,1,"Public, 4-year or above",2,16,38,6216753,2043017,8259770,9322717,4508241,13830958,Basketball
33884,2016,238032,West Virginia University,Morgantown,WV,26506,1,NCAA Division I-FBS,11128,9396,20524,1,"Public, 4-year or above",2,15,33,6846053,2472850,9318903,9453611,4385284,13838895,Basketball
51441,2017,238032,West Virginia University,Morgantown,WV,26506,1,NCAA Division I-FBS,11063,9649,20712,1,"Public, 4-year or above",2,13,20,7282004,3117037,10399041,10196409,4761617,14958026,Basketball
69185,2018,238032,West Virginia University,Morgantown,WV,26506,1,NCAA Division I-FBS,10170,9395,19565,1,"Public, 4-year or above",2,16,24,8484584,3091144,11575728,10798893,4697807,15496700,Basketball
128411,2019,238032,West Virginia University,Morgantown,WV,26506,1,NCAA Division I-FBS,9814,9552,19366,1,"Public, 4-year or above",2,14,29,8228788,2952484,11181272,10355093,4301544,14656637,Basketball
16398,2015,237969,West Virginia Wesleyan College,Buckhannon,WV,262012994,4,NCAA Division II with football,613,744,1357,2,"Private nonprofit, 4-year or above",2,20,25,380770,421437,802207,380770,421437,802207,Basketball
33873,2016,237969,West Virginia Wesleyan College,Buckhannon,WV,26201,4,NCAA Division II with football,618,744,1362,2,"Private nonprofit, 4-year or above",2,19,18,377426,351239,728665,377426,351239,728665,Basketball
51427,2017,237969,West Virginia Wesleyan College,Buckhannon,WV,26201,4,NCAA Division II with football,566,718,1284,2,"Private nonprofit, 4-year or above",2,23,19,449635,435180,884815,449635,435180,884815,Basketball
69171,2018,237969,West Virginia Wesleyan College,Buckhannon,WV,26201,4,NCAA Division II with football,528,633,1161,2,"Private nonprofit, 4-year or above",2,25,18,500431,414218,914649,500431,414218,914649,Basketball
128376,2019,237969,West Virginia Wesleyan College,Buckhannon,WV,26201,4,NCAA Division II with football,499,617,1116,2,"Private nonprofit, 4-year or above",2,26,17,405667,396339,802006,405667,396339,802006,Basketball
11283,2015,200004,Western Carolina University,Cullowhee,NC,287239646,2,NCAA Division I-FCS,3406,4003,7409,1,"Public, 4-year or above",2,14,13,1082372,829111,1911483,1082372,829111,1911483,Basketball
28721,2016,200004,Western Carolina University,Cullowhee,NC,28723,2,NCAA Division I-FCS,3592,4222,7814,1,"Public, 4-year or above",2,16,14,1044112,880875,1924987,1044112,880875,1924987,Basketball
46226,2017,200004,Western Carolina University,Cullowhee,NC,28723,2,NCAA Division I-FCS,3701,4286,7987,1,"Public, 4-year or above",2,16,15,1416897,911254,2328151,1416897,911254,2328151,Basketball
63949,2018,200004,Western Carolina University,Cullowhee,NC,28723,2,NCAA Division I-FCS,3963,4592,8555,1,"Public, 4-year or above",2,14,12,1089269,892474,1981743,1089269,892474,1981743,Basketball
109592,2019,200004,Western Carolina University,Cullowhee,NC,28723,2,NCAA Division I-FCS,4077,4815,8892,1,"Public, 4-year or above",2,16,12,1116879,858916,1975795,1116879,858916,1975795,Basketball
78760,2019,128391,Western Colorado University,Gunnison,CO,81231,4,NCAA Division II with football,1002,729,1731,1,"Public, 4-year or above",2,17,17,397974,438489,836463,397974,438489,836463,Basketball
2522,2015,130776,Western Connecticut State University,Danbury,CT,68106826,6,NCAA Division III with football,2022,2225,4247,1,"Public, 4-year or above",2,13,12,245557,266905,512462,245557,249767,495324,Basketball
19892,2016,130776,Western Connecticut State University,Danbury,CT,6810,6,NCAA Division III with football,2025,2091,4116,1,"Public, 4-year or above",2,13,15,181411,262510,443921,181411,262510,443921,Basketball
37331,2017,130776,Western Connecticut State University,Danbury,CT,6810,6,NCAA Division III with football,2032,2057,4089,1,"Public, 4-year or above",2,14,14,161749,239331,401080,161749,239331,401080,Basketball
54968,2018,130776,Western Connecticut State University,Danbury,CT,6810,6,NCAA Division III with football,1996,2129,4125,1,"Public, 4-year or above",2,23,13,204066,257509,461575,204066,257509,461575,Basketball
79269,2019,130776,Western Connecticut State University,Danbury,CT,6810,6,NCAA Division III with football,1974,2098,4072,1,"Public, 4-year or above",2,21,14,224459,255122,479581,224459,255122,479581,Basketball
4277,2015,149772,Western Illinois University,Macomb,IL,61455,2,NCAA Division I-FCS,4011,4095,8106,1,"Public, 4-year or above",2,16,13,1238197,953973,2192170,1238197,953973,2192170,Basketball
21651,2016,149772,Western Illinois University,Macomb,IL,61455,2,NCAA Division I-FCS,3662,3820,7482,1,"Public, 4-year or above",2,15,21,1236707,997960,2234667,1236707,997960,2234667,Basketball
39112,2017,149772,Western Illinois University,Macomb,IL,61455,2,NCAA Division I-FCS,3256,3412,6668,1,"Public, 4-year or above",2,15,21,1212286,1042532,2254818,1212286,1042532,2254818,Basketball
56770,2018,149772,Western Illinois University,Macomb,IL,61455,2,NCAA Division I-FCS,2849,3100,5949,1,"Public, 4-year or above",2,15,13,1190756,975303,2166059,1190756,975303,2166059,Basketball
85832,2019,149772,Western Illinois University,Macomb,IL,61455,2,NCAA Division I-FCS,2408,2743,5151,1,"Public, 4-year or above",2,16,15,1102602,987867,2090469,1102602,987867,2090469,Basketball
5711,2015,157951,Western Kentucky University,Bowling Green,KY,421011000,1,NCAA Division I-FBS,5752,7180,12932,1,"Public, 4-year or above",2,15,13,2759058,1635629,4394687,2759058,1635629,4394687,Basketball
23089,2016,157951,Western Kentucky University,Bowling Green,KY,42101,1,NCAA Division I-FBS,5682,7285,12967,1,"Public, 4-year or above",2,15,14,2618066,1709659,4327725,2618066,1709659,4327725,Basketball
40587,2017,157951,Western Kentucky University,Bowling Green,KY,42101,1,NCAA Division I-FBS,5456,7232,12688,1,"Public, 4-year or above",2,17,23,2976173,1731954,4708127,2976173,1731954,4708127,Basketball
58272,2018,157951,Western Kentucky University,Bowling Green,KY,42101,1,NCAA Division I-FBS,5139,7014,12153,1,"Public, 4-year or above",2,16,15,3455918,1625601,5081519,3455918,1625601,5081519,Basketball
90496,2019,157951,Western Kentucky University,Bowling Green,KY,42101,1,NCAA Division I-FBS,4756,6848,11604,1,"Public, 4-year or above",2,15,12,3147254,1524942,4672196,3147254,1524942,4672196,Basketball
7454,2015,172699,Western Michigan University,Kalamazoo,MI,490085200,1,NCAA Division I-FBS,7835,7502,15337,1,"Public, 4-year or above",2,14,16,2183818,1625516,3809334,2183818,1625516,3809334,Basketball
24866,2016,172699,Western Michigan University,Kalamazoo,MI,49008,1,NCAA Division I-FBS,7662,7337,14999,1,"Public, 4-year or above",2,15,17,2374548,1546444,3920992,2374548,1546444,3920992,Basketball
42366,2017,172699,Western Michigan University,Kalamazoo,MI,49008,1,NCAA Division I-FBS,7654,7361,15015,1,"Public, 4-year or above",2,14,18,2344233,1686830,4031063,2344233,1686830,4031063,Basketball
60069,2018,172699,Western Michigan University,Kalamazoo,MI,49008,1,NCAA Division I-FBS,7712,7211,14923,1,"Public, 4-year or above",2,14,18,2243842,1628534,3872376,2243842,1628534,3872376,Basketball
96326,2019,172699,Western Michigan University,Kalamazoo,MI,49008,1,NCAA Division I-FBS,7406,7109,14515,1,"Public, 4-year or above",2,15,16,2204126,1513944,3718070,2204126,1513944,3718070,Basketball
6905,2015,168254,Western New England University,Springfield,MA,11192684,6,NCAA Division III with football,1572,1006,2578,2,"Private nonprofit, 4-year or above",2,16,15,117750,170489,288239,117342,163169,280511,Basketball
24297,2016,168254,Western New England University,Springfield,MA,1119,6,NCAA Division III with football,1593,987,2580,2,"Private nonprofit, 4-year or above",2,16,14,139813,139371,279184,139813,126840,266653,Basketball
41801,2017,168254,Western New England University,Springfield,MA,1119,6,NCAA Division III with football,1646,967,2613,2,"Private nonprofit, 4-year or above",2,14,12,132051,163444,295495,132051,157685,289736,Basketball
59494,2018,168254,Western New England University,Springfield,MA,1119,6,NCAA Division III with football,1652,977,2629,2,"Private nonprofit, 4-year or above",2,15,16,171078,171720,342798,171078,152186,323264,Basketball
94403,2019,168254,Western New England University,Springfield,MA,1119,6,NCAA Division III with football,1569,1011,2580,2,"Private nonprofit, 4-year or above",2,17,17,247489,294766,542255,247489,283142,530631,Basketball
9352,2015,188304,Western New Mexico University,Silver City,NM,88061,4,NCAA Division II with football,549,824,1373,1,"Public, 4-year or above",2,13,12,222343,213621,435964,219941,214902,434843,Basketball
26774,2016,188304,Western New Mexico University,Silver City,NM,88061,4,NCAA Division II with football,508,784,1292,1,"Public, 4-year or above",2,15,15,230584,208229,438813,229584,208229,437813,Basketball
44267,2017,188304,Western New Mexico University,Silver City,NM,88062,4,NCAA Division II with football,487,753,1240,1,"Public, 4-year or above",2,18,17,248355,219605,467960,248355,219605,467960,Basketball
61989,2018,188304,Western New Mexico University,Silver City,NM,88062,4,NCAA Division II with football,451,701,1152,1,"Public, 4-year or above",2,16,18,288009,269556,557565,288009,269556,557565,Basketball
103191,2019,188304,Western New Mexico University,Silver City,NM,88062,4,NCAA Division II with football,431,636,1067,1,"Public, 4-year or above",2,18,18,287168,298200,585368,264594,269117,533711,Basketball
12498,2015,210429,Western Oregon University,Monmouth,OR,973611394,4,NCAA Division II with football,1614,2466,4080,1,"Public, 4-year or above",2,15,13,585738,410482,996220,585738,410482,996220,Basketball
29947,2016,210429,Western Oregon University,Monmouth,OR,97361,4,NCAA Division II with football,1573,2501,4074,1,"Public, 4-year or above",2,20,16,531105,425355,956460,531105,425355,956460,Basketball
47442,2017,210429,Western Oregon University,Monmouth,OR,97361,4,NCAA Division II with football,1528,2533,4061,1,"Public, 4-year or above",2,19,14,628296,456527,1084823,628296,456527,1084823,Basketball
65190,2018,210429,Western Oregon University,Monmouth,OR,97361,4,NCAA Division II with football,1450,2428,3878,1,"Public, 4-year or above",2,14,12,444179,407886,852065,444179,407886,852065,Basketball
114146,2019,210429,Western Oregon University,Monmouth,OR,97361,4,NCAA Division II with football,1292,2381,3673,1,"Public, 4-year or above",2,15,12,431686,437270,868956,431686,437270,868956,Basketball
2315,2015,128391,Western State Colorado University,Gunnison,CO,81231,4,NCAA Division II with football,1092,744,1836,1,"Public, 4-year or above",2,14,18,430295,339894,770189,417069,336970,754039,Basketball
19687,2016,128391,Western State Colorado University,Gunnison,CO,81231,4,NCAA Division II with football,1128,772,1900,1,"Public, 4-year or above",2,17,15,425160,415120,840280,425160,413496,838656,Basketball
37126,2017,128391,Western State Colorado University,Gunnison,CO,81231,4,NCAA Division II with football,1063,750,1813,1,"Public, 4-year or above",2,19,14,473998,445151,919149,473998,445151,919149,Basketball
54762,2018,128391,Western State Colorado University,Gunnison,CO,81231,4,NCAA Division II with football,1094,757,1851,1,"Public, 4-year or above",2,18,15,463884,509753,973637,463884,509753,973637,Basketball
16199,2015,237011,Western Washington University,Bellingham,WA,982259008,5,NCAA Division II without football,5806,7424,13230,1,"Public, 4-year or above",2,18,11,726497,638925,1365422,726497,638925,1365422,Basketball
33673,2016,237011,Western Washington University,Bellingham,WA,98225,5,NCAA Division II without football,5773,7581,13354,1,"Public, 4-year or above",2,15,14,790856,711987,1502843,790856,711987,1502843,Basketball
51227,2017,237011,Western Washington University,Bellingham,WA,98225,5,NCAA Division II without football,5875,7809,13684,1,"Public, 4-year or above",2,17,12,791161,759112,1550273,791161,759112,1550273,Basketball
68974,2018,237011,Western Washington University,Bellingham,WA,98225,5,NCAA Division II without football,5871,7969,13840,1,"Public, 4-year or above",2,15,12,863277,782732,1646009,863277,782732,1646009,Basketball
127686,2019,237011,Western Washington University,Bellingham,WA,98225,5,NCAA Division II without football,5783,8023,13806,1,"Public, 4-year or above",2,17,12,816294,900881,1717175,816294,900881,1717175,Basketball
6919,2015,168263,Westfield State University,Westfield,MA,10861630,6,NCAA Division III with football,2301,2638,4939,1,"Public, 4-year or above",2,18,18,86889,99329,186218,82138,91485,173623,Basketball
24311,2016,168263,Westfield State University,Westfield,MA,1086,6,NCAA Division III with football,2294,2662,4956,1,"Public, 4-year or above",2,18,18,85962,129374,215336,82936,129704,212640,Basketball
41815,2017,168263,Westfield State University,Westfield,MA,1086,6,NCAA Division III with football,2191,2592,4783,1,"Public, 4-year or above",2,18,18,105108,128838,233946,106054,124050,230104,Basketball
59508,2018,168263,Westfield State University,Westfield,MA,1086,6,NCAA Division III with football,2052,2504,4556,1,"Public, 4-year or above",2,18,16,110046,134379,244425,107087,144554,251641,Basketball
94441,2019,168263,Westfield State University,Westfield,MA,1086,6,NCAA Division III with football,1924,2315,4239,1,"Public, 4-year or above",2,18,17,150354,120827,271181,146007,118476,264483,Basketball
8445,2015,179946,Westminster College,Fulton,MO,652511299,6,NCAA Division III with football,528,398,926,2,"Private nonprofit, 4-year or above",2,16,17,127825,85285,213110,132149,92511,224660,Basketball
13704,2015,216807,Westminster College,New Wilmington,PA,16172,6,NCAA Division III with football,477,608,1085,2,"Private nonprofit, 4-year or above",2,17,11,143930,113465,257395,137616,103201,240817,Basketball
15451,2015,230807,Westminster College,Salt Lake City,UT,84105,5,NCAA Division II without football,890,1141,2031,2,"Private nonprofit, 4-year or above",2,16,15,490302,369362,859664,486659,365928,852587,Basketball
25874,2016,179946,Westminster College,Fulton,MO,65251,6,NCAA Division III with football,479,379,858,2,"Private nonprofit, 4-year or above",2,17,12,137625,86485,224110,95723,81926,177649,Basketball
31160,2016,216807,Westminster College,New Wilmington,PA,16172,6,NCAA Division III with football,524,623,1147,2,"Private nonprofit, 4-year or above",2,23,13,167796,126986,294782,163642,127159,290801,Basketball
32916,2016,230807,Westminster College,Salt Lake City,UT,84105,5,NCAA Division II without football,864,1139,2003,2,"Private nonprofit, 4-year or above",2,16,14,424494,392299,816793,420033,390695,810728,Basketball
43364,2017,179946,Westminster College,Fulton,MO,65251,6,NCAA Division III with football,422,335,757,2,"Private nonprofit, 4-year or above",2,15,13,101029,119184,220213,101029,119184,220213,Basketball
48671,2017,216807,Westminster College,New Wilmington,PA,16172,6,NCAA Division III with football,542,627,1169,2,"Private nonprofit, 4-year or above",2,20,17,156884,125733,282617,143060,134934,277994,Basketball
50449,2017,230807,Westminster College,Salt Lake City,UT,84105,5,NCAA Division II without football,771,1132,1903,2,"Private nonprofit, 4-year or above",2,13,14,422413,424384,846797,409184,421420,830604,Basketball
61083,2018,179946,Westminster College,Fulton,MO,65251,6,NCAA Division III with football,382,308,690,2,"Private nonprofit, 4-year or above",2,21,18,52678,61939,114617,52678,61939,114617,Basketball
66423,2018,216807,Westminster College,New Wilmington,PA,16172,6,NCAA Division III with football,550,613,1163,2,"Private nonprofit, 4-year or above",2,19,16,128701,112042,240743,111831,107373,219204,Basketball
68225,2018,230807,Westminster College,Salt Lake City,UT,84105,5,NCAA Division II without football,746,1112,1858,2,"Private nonprofit, 4-year or above",2,15,15,408251,460369,868620,393348,438028,831376,Basketball
100096,2019,179946,Westminster College,Fulton,MO,65251,6,NCAA Division III with football,352,280,632,2,"Private nonprofit, 4-year or above",2,29,15,74243,104950,179193,59459,94102,153561,Basketball
117862,2019,216807,Westminster College,New Wilmington,PA,16172,6,NCAA Division III with football,531,576,1107,2,"Private nonprofit, 4-year or above",2,19,16,141309,105832,247141,142948,112890,255838,Basketball
124935,2019,230807,Westminster College,Salt Lake City,UT,84105,5,NCAA Division II without football,634,1007,1641,2,"Private nonprofit, 4-year or above",2,17,13,429271,544427,973698,436524,558531,995055,Basketball
4287,2015,149781,Wheaton College,Wheaton,IL,601875593,6,NCAA Division III with football,1121,1288,2409,2,"Private nonprofit, 4-year or above",2,18,16,241779,243234,485013,241779,243234,485013,Basketball
6931,2015,168281,Wheaton College,Norton,MA,27662322,7,NCAA Division III without football,563,999,1562,2,"Private nonprofit, 4-year or above",2,17,13,143476,140408,283884,148477,135408,283885,Basketball
21661,2016,149781,Wheaton College,Wheaton,IL,60187,6,NCAA Division III with football,1117,1283,2400,2,"Private nonprofit, 4-year or above",2,15,16,245450,224541,469991,245450,224541,469991,Basketball
24323,2016,168281,Wheaton College,Norton,MA,2766,7,NCAA Division III without football,621,1014,1635,2,"Private nonprofit, 4-year or above",2,17,14,156562,146207,302769,156562,146207,302769,Basketball
39123,2017,149781,Wheaton College,Wheaton,IL,601875593,6,NCAA Division III with football,1045,1264,2309,2,"Private nonprofit, 4-year or above",2,19,17,291366,244210,535576,291366,244210,535576,Basketball
41827,2017,168281,Wheaton College,Norton,MA,2766,7,NCAA Division III without football,646,1028,1674,2,"Private nonprofit, 4-year or above",2,13,16,152222,157803,310025,152222,157803,310025,Basketball
56780,2018,149781,Wheaton College,Wheaton,IL,601875593,6,NCAA Division III with football,1047,1278,2325,2,"Private nonprofit, 4-year or above",2,18,17,289183,232747,521930,289183,232747,521930,Basketball
59520,2018,168281,Wheaton College,Norton,MA,2766,7,NCAA Division III without football,686,1061,1747,2,"Private nonprofit, 4-year or above",2,14,14,153230,147074,300304,153230,147074,300304,Basketball
85843,2019,149781,Wheaton College,Wheaton,IL,601875593,6,NCAA Division III with football,1062,1263,2325,2,"Private nonprofit, 4-year or above",2,20,17,275596,254903,530499,275596,254903,530499,Basketball
94479,2019,168281,Wheaton College,Norton,MA,2766,7,NCAA Division III without football,696,1060,1756,2,"Private nonprofit, 4-year or above",2,15,15,149752,163572,313324,149752,163572,313324,Basketball
16422,2015,238078,Wheeling Jesuit University,Wheeling,WV,26003,5,NCAA Division II without football,451,407,858,2,"Private nonprofit, 4-year or above",2,27,18,435750,440655,876405,429369,434176,863545,Basketball
33897,2016,238078,Wheeling Jesuit University,Wheeling,WV,26003,5,NCAA Division II without football,418,372,790,2,"Private nonprofit, 4-year or above",2,24,17,380112,394888,775000,356369,376990,733359,Basketball
51454,2017,238078,Wheeling Jesuit University,Wheeling,WV,26003,5,NCAA Division II without football,355,315,670,2,"Private nonprofit, 4-year or above",2,24,14,407748,273827,681575,407748,273827,681575,Basketball
69198,2018,238078,Wheeling Jesuit University,Wheeling,WV,26003,5,NCAA Division II without football,429,326,755,2,"Private nonprofit, 4-year or above",2,16,14,376821,267012,643833,363266,262532,625798,Basketball
128449,2019,238078,Wheeling University,Wheeling,WV,26003,4,NCAA Division II with football,225,196,421,2,"Private nonprofit, 4-year or above",2,22,13,417255,266627,683882,401189,262538,663727,Basketball
6941,2015,168290,Wheelock College,Boston,MA,22154104,7,NCAA Division III without football,128,669,797,2,"Private nonprofit, 4-year or above",2,19,12,53499,50687,104186,53499,50687,104186,Basketball
24333,2016,168290,Wheelock College,Boston,MA,2215,7,NCAA Division III without football,126,587,713,2,"Private nonprofit, 4-year or above",2,15,10,60309,50089,110398,60309,50089,110398,Basketball
16210,2015,237057,Whitman College,Walla Walla,WA,99362,7,NCAA Division III without football,602,825,1427,2,"Private nonprofit, 4-year or above",2,15,13,232904,211266,444170,232904,211266,444170,Basketball
33684,2016,237057,Whitman College,Walla Walla,WA,99362,7,NCAA Division III without football,622,828,1450,2,"Private nonprofit, 4-year or above",2,14,17,266338,218548,484886,266298,218548,484846,Basketball
51238,2017,237057,Whitman College,Walla Walla,WA,99362,7,NCAA Division III without football,623,831,1454,2,"Private nonprofit, 4-year or above",2,15,15,270431,244710,515141,272006,225263,497269,Basketball
68985,2018,237057,Whitman College,Walla Walla,WA,99362,7,NCAA Division III without football,613,822,1435,2,"Private nonprofit, 4-year or above",2,15,12,286691,286165,572856,281738,278750,560488,Basketball
127762,2019,237057,Whitman College,Walla Walla,WA,99362,7,NCAA Division III without football,654,875,1529,2,"Private nonprofit, 4-year or above",2,16,16,337540,302757,640297,332242,298789,631031,Basketball
2127,2015,125763,Whittier College,Whittier,CA,90601,6,NCAA Division III with football,709,906,1615,2,"Private nonprofit, 4-year or above",2,16,19,209822,124492,334314,117691,114378,232069,Basketball
36934,2017,125763,Whittier College,Whittier,CA,90601,6,NCAA Division III with football,711,927,1638,2,"Private nonprofit, 4-year or above",2,16,15,109363,114494,223857,103213,110494,213707,Basketball
54571,2018,125763,Whittier College,Whittier,CA,90601,6,NCAA Division III with football,709,986,1695,2,"Private nonprofit, 4-year or above",2,14,13,105207,131065,236272,99861,147188,247049,Basketball
78006,2019,125763,Whittier College,Whittier,CA,90602,6,NCAA Division III with football,760,986,1746,2,"Private nonprofit, 4-year or above",2,11,15,109666,68089,177755,125321,127941,253262,Basketball
16219,2015,237066,Whitworth University,Spokane,WA,99251,6,NCAA Division III with football,875,1411,2286,2,"Private nonprofit, 4-year or above",2,16,21,283295,214953,498248,283042,214953,497995,Basketball
33693,2016,237066,Whitworth University,Spokane,WA,99251,6,NCAA Division III with football,902,1344,2246,2,"Private nonprofit, 4-year or above",2,15,16,281001,231894,512895,281001,231894,512895,Basketball
51247,2017,237066,Whitworth University,Spokane,WA,99251,6,NCAA Division III with football,878,1314,2192,2,"Private nonprofit, 4-year or above",2,18,13,296935,204867,501802,296935,204854,501789,Basketball
68994,2018,237066,Whitworth University,Spokane,WA,99251,6,NCAA Division III with football,910,1388,2298,2,"Private nonprofit, 4-year or above",2,19,16,325076,199183,524259,325026,197769,522795,Basketball
127800,2019,237066,Whitworth University,Spokane,WA,99251,6,NCAA Division III with football,976,1377,2353,2,"Private nonprofit, 4-year or above",2,18,14,418324,255300,673624,419862,217116,636978,Basketball
5441,2015,156125,Wichita State University,Wichita,KS,672600124,3,NCAA Division I without football,3998,4540,8538,1,"Public, 4-year or above",2,19,18,8662678,1963388,10626066,6920933,1963388,8884321,Basketball
22814,2016,156125,Wichita State University,Wichita,KS,67260,3,NCAA Division I without football,3999,4567,8566,1,"Public, 4-year or above",2,17,23,7426190,2467879,9894069,6380482,2467879,8848361,Basketball
40304,2017,156125,Wichita State University,Wichita,KS,67260,3,NCAA Division I without football,4044,4628,8672,1,"Public, 4-year or above",2,17,24,8106217,2528714,10634931,7513193,2528714,10041907,Basketball
57981,2018,156125,Wichita State University,Wichita,KS,67260,3,NCAA Division I without football,4088,4701,8789,1,"Public, 4-year or above",2,17,34,8182863,2607718,10790581,8182863,2607718,10790581,Basketball
89778,2019,156125,Wichita State University,Wichita,KS,67260,3,NCAA Division I without football,4106,4821,8927,1,"Public, 4-year or above",2,16,33,8257254,2507476,10764730,7431720,2507476,9939196,Basketball
31180,2016,216852,Widener University,Chester,PA,19013,6,NCAA Division III with football,1378,1582,2960,2,"Private nonprofit, 4-year or above",2,15,16,126339,149253,275592,124066,161202,285268,Basketball
48692,2017,216852,Widener University,Chester,PA,19013,6,NCAA Division III with football,1321,1582,2903,2,"Private nonprofit, 4-year or above",2,17,14,168892,176664,345556,168209,175539,343748,Basketball
66444,2018,216852,Widener University,Chester,PA,19013,6,NCAA Division III with football,1299,1597,2896,2,"Private nonprofit, 4-year or above",2,15,14,165557,182443,348000,164194,165505,329699,Basketball
117937,2019,216852,Widener University,Chester,PA,19013,6,NCAA Division III with football,1252,1515,2767,2,"Private nonprofit, 4-year or above",2,17,15,163032,197580,360612,155028,175036,330064,Basketball
13725,2015,216852,Widener University-Main Campus,Chester,PA,190135792,6,NCAA Division III with football,1362,1556,2918,2,"Private nonprofit, 4-year or above",2,15,13,134652,146486,281138,136273,137833,274106,Basketball
13736,2015,216931,Wilkes University,Wilkes-Barre,PA,18766,6,NCAA Division III with football,1184,1067,2251,2,"Private nonprofit, 4-year or above",2,16,17,164073,92947,257020,157920,92946,250866,Basketball
31191,2016,216931,Wilkes University,Wilkes-Barre,PA,18766,6,NCAA Division III with football,1219,1078,2297,2,"Private nonprofit, 4-year or above",2,13,18,183900,97373,281273,162216,97305,259521,Basketball
48703,2017,216931,Wilkes University,Wilkes-Barre,PA,18766,6,NCAA Division III with football,1214,1006,2220,2,"Private nonprofit, 4-year or above",2,17,17,221656,115300,336956,191598,115300,306898,Basketball
66455,2018,216931,Wilkes University,Wilkes-Barre,PA,18766,6,NCAA Division III with football,1189,1018,2207,2,"Private nonprofit, 4-year or above",2,16,17,215809,120113,335922,174865,112829,287694,Basketball
117950,2019,216931,Wilkes University,Wilkes-Barre,PA,18766,6,NCAA Division III with football,1061,1043,2104,2,"Private nonprofit, 4-year or above",2,15,18,204705,106856,311561,181850,102268,284118,Basketball
12486,2015,210401,Willamette University,Salem,OR,97301,6,NCAA Division III with football,823,1082,1905,2,"Private nonprofit, 4-year or above",2,24,14,257022,181348,438370,257022,181348,438370,Basketball
29936,2016,210401,Willamette University,Salem,OR,97301,6,NCAA Division III with football,796,1054,1850,2,"Private nonprofit, 4-year or above",2,22,14,208859,180198,389057,203224,172198,375422,Basketball
47431,2017,210401,Willamette University,Salem,OR,97301,6,NCAA Division III with football,737,1015,1752,2,"Private nonprofit, 4-year or above",2,20,17,252047,227980,480027,252047,227980,480027,Basketball
65178,2018,210401,Willamette University,Salem,OR,97301,6,NCAA Division III with football,668,936,1604,2,"Private nonprofit, 4-year or above",2,17,10,233456,208152,441608,233456,208152,441608,Basketball
114133,2019,210401,Willamette University,Salem,OR,97301,6,NCAA Division III with football,596,860,1456,2,"Private nonprofit, 4-year or above",2,18,15,212627,180786,393413,212627,180786,393413,Basketball
125281,2019,231624,William & Mary,Williamsburg,VA,23187,2,NCAA Division I-FCS,2587,3600,6187,1,"Public, 4-year or above",2,15,13,2815292,1719676,4534968,2815292,1719676,4534968,Basketball
8454,2015,179955,William Jewell College,Liberty,MO,640681896,4,NCAA Division II with football,429,597,1026,2,"Private nonprofit, 4-year or above",2,18,19,601780,521066,1122846,579142,521066,1100208,Basketball
25887,2016,179955,William Jewell College,Liberty,MO,64068,4,NCAA Division II with football,413,564,977,2,"Private nonprofit, 4-year or above",2,15,15,638561,463148,1101709,618581,462443,1081024,Basketball
43376,2017,179955,William Jewell College,Liberty,MO,64068,4,NCAA Division II with football,377,532,909,2,"Private nonprofit, 4-year or above",2,15,19,515205,524847,1040052,487759,515805,1003564,Basketball
61093,2018,179955,William Jewell College,Liberty,MO,64068,4,NCAA Division II with football,356,423,779,2,"Private nonprofit, 4-year or above",2,16,18,452998,537672,990670,451998,534947,986945,Basketball
100134,2019,179955,William Jewell College,Liberty,MO,64068,4,NCAA Division II with football,331,393,724,2,"Private nonprofit, 4-year or above",2,16,19,459153,507773,966926,452102,507773,959875,Basketball
9275,2015,187444,William Paterson University of New Jersey,Wayne,NJ,7470,6,NCAA Division III with football,3485,4223,7708,1,"Public, 4-year or above",2,16,16,142829,179737,322566,135773,173076,308849,Basketball
26696,2016,187444,William Paterson University of New Jersey,Wayne,NJ,7470,6,NCAA Division III with football,3436,4054,7490,1,"Public, 4-year or above",2,16,13,132892,154738,287630,129100,153635,282735,Basketball
44191,2017,187444,William Paterson University of New Jersey,Wayne,NJ,7470,6,NCAA Division III with football,3332,3945,7277,1,"Public, 4-year or above",2,15,15,143368,172100,315468,136315,165349,301664,Basketball
61912,2018,187444,William Paterson University of New Jersey,Wayne,NJ,7470,6,NCAA Division III with football,3241,4018,7259,1,"Public, 4-year or above",2,16,12,148180,157897,306077,147763,157630,305393,Basketball
102895,2019,187444,William Paterson University of New Jersey,Wayne,NJ,7470,6,NCAA Division III with football,3148,4007,7155,1,"Public, 4-year or above",2,14,15,150772,165419,316191,148343,164967,313310,Basketball
11149,2015,199272,William Peace University,Raleigh,NC,276041194,7,NCAA Division III without football,346,540,886,2,"Private nonprofit, 4-year or above",2,19,14,77663,83190,160853,77663,83190,160853,Basketball
28589,2016,199272,William Peace University,Raleigh,NC,27604,7,NCAA Division III without football,380,500,880,2,"Private nonprofit, 4-year or above",2,18,9,108476,52978,161454,108476,52978,161454,Basketball
46083,2017,199272,William Peace University,Raleigh,NC,27604,7,NCAA Division III without football,408,406,814,2,"Private nonprofit, 4-year or above",2,18,9,157562,87111,244673,149761,71024,220785,Basketball
63803,2018,199272,William Peace University,Raleigh,NC,27604,7,NCAA Division III without football,403,415,818,2,"Private nonprofit, 4-year or above",2,17,17,112714,100941,213655,99468,133875,233343,Basketball
108975,2019,199272,William Peace University,Raleigh,NC,27604,7,NCAA Division III without football,382,395,777,2,"Private nonprofit, 4-year or above",2,18,27,125051,110565,235616,125301,125565,250866,Basketball
6949,2015,168342,Williams College,Williamstown,MA,1267,6,NCAA Division III with football,1015,1055,2070,2,"Private nonprofit, 4-year or above",2,15,12,150543,217101,367644,150543,217101,367644,Basketball
24341,2016,168342,Williams College,Williamstown,MA,1267,6,NCAA Division III with football,1052,992,2044,2,"Private nonprofit, 4-year or above",2,16,13,211853,226721,438574,211853,226721,438574,Basketball
41838,2017,168342,Williams College,Williamstown,MA,1267,6,NCAA Division III with football,1075,958,2033,2,"Private nonprofit, 4-year or above",2,17,14,173037,251498,424535,173037,251498,424535,Basketball
59531,2018,168342,Williams College,Williamstown,MA,1267,6,NCAA Division III with football,1052,976,2028,2,"Private nonprofit, 4-year or above",2,16,14,194537,252438,446975,194537,252438,446975,Basketball
94492,2019,168342,Williams College,Williamstown,MA,1267,6,NCAA Division III with football,1020,1008,2028,2,"Private nonprofit, 4-year or above",2,15,12,187758,267426,455184,187758,267426,455184,Basketball
11959,2015,206507,Wilmington College,Wilmington,OH,45177,6,NCAA Division III with football,482,547,1029,2,"Private nonprofit, 4-year or above",2,15,16,137402,141998,279400,137405,142005,279410,Basketball
29396,2016,206507,Wilmington College,Wilmington,OH,45177,6,NCAA Division III with football,485,584,1069,2,"Private nonprofit, 4-year or above",2,18,15,137432,141953,279385,137432,141953,279385,Basketball
46902,2017,206507,Wilmington College,Wilmington,OH,45177,6,NCAA Division III with football,523,575,1098,2,"Private nonprofit, 4-year or above",2,16,20,149898,165352,315250,149898,165352,315250,Basketball
64646,2018,206507,Wilmington College,Wilmington,OH,45177,6,NCAA Division III with football,567,598,1165,2,"Private nonprofit, 4-year or above",2,20,19,148346,170101,318447,148346,170101,318447,Basketball
111975,2019,206507,Wilmington College,Wilmington,OH,45177,6,NCAA Division III with football,544,623,1167,2,"Private nonprofit, 4-year or above",2,18,15,171451,190066,361517,171451,190066,361517,Basketball
2600,2015,131113,Wilmington University,New Castle,DE,19720,5,NCAA Division II without football,1409,2058,3467,2,"Private nonprofit, 4-year or above",2,15,19,230504,232564,463068,230504,232564,463068,Basketball
19971,2016,131113,Wilmington University,New Castle,DE,19720,5,NCAA Division II without football,1421,2001,3422,2,"Private nonprofit, 4-year or above",2,18,16,220790,208906,429696,220790,208906,429696,Basketball
37410,2017,131113,Wilmington University,New Castle,DE,19720,5,NCAA Division II without football,1284,1735,3019,2,"Private nonprofit, 4-year or above",2,18,13,229833,190123,419956,229833,190123,419956,Basketball
55052,2018,131113,Wilmington University,New Castle,DE,19720,5,NCAA Division II without football,1423,2000,3423,2,"Private nonprofit, 4-year or above",2,17,15,229725,214641,444366,229725,214641,444366,Basketball
79408,2019,131113,Wilmington University,New Castle,DE,19720,5,NCAA Division II without football,1276,1749,3025,2,"Private nonprofit, 4-year or above",2,18,16,289351,247566,536917,256589,203167,459756,Basketball
13748,2015,217013,Wilson College,Chambersburg,PA,172011285,7,NCAA Division III without football,66,348,414,2,"Private nonprofit, 4-year or above",2,14,14,68513,57023,125536,68513,57023,125536,Basketball
31203,2016,217013,Wilson College,Chambersburg,PA,17201,7,NCAA Division III without football,83,398,481,2,"Private nonprofit, 4-year or above",2,13,8,70376,58130,128506,70376,58130,128506,Basketball
48715,2017,217013,Wilson College,Chambersburg,PA,17201,7,NCAA Division III without football,90,462,552,2,"Private nonprofit, 4-year or above",2,14,10,82997,62695,145692,82997,62695,145692,Basketball
66469,2018,217013,Wilson College,Chambersburg,PA,17201,7,NCAA Division III without football,125,524,649,2,"Private nonprofit, 4-year or above",2,19,8,94042,74138,168180,94042,74138,168180,Basketball
117988,2019,217013,Wilson College,Chambersburg,PA,17201,7,NCAA Division III without football,129,539,668,2,"Private nonprofit, 4-year or above",2,17,12,62750,59375,122125,62750,59375,122125,Basketball
11264,2015,199962,Wingate University,Wingate,NC,281740159,4,NCAA Division II with football,786,1183,1969,2,"Private nonprofit, 4-year or above",2,16,18,523313,530634,1053947,513871,481267,995138,Basketball
28702,2016,199962,Wingate University,Wingate,NC,28174,4,NCAA Division II with football,809,1235,2044,2,"Private nonprofit, 4-year or above",2,18,16,532251,512138,1044389,514720,446978,961698,Basketball
46205,2017,199962,Wingate University,Wingate,NC,28174,4,NCAA Division II with football,984,1553,2537,2,"Private nonprofit, 4-year or above",2,17,15,542315,704483,1246798,525105,575636,1100741,Basketball
63928,2018,199962,Wingate University,Wingate,NC,28174,4,NCAA Division II with football,1058,1625,2683,2,"Private nonprofit, 4-year or above",2,15,17,536877,537366,1074243,521776,512879,1034655,Basketball
109481,2019,199962,Wingate University,Wingate,NC,28174,4,NCAA Division II with football,1057,1649,2706,2,"Private nonprofit, 4-year or above",2,18,19,536426,729025,1265451,522784,602179,1124963,Basketball
7851,2015,175272,Winona State University,Winona,MN,559875838,4,NCAA Division II with football,2716,4269,6985,1,"Public, 4-year or above",2,15,16,535408,477645,1013053,533327,462933,996260,Basketball
25265,2016,175272,Winona State University,Winona,MN,55987,4,NCAA Division II with football,2481,4139,6620,1,"Public, 4-year or above",2,14,15,504284,506815,1011099,489453,481867,971320,Basketball
42766,2017,175272,Winona State University,Winona,MN,55987,4,NCAA Division II with football,2375,4074,6449,1,"Public, 4-year or above",2,15,15,491212,468442,959654,491212,468442,959654,Basketball
60472,2018,175272,Winona State University,Winona,MN,55987,4,NCAA Division II with football,2267,3971,6238,1,"Public, 4-year or above",2,17,15,494640,467754,962394,494640,467754,962394,Basketball
97649,2019,175272,Winona State University,Winona,MN,55987,4,NCAA Division II with football,2073,3975,6048,1,"Public, 4-year or above",2,14,17,354427,385256,739683,547806,498777,1046583,Basketball
11275,2015,199999,Winston-Salem State University,Winston-Salem,NC,271100001,4,NCAA Division II with football,1206,2808,4014,1,"Public, 4-year or above",2,21,13,504713,451903,956616,504713,451903,956616,Basketball
28713,2016,199999,Winston-Salem State University,Winston-Salem,NC,27110,4,NCAA Division II with football,1227,2869,4096,1,"Public, 4-year or above",2,19,16,448976,461699,910675,448976,466049,915025,Basketball
46217,2017,199999,Winston-Salem State University,Winston-Salem,NC,27110,4,NCAA Division II with football,1217,2835,4052,1,"Public, 4-year or above",2,11,13,412138,202339,614477,412138,202339,614477,Basketball
63940,2018,199999,Winston-Salem State University,Winston-Salem,NC,27110,4,NCAA Division II with football,1167,2944,4111,1,"Public, 4-year or above",2,17,15,417155,433141,850296,417155,433141,850296,Basketball
109554,2019,199999,Winston-Salem State University,Winston-Salem,NC,27110,4,NCAA Division II with football,1129,2921,4050,1,"Public, 4-year or above",2,14,16,40161,13779,53940,463334,410179,873513,Basketball
14161,2015,218964,Winthrop University,Rock Hill,SC,29733,3,NCAA Division I without football,1457,3086,4543,1,"Public, 4-year or above",2,17,18,1303194,1082635,2385829,1303194,1082635,2385829,Basketball
31619,2016,218964,Winthrop University,Rock Hill,SC,29733,3,NCAA Division I without football,1412,3125,4537,1,"Public, 4-year or above",2,16,14,1804697,1238967,3043664,1433504,1188967,2622471,Basketball
49134,2017,218964,Winthrop University,Rock Hill,SC,29733,3,NCAA Division I without football,1349,3138,4487,1,"Public, 4-year or above",2,17,19,2005765,1215911,3221676,2005765,1215911,3221676,Basketball
66897,2018,218964,Winthrop University,Rock Hill,SC,29733,3,NCAA Division I without football,1303,3025,4328,1,"Public, 4-year or above",2,18,18,2101706,1141031,3242737,1780882,1104740,2885622,Basketball
119448,2019,218964,Winthrop University,Rock Hill,SC,29733,3,NCAA Division I without football,1300,2931,4231,1,"Public, 4-year or above",2,17,17,1935243,1067283,3002526,1855620,1233386,3089006,Basketball
16671,2015,240338,Wisconsin Lutheran College,Milwaukee,WI,532264699,6,NCAA Division III with football,429,539,968,2,"Private nonprofit, 4-year or above",2,22,17,109086,127331,236417,109086,127331,236417,Basketball
34146,2016,240338,Wisconsin Lutheran College,Milwaukee,WI,53226,6,NCAA Division III with football,397,518,915,2,"Private nonprofit, 4-year or above",2,20,18,139995,191967,331962,139995,191967,331962,Basketball
51698,2017,240338,Wisconsin Lutheran College,Milwaukee,WI,53226,6,NCAA Division III with football,410,511,921,2,"Private nonprofit, 4-year or above",2,21,15,137633,147853,285486,137633,147853,285486,Basketball
69448,2018,240338,Wisconsin Lutheran College,Milwaukee,WI,53226,6,NCAA Division III with football,431,520,951,2,"Private nonprofit, 4-year or above",2,20,20,145581,184645,330226,145028,184645,329673,Basketball
129259,2019,240338,Wisconsin Lutheran College,Milwaukee,WI,53226,6,NCAA Division III with football,407,508,915,2,"Private nonprofit, 4-year or above",2,20,16,171257,160388,331645,167593,158625,326218,Basketball
11968,2015,206525,Wittenberg University,Springfield,OH,45504,6,NCAA Division III with football,764,986,1750,2,"Private nonprofit, 4-year or above",2,24,21,250128,145222,395350,250128,145222,395350,Basketball
29405,2016,206525,Wittenberg University,Springfield,OH,45504,6,NCAA Division III with football,831,1013,1844,2,"Private nonprofit, 4-year or above",2,22,19,234147,220165,454312,227031,220165,447196,Basketball
46913,2017,206525,Wittenberg University,Springfield,OH,45504,6,NCAA Division III with football,823,925,1748,2,"Private nonprofit, 4-year or above",2,22,16,219615,176876,396491,217999,175174,393173,Basketball
64659,2018,206525,Wittenberg University,Springfield,OH,45504,6,NCAA Division III with football,757,910,1667,2,"Private nonprofit, 4-year or above",2,21,15,247060,196297,443357,240354,196297,436651,Basketball
112013,2019,206525,Wittenberg University,Springfield,OH,45504,6,NCAA Division III with football,683,809,1492,2,"Private nonprofit, 4-year or above",2,17,14,251374,219926,471300,236144,218995,455139,Basketball
14170,2015,218973,Wofford College,Spartanburg,SC,293033663,2,NCAA Division I-FCS,813,832,1645,2,"Private nonprofit, 4-year or above",2,15,14,1506228,1169665,2675893,1506228,1169665,2675893,Basketball
31628,2016,218973,Wofford College,Spartanburg,SC,29303,2,NCAA Division I-FCS,799,865,1664,2,"Private nonprofit, 4-year or above",2,17,13,1610673,1198117,2808790,1610673,1198117,2808790,Basketball
49143,2017,218973,Wofford College,Spartanburg,SC,29303,2,NCAA Division I-FCS,761,901,1662,2,"Private nonprofit, 4-year or above",2,20,12,1604157,1087971,2692128,1604157,1087971,2692128,Basketball
66906,2018,218973,Wofford College,Spartanburg,SC,29303,2,NCAA Division I-FCS,773,880,1653,2,"Private nonprofit, 4-year or above",2,16,15,1965358,1298040,3263398,1965358,1298040,3263398,Basketball
119486,2019,218973,Wofford College,Spartanburg,SC,29303,2,NCAA Division I-FCS,815,894,1709,2,"Private nonprofit, 4-year or above",2,16,14,1795343,1530442,3325785,1795343,1530442,3325785,Basketball
6968,2015,168421,Worcester Polytechnic Institute,Worcester,MA,16092280,6,NCAA Division III with football,2715,1370,4085,2,"Private nonprofit, 4-year or above",2,20,18,285174,231775,516949,262427,225465,487892,Basketball
24360,2016,168421,Worcester Polytechnic Institute,Worcester,MA,1609,6,NCAA Division III with football,2776,1438,4214,2,"Private nonprofit, 4-year or above",2,14,18,306761,286535,593296,298227,286141,584368,Basketball
41858,2017,168421,Worcester Polytechnic Institute,Worcester,MA,1609,6,NCAA Division III with football,2711,1533,4244,2,"Private nonprofit, 4-year or above",2,17,17,327747,301229,628976,320239,293074,613313,Basketball
59551,2018,168421,Worcester Polytechnic Institute,Worcester,MA,1609,6,NCAA Division III with football,2744,1722,4466,2,"Private nonprofit, 4-year or above",2,15,17,320795,281958,602753,320265,269119,589384,Basketball
94511,2019,168421,Worcester Polytechnic Institute,Worcester,MA,1609,6,NCAA Division III with football,2746,1832,4578,2,"Private nonprofit, 4-year or above",2,18,17,288892,262699,551591,268277,262699,530976,Basketball
6979,2015,168430,Worcester State University,Worcester,MA,16022597,6,NCAA Division III with football,1685,2409,4094,1,"Public, 4-year or above",2,16,9,78302,118534,196836,78198,114364,192562,Basketball
24371,2016,168430,Worcester State University,Worcester,MA,1602,6,NCAA Division III with football,1666,2355,4021,1,"Public, 4-year or above",2,13,14,77373,143949,221322,77373,143949,221322,Basketball
41869,2017,168430,Worcester State University,Worcester,MA,1602,6,NCAA Division III with football,1715,2425,4140,1,"Public, 4-year or above",2,15,14,80486,112894,193380,75789,111567,187356,Basketball
59562,2018,168430,Worcester State University,Worcester,MA,1602,6,NCAA Division III with football,1648,2497,4145,1,"Public, 4-year or above",2,14,18,56096,117080,173176,48974,122247,171221,Basketball
94549,2019,168430,Worcester State University,Worcester,MA,1602,6,NCAA Division III with football,1547,2522,4069,1,"Public, 4-year or above",2,15,15,58321,169175,227496,54623,161348,215971,Basketball
11994,2015,206604,Wright State University-Main Campus,Dayton,OH,454350001,3,NCAA Division I without football,4780,5058,9838,1,"Public, 4-year or above",2,15,11,2445427,1736693,4182120,2445427,1736693,4182120,Basketball
29432,2016,206604,Wright State University-Main Campus,Dayton,OH,45435,3,NCAA Division I without football,4624,4958,9582,1,"Public, 4-year or above",2,15,11,3050260,1624734,4674994,3050260,1624734,4674994,Basketball
46940,2017,206604,Wright State University-Main Campus,Dayton,OH,45435,3,NCAA Division I without football,4493,4828,9321,1,"Public, 4-year or above",2,16,13,3050810,1546284,4597094,3050810,1546284,4597094,Basketball
64687,2018,206604,Wright State University-Main Campus,Dayton,OH,45435,3,NCAA Division I without football,3982,4365,8347,1,"Public, 4-year or above",2,16,15,3330147,1779657,5109804,3330147,1779657,5109804,Basketball
112067,2019,206604,Wright State University-Main Campus,Dayton,OH,45435,3,NCAA Division I without football,3297,3863,7160,1,"Public, 4-year or above",2,15,15,3258201,1845868,5104069,3258201,1845868,5104069,Basketball
12008,2015,206622,Xavier University,Cincinnati,OH,452071092,3,NCAA Division I without football,1944,2276,4220,2,"Private nonprofit, 4-year or above",2,17,16,12346880,444384,12791264,5710021,2506557,8216578,Basketball
29446,2016,206622,Xavier University,Cincinnati,OH,45207,3,NCAA Division I without football,1994,2298,4292,2,"Private nonprofit, 4-year or above",2,17,16,12707109,1313028,14020137,7835880,2651684,10487564,Basketball
46952,2017,206622,Xavier University,Cincinnati,OH,45207,3,NCAA Division I without football,2020,2346,4366,2,"Private nonprofit, 4-year or above",2,15,15,13060660,1315163,14375823,8062088,2661069,10723157,Basketball
64698,2018,206622,Xavier University,Cincinnati,OH,45207,3,NCAA Division I without football,2175,2606,4781,2,"Private nonprofit, 4-year or above",2,16,14,13916975,1160640,15077615,7406374,2525521,9931895,Basketball
112115,2019,206622,Xavier University,Cincinnati,OH,45207,3,NCAA Division I without football,2201,2630,4831,2,"Private nonprofit, 4-year or above",2,13,13,12422262,1720854,14143116,9205473,2334484,11539957,Basketball
2532,2015,130794,Yale University,New Haven,CT,6520,2,NCAA Division I-FCS,2812,2696,5508,2,"Private nonprofit, 4-year or above",2,18,19,1255431,722468,1977899,1229771,722468,1952239,Basketball
19902,2016,130794,Yale University,New Haven,CT,6520,2,NCAA Division I-FCS,2782,2686,5468,2,"Private nonprofit, 4-year or above",2,16,14,1398300,797602,2195902,1327034,784329,2111363,Basketball
37341,2017,130794,Yale University,New Haven,CT,6520,2,NCAA Division I-FCS,2898,2843,5741,2,"Private nonprofit, 4-year or above",2,16,14,1325398,788605,2114003,1335946,798201,2134147,Basketball
54980,2018,130794,Yale University,New Haven,CT,6520,2,NCAA Division I-FCS,2952,2986,5938,2,"Private nonprofit, 4-year or above",2,18,16,1416853,728521,2145374,1416853,728521,2145374,Basketball
79280,2019,130794,Yale University,New Haven,CT,6520,2,NCAA Division I-FCS,2994,3094,6088,2,"Private nonprofit, 4-year or above",2,15,15,1406865,900737,2307602,1397230,868434,2265664,Basketball
10756,2015,197708,Yeshiva University,New York,NY,100333299,7,NCAA Division III without football,1417,1226,2643,2,"Private nonprofit, 4-year or above",2,17,14,61272,97092,158364,61272,97092,158364,Basketball
28188,2016,197708,Yeshiva University,New York,NY,10033,7,NCAA Division III without football,1404,1224,2628,2,"Private nonprofit, 4-year or above",2,16,13,52120,92655,144775,52120,92655,144775,Basketball
45686,2017,197708,Yeshiva University,New York,NY,10033,7,NCAA Division III without football,1362,1284,2646,2,"Private nonprofit, 4-year or above",2,15,15,123101,146927,270028,123101,146927,270028,Basketball
63397,2018,197708,Yeshiva University,New York,NY,10033,7,NCAA Division III without football,1368,1265,2633,2,"Private nonprofit, 4-year or above",2,17,15,71246,130700,201946,71246,130700,201946,Basketball
107569,2019,197708,Yeshiva University,New York,NY,10033,7,NCAA Division III without football,1400,1243,2643,2,"Private nonprofit, 4-year or above",2,18,17,110134,118373,228507,110134,118373,228507,Basketball
48722,2017,217059,York College of Pennsylvania,York,PA,17403,7,NCAA Division III without football,1743,2068,3811,2,"Private nonprofit, 4-year or above",2,14,16,173250,153952,327202,137919,153544,291463,Basketball
66476,2018,217059,York College of Pennsylvania,York,PA,17403,7,NCAA Division III without football,1670,2036,3706,2,"Private nonprofit, 4-year or above",2,16,14,173198,123214,296412,143044,109229,252273,Basketball
118026,2019,217059,York College of Pennsylvania,York,PA,17403,7,NCAA Division III without football,1596,2085,3681,2,"Private nonprofit, 4-year or above",2,17,15,173805,156345,330150,143704,143689,287393,Basketball
13756,2015,217059,York College Pennsylvania,York,PA,174033651,7,NCAA Division III without football,1834,2238,4072,2,"Private nonprofit, 4-year or above",2,13,18,116797,137648,254445,110293,123008,233301,Basketball
31210,2016,217059,York College Pennsylvania,York,PA,17403,7,NCAA Division III without football,1729,2117,3846,2,"Private nonprofit, 4-year or above",2,13,15,144026,151912,295938,124988,142225,267213,Basketball
3479,2015,141361,Young Harris College,Young Harris,GA,30582,5,NCAA Division II without football,499,653,1152,2,"Private nonprofit, 4-year or above",2,14,14,547164,537618,1084782,547164,537618,1084782,Basketball
20849,2016,141361,Young Harris College,Young Harris,GA,30582,5,NCAA Division II without football,486,616,1102,2,"Private nonprofit, 4-year or above",2,15,14,583223,483303,1066526,583223,483303,1066526,Basketball
38306,2017,141361,Young Harris College,Young Harris,GA,30582,5,NCAA Division II without football,417,592,1009,2,"Private nonprofit, 4-year or above",2,14,16,596763,585064,1181827,596763,585064,1181827,Basketball
55959,2018,141361,Young Harris College,Young Harris,GA,30582,5,NCAA Division II without football,457,521,978,2,"Private nonprofit, 4-year or above",2,15,18,614282,502147,1116429,614282,502147,1116429,Basketball
82810,2019,141361,Young Harris College,Young Harris,GA,30582,5,NCAA Division II without football,433,468,901,2,"Private nonprofit, 4-year or above",2,37,17,605683,543983,1149666,605683,543983,1149666,Basketball
12018,2015,206695,Youngstown State University,Youngstown,OH,445550001,2,NCAA Division I-FCS,4138,4299,8437,1,"Public, 4-year or above",2,13,12,1347141,1010160,2357301,1347141,1010160,2357301,Basketball
29456,2016,206695,Youngstown State University,Youngstown,OH,44555,2,NCAA Division I-FCS,4170,4448,8618,1,"Public, 4-year or above",2,15,16,1535346,1129211,2664557,1535346,1129211,2664557,Basketball
46962,2017,206695,Youngstown State University,Youngstown,OH,44555,2,NCAA Division I-FCS,4274,4374,8648,1,"Public, 4-year or above",2,20,16,1517679,1117584,2635263,1517679,1117584,2635263,Basketball
64708,2018,206695,Youngstown State University,Youngstown,OH,44555,2,NCAA Division I-FCS,4278,4508,8786,1,"Public, 4-year or above",2,19,14,1555175,1158692,2713867,1555175,1158692,2713867,Basketball
112153,2019,206695,Youngstown State University,Youngstown,OH,44555,2,NCAA Division I-FCS,4048,4528,8576,1,"Public, 4-year or above",2,16,14,1702113,1173181,2875294,1702113,1173181,2875294,Basketball